ahobachonado	ahobachonado	O
ahobachonadas	ahobachonado	FP
ahobachonada	ahobachonado	F
ahobachonados	ahobachonado	P
ahogadero	ahogadero	O
ahogaderas	ahogadero	FP
ahogadera	ahogadero	F
ahogaderos	ahogadero	P
ahogadilla	ahogadilla	O
ahogadillas	ahogadilla	P
ahogadizo	ahogadizo	O
ahogadizas	ahogadizo	FP
ahogadiza	ahogadizo	F
ahogadizos	ahogadizo	P
ahogado	ahogado	O
ahogadas	ahogado	FP
ahogada	ahogado	F
ahogados	ahogado	P
ahogador	ahogador	O
ahogadoras	ahogador	FP
ahogadora	ahogador	F
ahogadores	ahogador	P
ahogamiento	ahogamiento	O
ahogamientos	ahogamiento	P
ahogaviejas	ahogaviejas	O
ahogo	ahogo	O
ahogos	ahogo	P
ahoguío	ahoguío	O
ahoguíos	ahoguío	P
ahombrado	ahombrado	O
ahombradas	ahombrado	FP
ahombrada	ahombrado	F
ahombrados	ahombrado	P
ahondamiento	ahondamiento	O
ahondamientos	ahondamiento	P
ahonde	ahonde	O
ahondes	ahonde	P
ahora	ahora	O
ahorcable	ahorcable	O
ahorcables	ahorcable	P
ahorcadizo	ahorcadizo	O
ahorcadizas	ahorcadizo	FP
ahorcadiza	ahorcadizo	F
ahorcadizos	ahorcadizo	P
ahorcado	ahorcado	O
ahorcadas	ahorcado	FP
ahorcada	ahorcado	F
ahorcados	ahorcado	P
ahorcadora	ahorcadora	O
ahorcadoras	ahorcadora	P
ahorcadura	ahorcadura	O
ahorcaduras	ahorcadura	P
ahorcamiento	ahorcamiento	O
ahorcamientos	ahorcamiento	P
ahorcaperros	ahorcaperros	O
ahorita	ahorita	O
ahoritita	ahoritita	O
ahornagamiento	ahornagamiento	O
ahornagamientos	ahornagamiento	P
ahorquillado	ahorquillado	O
ahorquilladas	ahorquillado	FP
ahorquillada	ahorquillado	F
ahorquillados	ahorquillado	P
ahorradamente	ahorradamente	O
ahorrado	ahorrado	O
ahorradas	ahorrado	FP
ahorrada	ahorrado	F
ahorrados	ahorrado	P
ahorrador	ahorrador	O
ahorradoras	ahorrador	FP
ahorradora	ahorrador	F
ahorradores	ahorrador	P
ahorramiento	ahorramiento	O
ahorramientos	ahorramiento	P
ahorrativo	ahorrativo	O
ahorrativas	ahorrativo	FP
ahorrativa	ahorrativo	F
ahorrativos	ahorrativo	P
ahorrista	ahorrista	O
ahorristas	ahorrista	P
ahorro	ahorro	O
ahorros	ahorro	P
ahorría	ahorría	O
ahorrías	ahorría	P
ahotado	ahotado	O
ahotadas	ahotado	FP
ahotada	ahotado	F
ahotados	ahotado	P
ahotas	ahotas	O
ahoyadura	ahoyadura	O
ahoyaduras	ahoyadura	P
ahó	ahó	O
ahós	ahó	P
ahocicar	ahocicar	O
ahocico	ahocicar	VIP1
ahocicas	ahocicar	VIP2
ahocica	ahocicar	VIP3
ahocicamos	ahocicar	VIP4
ahocicáis	ahocicar	VIP5
ahocican	ahocicar	VIP6
ahocicaba	ahocicar	VII1
ahocicabas	ahocicar	VII2
ahocicábamos	ahocicar	VII4
ahocicabais	ahocicar	VII5
ahocicaban	ahocicar	VII6
ahocicaré	ahocicar	VIF1
ahocicarás	ahocicar	VIF2
ahocicará	ahocicar	VIF3
ahocicaremos	ahocicar	VIF4
ahocicaréis	ahocicar	VIF5
ahocicarán	ahocicar	VIF6
ahocicaría	ahocicar	VIC1
ahocicarías	ahocicar	VIC2
ahocicaría	ahocicar	VIC3
ahocicaríamos	ahocicar	VIC4
ahocicaríais	ahocicar	VIC5
ahocicarían	ahocicar	VIC6
ahociqué	ahocicar	VIX1
ahocicaste	ahocicar	VIX2
ahocicó	ahocicar	VIX3
ahocicasteis	ahocicar	VIX5
ahocicaron	ahocicar	VIX6
ahocique	ahocicar	VSP1
ahociques	ahocicar	VSP2
ahociquemos	ahocicar	VSP4
ahociquéis	ahocicar	VSP5
ahociquen	ahocicar	VSP6
ahocicara	ahocicar	VSX1
ahocicaras	ahocicar	VSX2
ahocicáramos	ahocicar	VSX4
ahocicarais	ahocicar	VSX5
ahocicaran	ahocicar	VSX6
ahocicare	ahocicar	VSF1
ahocicares	ahocicar	VSF2
ahocicáremos	ahocicar	VSF4
ahocicareis	ahocicar	VSF5
ahocicaren	ahocicar	VSF6
ahocicase	ahocicar	VSI1
ahocicases	ahocicar	VSI2
ahocicásemos	ahocicar	VSI4
ahocicaseis	ahocicar	VSI5
ahocicasen	ahocicar	VSI6
ahocicad	ahocicar	VMP
ahocicadme	ahocicar	VMSE
ahocicadle	ahocicar	VMSE
ahocicadnos	ahocicar	VMPE
ahocicaos	ahocicar	VMPE
ahocicadles	ahocicar	VMPE
ahocicadlo	ahocicar	VMMSE
ahocicadla	ahocicar	VMFSE
ahocicadlos	ahocicar	VMMPE
ahocicadlas	ahocicar	VMFPE
ahocicádmelo	ahocicar	VMMSE
ahocicádselo	ahocicar	VMMSE
ahocicádnoslo	ahocicar	VMMSE
ahocicáoslo	ahocicar	VMMSE
ahocicádmelos	ahocicar	VMMPE
ahocicádselos	ahocicar	VMMPE
ahocicádnoslos	ahocicar	VMMPE
ahocicáoslos	ahocicar	VMMPE
ahocicádmela	ahocicar	VMFSE
ahocicádsela	ahocicar	VMFSE
ahocicádnosla	ahocicar	VMFSE
ahocicáosla	ahocicar	VMFSE
ahocicádmelas	ahocicar	VMFPE
ahocicádselas	ahocicar	VMFPE
ahocicádnoslas	ahocicar	VMFPE
ahocicáoslas	ahocicar	VMFPE
ahocicado	ahocicar	VPM
ahocicados	ahocicar	VPMP
ahocicada	ahocicar	VPF
ahocicadas	ahocicar	VPFP
ahocicando	ahocicar	VG
ahocicándome	ahocicar	VGSE
ahocicándote	ahocicar	VGSE
ahocicándole	ahocicar	VGSE
ahocicándonos	ahocicar	VGPE
ahocicándoos	ahocicar	VGPE
ahocicándolo	ahocicar	VGMSE
ahocicándola	ahocicar	VGFSE
ahocicándolos	ahocicar	VGMPE
ahocicándolas	ahocicar	VGFPE
ahocicándomelo	ahocicar	VGMSE
ahocicándotelo	ahocicar	VGMSE
ahocicándoselo	ahocicar	VGMSE
ahocicándonoslo	ahocicar	VGMSE
ahocicándooslo	ahocicar	VGMSE
ahocicándomelos	ahocicar	VGMPE
ahocicándotelos	ahocicar	VGMPE
ahocicándoselos	ahocicar	VGMPE
ahocicándonoslos	ahocicar	VGMPE
ahocicándooslos	ahocicar	VGMPE
ahocicándomela	ahocicar	VGFSE
ahocicándotela	ahocicar	VGFSE
ahocicándosela	ahocicar	VGFSE
ahocicándonosla	ahocicar	VGFSE
ahocicándoosla	ahocicar	VGFSE
ahocicándomelas	ahocicar	VGFPE
ahocicándotelas	ahocicar	VGFPE
ahocicándoselas	ahocicar	VGFPE
ahocicándonoslas	ahocicar	VGFPE
ahocicándooslas	ahocicar	VGFPE
ahocinar	ahocinar	O
ahocino	ahocinar	VIP1
ahocinas	ahocinar	VIP2
ahocina	ahocinar	VIP3
ahocinamos	ahocinar	VIP4
ahocináis	ahocinar	VIP5
ahocinan	ahocinar	VIP6
ahocinaba	ahocinar	VII1
ahocinabas	ahocinar	VII2
ahocinábamos	ahocinar	VII4
ahocinabais	ahocinar	VII5
ahocinaban	ahocinar	VII6
ahocinaré	ahocinar	VIF1
ahocinarás	ahocinar	VIF2
ahocinará	ahocinar	VIF3
ahocinaremos	ahocinar	VIF4
ahocinaréis	ahocinar	VIF5
ahocinarán	ahocinar	VIF6
ahocinaría	ahocinar	VIC1
ahocinarías	ahocinar	VIC2
ahocinaría	ahocinar	VIC3
ahocinaríamos	ahocinar	VIC4
ahocinaríais	ahocinar	VIC5
ahocinarían	ahocinar	VIC6
ahociné	ahocinar	VIX1
ahocinaste	ahocinar	VIX2
ahocinó	ahocinar	VIX3
ahocinasteis	ahocinar	VIX5
ahocinaron	ahocinar	VIX6
ahocine	ahocinar	VSP1
ahocines	ahocinar	VSP2
ahocinemos	ahocinar	VSP4
ahocinéis	ahocinar	VSP5
ahocinen	ahocinar	VSP6
ahocinara	ahocinar	VSX1
ahocinaras	ahocinar	VSX2
ahocináramos	ahocinar	VSX4
ahocinarais	ahocinar	VSX5
ahocinaran	ahocinar	VSX6
ahocinare	ahocinar	VSF1
ahocinares	ahocinar	VSF2
ahocináremos	ahocinar	VSF4
ahocinareis	ahocinar	VSF5
ahocinaren	ahocinar	VSF6
ahocinase	ahocinar	VSI1
ahocinases	ahocinar	VSI2
ahocinásemos	ahocinar	VSI4
ahocinaseis	ahocinar	VSI5
ahocinasen	ahocinar	VSI6
ahocinad	ahocinar	VMP
ahocinadme	ahocinar	VMSE
ahocinadle	ahocinar	VMSE
ahocinadnos	ahocinar	VMPE
ahocinaos	ahocinar	VMPE
ahocinadles	ahocinar	VMPE
ahocinado	ahocinar	VPM
ahocinados	ahocinar	VPMP
ahocinada	ahocinar	VPF
ahocinadas	ahocinar	VPFP
ahocinando	ahocinar	VG
ahocinándome	ahocinar	VGSE
ahocinándote	ahocinar	VGSE
ahocinándole	ahocinar	VGSE
ahocinándonos	ahocinar	VGPE
ahocinándoos	ahocinar	VGPE
ahogar	ahogar	O
ahogo	ahogar	VIP1
ahogas	ahogar	VIP2
ahoga	ahogar	VIP3
ahogamos	ahogar	VIP4
ahogáis	ahogar	VIP5
ahogan	ahogar	VIP6
ahogaba	ahogar	VII1
ahogabas	ahogar	VII2
ahogábamos	ahogar	VII4
ahogabais	ahogar	VII5
ahogaban	ahogar	VII6
ahogaré	ahogar	VIF1
ahogarás	ahogar	VIF2
ahogará	ahogar	VIF3
ahogaremos	ahogar	VIF4
ahogaréis	ahogar	VIF5
ahogarán	ahogar	VIF6
ahogaría	ahogar	VIC1
ahogarías	ahogar	VIC2
ahogaría	ahogar	VIC3
ahogaríamos	ahogar	VIC4
ahogaríais	ahogar	VIC5
ahogarían	ahogar	VIC6
ahogé	ahogar	VIX1
ahogaste	ahogar	VIX2
ahogó	ahogar	VIX3
ahogasteis	ahogar	VIX5
ahogaron	ahogar	VIX6
ahogue	ahogar	VSP1
ahogues	ahogar	VSP2
ahoguemos	ahogar	VSP4
ahoguéis	ahogar	VSP5
ahoguen	ahogar	VSP6
ahogara	ahogar	VSX1
ahogaras	ahogar	VSX2
ahogáramos	ahogar	VSX4
ahogarais	ahogar	VSX5
ahogaran	ahogar	VSX6
ahogare	ahogar	VSF1
ahogares	ahogar	VSF2
ahogáremos	ahogar	VSF4
ahogareis	ahogar	VSF5
ahogaren	ahogar	VSF6
ahogase	ahogar	VSI1
ahogases	ahogar	VSI2
ahogásemos	ahogar	VSI4
ahogaseis	ahogar	VSI5
ahogasen	ahogar	VSI6
ahogad	ahogar	VMP
ahogadme	ahogar	VMSE
ahogadle	ahogar	VMSE
ahogadnos	ahogar	VMPE
ahogaos	ahogar	VMPE
ahogadles	ahogar	VMPE
ahogadlo	ahogar	VMMSE
ahogadla	ahogar	VMFSE
ahogadlos	ahogar	VMMPE
ahogadlas	ahogar	VMFPE
ahogádmelo	ahogar	VMMSE
ahogádselo	ahogar	VMMSE
ahogádnoslo	ahogar	VMMSE
ahogáoslo	ahogar	VMMSE
ahogádmelos	ahogar	VMMPE
ahogádselos	ahogar	VMMPE
ahogádnoslos	ahogar	VMMPE
ahogáoslos	ahogar	VMMPE
ahogádmela	ahogar	VMFSE
ahogádsela	ahogar	VMFSE
ahogádnosla	ahogar	VMFSE
ahogáosla	ahogar	VMFSE
ahogádmelas	ahogar	VMFPE
ahogádselas	ahogar	VMFPE
ahogádnoslas	ahogar	VMFPE
ahogáoslas	ahogar	VMFPE
ahogado	ahogar	VPM
ahogados	ahogar	VPMP
ahogada	ahogar	VPF
ahogadas	ahogar	VPFP
ahogando	ahogar	VG
ahogándome	ahogar	VGSE
ahogándote	ahogar	VGSE
ahogándole	ahogar	VGSE
ahogándonos	ahogar	VGPE
ahogándoos	ahogar	VGPE
ahogándolo	ahogar	VGMSE
ahogándola	ahogar	VGFSE
ahogándolos	ahogar	VGMPE
ahogándolas	ahogar	VGFPE
ahogándomelo	ahogar	VGMSE
ahogándotelo	ahogar	VGMSE
ahogándoselo	ahogar	VGMSE
ahogándonoslo	ahogar	VGMSE
ahogándooslo	ahogar	VGMSE
ahogándomelos	ahogar	VGMPE
ahogándotelos	ahogar	VGMPE
ahogándoselos	ahogar	VGMPE
ahogándonoslos	ahogar	VGMPE
ahogándooslos	ahogar	VGMPE
ahogándomela	ahogar	VGFSE
ahogándotela	ahogar	VGFSE
ahogándosela	ahogar	VGFSE
ahogándonosla	ahogar	VGFSE
ahogándoosla	ahogar	VGFSE
ahogándomelas	ahogar	VGFPE
ahogándotelas	ahogar	VGFPE
ahogándoselas	ahogar	VGFPE
ahogándonoslas	ahogar	VGFPE
ahogándooslas	ahogar	VGFPE
ahondar	ahondar	O
ahondo	ahondar	VIP1
ahondas	ahondar	VIP2
ahonda	ahondar	VIP3
ahondamos	ahondar	VIP4
ahondáis	ahondar	VIP5
ahondan	ahondar	VIP6
ahondaba	ahondar	VII1
ahondabas	ahondar	VII2
ahondábamos	ahondar	VII4
ahondabais	ahondar	VII5
ahondaban	ahondar	VII6
ahondaré	ahondar	VIF1
ahondarás	ahondar	VIF2
ahondará	ahondar	VIF3
ahondaremos	ahondar	VIF4
ahondaréis	ahondar	VIF5
ahondarán	ahondar	VIF6
ahondaría	ahondar	VIC1
ahondarías	ahondar	VIC2
ahondaría	ahondar	VIC3
ahondaríamos	ahondar	VIC4
ahondaríais	ahondar	VIC5
ahondarían	ahondar	VIC6
ahondé	ahondar	VIX1
ahondaste	ahondar	VIX2
ahondó	ahondar	VIX3
ahondasteis	ahondar	VIX5
ahondaron	ahondar	VIX6
ahonde	ahondar	VSP1
ahondes	ahondar	VSP2
ahondemos	ahondar	VSP4
ahondéis	ahondar	VSP5
ahonden	ahondar	VSP6
ahondara	ahondar	VSX1
ahondaras	ahondar	VSX2
ahondáramos	ahondar	VSX4
ahondarais	ahondar	VSX5
ahondaran	ahondar	VSX6
ahondare	ahondar	VSF1
ahondares	ahondar	VSF2
ahondáremos	ahondar	VSF4
ahondareis	ahondar	VSF5
ahondaren	ahondar	VSF6
ahondase	ahondar	VSI1
ahondases	ahondar	VSI2
ahondásemos	ahondar	VSI4
ahondaseis	ahondar	VSI5
ahondasen	ahondar	VSI6
ahondad	ahondar	VMP
ahondadme	ahondar	VMSE
ahondadle	ahondar	VMSE
ahondadnos	ahondar	VMPE
ahondaos	ahondar	VMPE
ahondadles	ahondar	VMPE
ahondadlo	ahondar	VMMSE
ahondadla	ahondar	VMFSE
ahondadlos	ahondar	VMMPE
ahondadlas	ahondar	VMFPE
ahondádmelo	ahondar	VMMSE
ahondádselo	ahondar	VMMSE
ahondádnoslo	ahondar	VMMSE
ahondáoslo	ahondar	VMMSE
ahondádmelos	ahondar	VMMPE
ahondádselos	ahondar	VMMPE
ahondádnoslos	ahondar	VMMPE
ahondáoslos	ahondar	VMMPE
ahondádmela	ahondar	VMFSE
ahondádsela	ahondar	VMFSE
ahondádnosla	ahondar	VMFSE
ahondáosla	ahondar	VMFSE
ahondádmelas	ahondar	VMFPE
ahondádselas	ahondar	VMFPE
ahondádnoslas	ahondar	VMFPE
ahondáoslas	ahondar	VMFPE
ahondado	ahondar	VPM
ahondados	ahondar	VPMP
ahondada	ahondar	VPF
ahondadas	ahondar	VPFP
ahondando	ahondar	VG
ahondándome	ahondar	VGSE
ahondándote	ahondar	VGSE
ahondándole	ahondar	VGSE
ahondándonos	ahondar	VGPE
ahondándoos	ahondar	VGPE
ahondándolo	ahondar	VGMSE
ahondándola	ahondar	VGFSE
ahondándolos	ahondar	VGMPE
ahondándolas	ahondar	VGFPE
ahondándomelo	ahondar	VGMSE
ahondándotelo	ahondar	VGMSE
ahondándoselo	ahondar	VGMSE
ahondándonoslo	ahondar	VGMSE
ahondándooslo	ahondar	VGMSE
ahondándomelos	ahondar	VGMPE
ahondándotelos	ahondar	VGMPE
ahondándoselos	ahondar	VGMPE
ahondándonoslos	ahondar	VGMPE
ahondándooslos	ahondar	VGMPE
ahondándomela	ahondar	VGFSE
ahondándotela	ahondar	VGFSE
ahondándosela	ahondar	VGFSE
ahondándonosla	ahondar	VGFSE
ahondándoosla	ahondar	VGFSE
ahondándomelas	ahondar	VGFPE
ahondándotelas	ahondar	VGFPE
ahondándoselas	ahondar	VGFPE
ahondándonoslas	ahondar	VGFPE
ahondándooslas	ahondar	VGFPE
ahorcajar	ahorcajar	O
ahorcajo	ahorcajar	VIP1
ahorcajas	ahorcajar	VIP2
ahorcaja	ahorcajar	VIP3
ahorcajamos	ahorcajar	VIP4
ahorcajáis	ahorcajar	VIP5
ahorcajan	ahorcajar	VIP6
ahorcajaba	ahorcajar	VII1
ahorcajabas	ahorcajar	VII2
ahorcajábamos	ahorcajar	VII4
ahorcajabais	ahorcajar	VII5
ahorcajaban	ahorcajar	VII6
ahorcajaré	ahorcajar	VIF1
ahorcajarás	ahorcajar	VIF2
ahorcajará	ahorcajar	VIF3
ahorcajaremos	ahorcajar	VIF4
ahorcajaréis	ahorcajar	VIF5
ahorcajarán	ahorcajar	VIF6
ahorcajaría	ahorcajar	VIC1
ahorcajarías	ahorcajar	VIC2
ahorcajaría	ahorcajar	VIC3
ahorcajaríamos	ahorcajar	VIC4
ahorcajaríais	ahorcajar	VIC5
ahorcajarían	ahorcajar	VIC6
ahorcajé	ahorcajar	VIX1
ahorcajaste	ahorcajar	VIX2
ahorcajó	ahorcajar	VIX3
ahorcajasteis	ahorcajar	VIX5
ahorcajaron	ahorcajar	VIX6
ahorcaje	ahorcajar	VSP1
ahorcajes	ahorcajar	VSP2
ahorcajemos	ahorcajar	VSP4
ahorcajéis	ahorcajar	VSP5
ahorcajen	ahorcajar	VSP6
ahorcajara	ahorcajar	VSX1
ahorcajaras	ahorcajar	VSX2
ahorcajáramos	ahorcajar	VSX4
ahorcajarais	ahorcajar	VSX5
ahorcajaran	ahorcajar	VSX6
ahorcajare	ahorcajar	VSF1
ahorcajares	ahorcajar	VSF2
ahorcajáremos	ahorcajar	VSF4
ahorcajareis	ahorcajar	VSF5
ahorcajaren	ahorcajar	VSF6
ahorcajase	ahorcajar	VSI1
ahorcajases	ahorcajar	VSI2
ahorcajásemos	ahorcajar	VSI4
ahorcajaseis	ahorcajar	VSI5
ahorcajasen	ahorcajar	VSI6
ahorcajad	ahorcajar	VMP
ahorcajadme	ahorcajar	VMSE
ahorcajadle	ahorcajar	VMSE
ahorcajadnos	ahorcajar	VMPE
ahorcajaos	ahorcajar	VMPE
ahorcajadles	ahorcajar	VMPE
ahorcajado	ahorcajar	VPM
ahorcajados	ahorcajar	VPMP
ahorcajada	ahorcajar	VPF
ahorcajadas	ahorcajar	VPFP
ahorcajando	ahorcajar	VG
ahorcajándome	ahorcajar	VGSE
ahorcajándote	ahorcajar	VGSE
ahorcajándole	ahorcajar	VGSE
ahorcajándonos	ahorcajar	VGPE
ahorcajándoos	ahorcajar	VGPE
ahorcar	ahorcar	O
ahorco	ahorcar	VIP1
ahorcas	ahorcar	VIP2
ahorca	ahorcar	VIP3
ahorcamos	ahorcar	VIP4
ahorcáis	ahorcar	VIP5
ahorcan	ahorcar	VIP6
ahorcaba	ahorcar	VII1
ahorcabas	ahorcar	VII2
ahorcábamos	ahorcar	VII4
ahorcabais	ahorcar	VII5
ahorcaban	ahorcar	VII6
ahorcaré	ahorcar	VIF1
ahorcarás	ahorcar	VIF2
ahorcará	ahorcar	VIF3
ahorcaremos	ahorcar	VIF4
ahorcaréis	ahorcar	VIF5
ahorcarán	ahorcar	VIF6
ahorcaría	ahorcar	VIC1
ahorcarías	ahorcar	VIC2
ahorcaría	ahorcar	VIC3
ahorcaríamos	ahorcar	VIC4
ahorcaríais	ahorcar	VIC5
ahorcarían	ahorcar	VIC6
ahorqué	ahorcar	VIX1
ahorcaste	ahorcar	VIX2
ahorcó	ahorcar	VIX3
ahorcasteis	ahorcar	VIX5
ahorcaron	ahorcar	VIX6
ahorque	ahorcar	VSP1
ahorques	ahorcar	VSP2
ahorquemos	ahorcar	VSP4
ahorquéis	ahorcar	VSP5
ahorquen	ahorcar	VSP6
ahorcara	ahorcar	VSX1
ahorcaras	ahorcar	VSX2
ahorcáramos	ahorcar	VSX4
ahorcarais	ahorcar	VSX5
ahorcaran	ahorcar	VSX6
ahorcare	ahorcar	VSF1
ahorcares	ahorcar	VSF2
ahorcáremos	ahorcar	VSF4
ahorcareis	ahorcar	VSF5
ahorcaren	ahorcar	VSF6
ahorcase	ahorcar	VSI1
ahorcases	ahorcar	VSI2
ahorcásemos	ahorcar	VSI4
ahorcaseis	ahorcar	VSI5
ahorcasen	ahorcar	VSI6
ahorcad	ahorcar	VMP
ahorcadme	ahorcar	VMSE
ahorcadle	ahorcar	VMSE
ahorcadnos	ahorcar	VMPE
ahorcaos	ahorcar	VMPE
ahorcadles	ahorcar	VMPE
ahorcadlo	ahorcar	VMMSE
ahorcadla	ahorcar	VMFSE
ahorcadlos	ahorcar	VMMPE
ahorcadlas	ahorcar	VMFPE
ahorcádmelo	ahorcar	VMMSE
ahorcádselo	ahorcar	VMMSE
ahorcádnoslo	ahorcar	VMMSE
ahorcáoslo	ahorcar	VMMSE
ahorcádmelos	ahorcar	VMMPE
ahorcádselos	ahorcar	VMMPE
ahorcádnoslos	ahorcar	VMMPE
ahorcáoslos	ahorcar	VMMPE
ahorcádmela	ahorcar	VMFSE
ahorcádsela	ahorcar	VMFSE
ahorcádnosla	ahorcar	VMFSE
ahorcáosla	ahorcar	VMFSE
ahorcádmelas	ahorcar	VMFPE
ahorcádselas	ahorcar	VMFPE
ahorcádnoslas	ahorcar	VMFPE
ahorcáoslas	ahorcar	VMFPE
ahorcado	ahorcar	VPM
ahorcados	ahorcar	VPMP
ahorcada	ahorcar	VPF
ahorcadas	ahorcar	VPFP
ahorcando	ahorcar	VG
ahorcándome	ahorcar	VGSE
ahorcándote	ahorcar	VGSE
ahorcándole	ahorcar	VGSE
ahorcándonos	ahorcar	VGPE
ahorcándoos	ahorcar	VGPE
ahorcándolo	ahorcar	VGMSE
ahorcándola	ahorcar	VGFSE
ahorcándolos	ahorcar	VGMPE
ahorcándolas	ahorcar	VGFPE
ahorcándomelo	ahorcar	VGMSE
ahorcándotelo	ahorcar	VGMSE
ahorcándoselo	ahorcar	VGMSE
ahorcándonoslo	ahorcar	VGMSE
ahorcándooslo	ahorcar	VGMSE
ahorcándomelos	ahorcar	VGMPE
ahorcándotelos	ahorcar	VGMPE
ahorcándoselos	ahorcar	VGMPE
ahorcándonoslos	ahorcar	VGMPE
ahorcándooslos	ahorcar	VGMPE
ahorcándomela	ahorcar	VGFSE
ahorcándotela	ahorcar	VGFSE
ahorcándosela	ahorcar	VGFSE
ahorcándonosla	ahorcar	VGFSE
ahorcándoosla	ahorcar	VGFSE
ahorcándomelas	ahorcar	VGFPE
ahorcándotelas	ahorcar	VGFPE
ahorcándoselas	ahorcar	VGFPE
ahorcándonoslas	ahorcar	VGFPE
ahorcándooslas	ahorcar	VGFPE
ahorcares	ahorcar	P
ahormar	ahormar	O
ahormo	ahormar	VIP1
ahormas	ahormar	VIP2
ahorma	ahormar	VIP3
ahormamos	ahormar	VIP4
ahormáis	ahormar	VIP5
ahorman	ahormar	VIP6
ahormaba	ahormar	VII1
ahormabas	ahormar	VII2
ahormábamos	ahormar	VII4
ahormabais	ahormar	VII5
ahormaban	ahormar	VII6
ahormaré	ahormar	VIF1
ahormarás	ahormar	VIF2
ahormará	ahormar	VIF3
ahormaremos	ahormar	VIF4
ahormaréis	ahormar	VIF5
ahormarán	ahormar	VIF6
ahormaría	ahormar	VIC1
ahormarías	ahormar	VIC2
ahormaría	ahormar	VIC3
ahormaríamos	ahormar	VIC4
ahormaríais	ahormar	VIC5
ahormarían	ahormar	VIC6
ahormé	ahormar	VIX1
ahormaste	ahormar	VIX2
ahormó	ahormar	VIX3
ahormasteis	ahormar	VIX5
ahormaron	ahormar	VIX6
ahorme	ahormar	VSP1
ahormes	ahormar	VSP2
ahormemos	ahormar	VSP4
ahorméis	ahormar	VSP5
ahormen	ahormar	VSP6
ahormara	ahormar	VSX1
ahormaras	ahormar	VSX2
ahormáramos	ahormar	VSX4
ahormarais	ahormar	VSX5
ahormaran	ahormar	VSX6
ahormare	ahormar	VSF1
ahormares	ahormar	VSF2
ahormáremos	ahormar	VSF4
ahormareis	ahormar	VSF5
ahormaren	ahormar	VSF6
ahormase	ahormar	VSI1
ahormases	ahormar	VSI2
ahormásemos	ahormar	VSI4
ahormaseis	ahormar	VSI5
ahormasen	ahormar	VSI6
ahormad	ahormar	VMP
ahormadme	ahormar	VMSE
ahormadle	ahormar	VMSE
ahormadnos	ahormar	VMPE
ahormaos	ahormar	VMPE
ahormadles	ahormar	VMPE
ahormadlo	ahormar	VMMSE
ahormadla	ahormar	VMFSE
ahormadlos	ahormar	VMMPE
ahormadlas	ahormar	VMFPE
ahormádmelo	ahormar	VMMSE
ahormádselo	ahormar	VMMSE
ahormádnoslo	ahormar	VMMSE
ahormáoslo	ahormar	VMMSE
ahormádmelos	ahormar	VMMPE
ahormádselos	ahormar	VMMPE
ahormádnoslos	ahormar	VMMPE
ahormáoslos	ahormar	VMMPE
ahormádmela	ahormar	VMFSE
ahormádsela	ahormar	VMFSE
ahormádnosla	ahormar	VMFSE
ahormáosla	ahormar	VMFSE
ahormádmelas	ahormar	VMFPE
ahormádselas	ahormar	VMFPE
ahormádnoslas	ahormar	VMFPE
ahormáoslas	ahormar	VMFPE
ahormado	ahormar	VPM
ahormados	ahormar	VPMP
ahormada	ahormar	VPF
ahormadas	ahormar	VPFP
ahormando	ahormar	VG
ahormándome	ahormar	VGSE
ahormándote	ahormar	VGSE
ahormándole	ahormar	VGSE
ahormándonos	ahormar	VGPE
ahormándoos	ahormar	VGPE
ahormándolo	ahormar	VGMSE
ahormándola	ahormar	VGFSE
ahormándolos	ahormar	VGMPE
ahormándolas	ahormar	VGFPE
ahormándomelo	ahormar	VGMSE
ahormándotelo	ahormar	VGMSE
ahormándoselo	ahormar	VGMSE
ahormándonoslo	ahormar	VGMSE
ahormándooslo	ahormar	VGMSE
ahormándomelos	ahormar	VGMPE
ahormándotelos	ahormar	VGMPE
ahormándoselos	ahormar	VGMPE
ahormándonoslos	ahormar	VGMPE
ahormándooslos	ahormar	VGMPE
ahormándomela	ahormar	VGFSE
ahormándotela	ahormar	VGFSE
ahormándosela	ahormar	VGFSE
ahormándonosla	ahormar	VGFSE
ahormándoosla	ahormar	VGFSE
ahormándomelas	ahormar	VGFPE
ahormándotelas	ahormar	VGFPE
ahormándoselas	ahormar	VGFPE
ahormándonoslas	ahormar	VGFPE
ahormándooslas	ahormar	VGFPE
ahornagar	ahornagar	O
ahornago	ahornagar	VIP1
ahornagas	ahornagar	VIP2
ahornaga	ahornagar	VIP3
ahornagamos	ahornagar	VIP4
ahornagáis	ahornagar	VIP5
ahornagan	ahornagar	VIP6
ahornagaba	ahornagar	VII1
ahornagabas	ahornagar	VII2
ahornagábamos	ahornagar	VII4
ahornagabais	ahornagar	VII5
ahornagaban	ahornagar	VII6
ahornagaré	ahornagar	VIF1
ahornagarás	ahornagar	VIF2
ahornagará	ahornagar	VIF3
ahornagaremos	ahornagar	VIF4
ahornagaréis	ahornagar	VIF5
ahornagarán	ahornagar	VIF6
ahornagaría	ahornagar	VIC1
ahornagarías	ahornagar	VIC2
ahornagaría	ahornagar	VIC3
ahornagaríamos	ahornagar	VIC4
ahornagaríais	ahornagar	VIC5
ahornagarían	ahornagar	VIC6
ahornagé	ahornagar	VIX1
ahornagaste	ahornagar	VIX2
ahornagó	ahornagar	VIX3
ahornagasteis	ahornagar	VIX5
ahornagaron	ahornagar	VIX6
ahornague	ahornagar	VSP1
ahornagues	ahornagar	VSP2
ahornaguemos	ahornagar	VSP4
ahornaguéis	ahornagar	VSP5
ahornaguen	ahornagar	VSP6
ahornagara	ahornagar	VSX1
ahornagaras	ahornagar	VSX2
ahornagáramos	ahornagar	VSX4
ahornagarais	ahornagar	VSX5
ahornagaran	ahornagar	VSX6
ahornagare	ahornagar	VSF1
ahornagares	ahornagar	VSF2
ahornagáremos	ahornagar	VSF4
ahornagareis	ahornagar	VSF5
ahornagaren	ahornagar	VSF6
ahornagase	ahornagar	VSI1
ahornagases	ahornagar	VSI2
ahornagásemos	ahornagar	VSI4
ahornagaseis	ahornagar	VSI5
ahornagasen	ahornagar	VSI6
ahornagad	ahornagar	VMP
ahornagadme	ahornagar	VMSE
ahornagadle	ahornagar	VMSE
ahornagadnos	ahornagar	VMPE
ahornagaos	ahornagar	VMPE
ahornagadles	ahornagar	VMPE
ahornagado	ahornagar	VPM
ahornagados	ahornagar	VPMP
ahornagada	ahornagar	VPF
ahornagadas	ahornagar	VPFP
ahornagando	ahornagar	VG
ahornagándome	ahornagar	VGSE
ahornagándote	ahornagar	VGSE
ahornagándole	ahornagar	VGSE
ahornagándonos	ahornagar	VGPE
ahornagándoos	ahornagar	VGPE
ahornar	ahornar	O
ahorno	ahornar	VIP1
ahornas	ahornar	VIP2
ahorna	ahornar	VIP3
ahornamos	ahornar	VIP4
ahornáis	ahornar	VIP5
ahornan	ahornar	VIP6
ahornaba	ahornar	VII1
ahornabas	ahornar	VII2
ahornábamos	ahornar	VII4
ahornabais	ahornar	VII5
ahornaban	ahornar	VII6
ahornaré	ahornar	VIF1
ahornarás	ahornar	VIF2
ahornará	ahornar	VIF3
ahornaremos	ahornar	VIF4
ahornaréis	ahornar	VIF5
ahornarán	ahornar	VIF6
ahornaría	ahornar	VIC1
ahornarías	ahornar	VIC2
ahornaría	ahornar	VIC3
ahornaríamos	ahornar	VIC4
ahornaríais	ahornar	VIC5
ahornarían	ahornar	VIC6
ahorné	ahornar	VIX1
ahornaste	ahornar	VIX2
ahornó	ahornar	VIX3
ahornasteis	ahornar	VIX5
ahornaron	ahornar	VIX6
ahorne	ahornar	VSP1
ahornes	ahornar	VSP2
ahornemos	ahornar	VSP4
ahornéis	ahornar	VSP5
ahornen	ahornar	VSP6
ahornara	ahornar	VSX1
ahornaras	ahornar	VSX2
ahornáramos	ahornar	VSX4
ahornarais	ahornar	VSX5
ahornaran	ahornar	VSX6
ahornare	ahornar	VSF1
ahornares	ahornar	VSF2
ahornáremos	ahornar	VSF4
ahornareis	ahornar	VSF5
ahornaren	ahornar	VSF6
ahornase	ahornar	VSI1
ahornases	ahornar	VSI2
ahornásemos	ahornar	VSI4
ahornaseis	ahornar	VSI5
ahornasen	ahornar	VSI6
ahornad	ahornar	VMP
ahornadme	ahornar	VMSE
ahornadle	ahornar	VMSE
ahornadnos	ahornar	VMPE
ahornaos	ahornar	VMPE
ahornadles	ahornar	VMPE
ahornadlo	ahornar	VMMSE
ahornadla	ahornar	VMFSE
ahornadlos	ahornar	VMMPE
ahornadlas	ahornar	VMFPE
ahornádmelo	ahornar	VMMSE
ahornádselo	ahornar	VMMSE
ahornádnoslo	ahornar	VMMSE
ahornáoslo	ahornar	VMMSE
ahornádmelos	ahornar	VMMPE
ahornádselos	ahornar	VMMPE
ahornádnoslos	ahornar	VMMPE
ahornáoslos	ahornar	VMMPE
ahornádmela	ahornar	VMFSE
ahornádsela	ahornar	VMFSE
ahornádnosla	ahornar	VMFSE
ahornáosla	ahornar	VMFSE
ahornádmelas	ahornar	VMFPE
ahornádselas	ahornar	VMFPE
ahornádnoslas	ahornar	VMFPE
ahornáoslas	ahornar	VMFPE
ahornado	ahornar	VPM
ahornados	ahornar	VPMP
ahornada	ahornar	VPF
ahornadas	ahornar	VPFP
ahornando	ahornar	VG
ahornándome	ahornar	VGSE
ahornándote	ahornar	VGSE
ahornándole	ahornar	VGSE
ahornándonos	ahornar	VGPE
ahornándoos	ahornar	VGPE
ahornándolo	ahornar	VGMSE
ahornándola	ahornar	VGFSE
ahornándolos	ahornar	VGMPE
ahornándolas	ahornar	VGFPE
ahornándomelo	ahornar	VGMSE
ahornándotelo	ahornar	VGMSE
ahornándoselo	ahornar	VGMSE
ahornándonoslo	ahornar	VGMSE
ahornándooslo	ahornar	VGMSE
ahornándomelos	ahornar	VGMPE
ahornándotelos	ahornar	VGMPE
ahornándoselos	ahornar	VGMPE
ahornándonoslos	ahornar	VGMPE
ahornándooslos	ahornar	VGMPE
ahornándomela	ahornar	VGFSE
ahornándotela	ahornar	VGFSE
ahornándosela	ahornar	VGFSE
ahornándonosla	ahornar	VGFSE
ahornándoosla	ahornar	VGFSE
ahornándomelas	ahornar	VGFPE
ahornándotelas	ahornar	VGFPE
ahornándoselas	ahornar	VGFPE
ahornándonoslas	ahornar	VGFPE
ahornándooslas	ahornar	VGFPE
ahorquillar	ahorquillar	O
ahorquillo	ahorquillar	VIP1
ahorquillas	ahorquillar	VIP2
ahorquilla	ahorquillar	VIP3
ahorquillamos	ahorquillar	VIP4
ahorquilláis	ahorquillar	VIP5
ahorquillan	ahorquillar	VIP6
ahorquillaba	ahorquillar	VII1
ahorquillabas	ahorquillar	VII2
ahorquillábamos	ahorquillar	VII4
ahorquillabais	ahorquillar	VII5
ahorquillaban	ahorquillar	VII6
ahorquillaré	ahorquillar	VIF1
ahorquillarás	ahorquillar	VIF2
ahorquillará	ahorquillar	VIF3
ahorquillaremos	ahorquillar	VIF4
ahorquillaréis	ahorquillar	VIF5
ahorquillarán	ahorquillar	VIF6
ahorquillaría	ahorquillar	VIC1
ahorquillarías	ahorquillar	VIC2
ahorquillaría	ahorquillar	VIC3
ahorquillaríamos	ahorquillar	VIC4
ahorquillaríais	ahorquillar	VIC5
ahorquillarían	ahorquillar	VIC6
ahorquillé	ahorquillar	VIX1
ahorquillaste	ahorquillar	VIX2
ahorquilló	ahorquillar	VIX3
ahorquillasteis	ahorquillar	VIX5
ahorquillaron	ahorquillar	VIX6
ahorquille	ahorquillar	VSP1
ahorquilles	ahorquillar	VSP2
ahorquillemos	ahorquillar	VSP4
ahorquilléis	ahorquillar	VSP5
ahorquillen	ahorquillar	VSP6
ahorquillara	ahorquillar	VSX1
ahorquillaras	ahorquillar	VSX2
ahorquilláramos	ahorquillar	VSX4
ahorquillarais	ahorquillar	VSX5
ahorquillaran	ahorquillar	VSX6
ahorquillare	ahorquillar	VSF1
ahorquillares	ahorquillar	VSF2
ahorquilláremos	ahorquillar	VSF4
ahorquillareis	ahorquillar	VSF5
ahorquillaren	ahorquillar	VSF6
ahorquillase	ahorquillar	VSI1
ahorquillases	ahorquillar	VSI2
ahorquillásemos	ahorquillar	VSI4
ahorquillaseis	ahorquillar	VSI5
ahorquillasen	ahorquillar	VSI6
ahorquillad	ahorquillar	VMP
ahorquilladme	ahorquillar	VMSE
ahorquilladle	ahorquillar	VMSE
ahorquilladnos	ahorquillar	VMPE
ahorquillaos	ahorquillar	VMPE
ahorquilladles	ahorquillar	VMPE
ahorquilladlo	ahorquillar	VMMSE
ahorquilladla	ahorquillar	VMFSE
ahorquilladlos	ahorquillar	VMMPE
ahorquilladlas	ahorquillar	VMFPE
ahorquilládmelo	ahorquillar	VMMSE
ahorquilládselo	ahorquillar	VMMSE
ahorquilládnoslo	ahorquillar	VMMSE
ahorquilláoslo	ahorquillar	VMMSE
ahorquilládmelos	ahorquillar	VMMPE
ahorquilládselos	ahorquillar	VMMPE
ahorquilládnoslos	ahorquillar	VMMPE
ahorquilláoslos	ahorquillar	VMMPE
ahorquilládmela	ahorquillar	VMFSE
ahorquilládsela	ahorquillar	VMFSE
ahorquilládnosla	ahorquillar	VMFSE
ahorquilláosla	ahorquillar	VMFSE
ahorquilládmelas	ahorquillar	VMFPE
ahorquilládselas	ahorquillar	VMFPE
ahorquilládnoslas	ahorquillar	VMFPE
ahorquilláoslas	ahorquillar	VMFPE
ahorquillado	ahorquillar	VPM
ahorquillados	ahorquillar	VPMP
ahorquillada	ahorquillar	VPF
ahorquilladas	ahorquillar	VPFP
ahorquillando	ahorquillar	VG
ahorquillándome	ahorquillar	VGSE
ahorquillándote	ahorquillar	VGSE
ahorquillándole	ahorquillar	VGSE
ahorquillándonos	ahorquillar	VGPE
ahorquillándoos	ahorquillar	VGPE
ahorquillándolo	ahorquillar	VGMSE
ahorquillándola	ahorquillar	VGFSE
ahorquillándolos	ahorquillar	VGMPE
ahorquillándolas	ahorquillar	VGFPE
ahorquillándomelo	ahorquillar	VGMSE
ahorquillándotelo	ahorquillar	VGMSE
ahorquillándoselo	ahorquillar	VGMSE
ahorquillándonoslo	ahorquillar	VGMSE
ahorquillándooslo	ahorquillar	VGMSE
ahorquillándomelos	ahorquillar	VGMPE
ahorquillándotelos	ahorquillar	VGMPE
ahorquillándoselos	ahorquillar	VGMPE
ahorquillándonoslos	ahorquillar	VGMPE
ahorquillándooslos	ahorquillar	VGMPE
ahorquillándomela	ahorquillar	VGFSE
ahorquillándotela	ahorquillar	VGFSE
ahorquillándosela	ahorquillar	VGFSE
ahorquillándonosla	ahorquillar	VGFSE
ahorquillándoosla	ahorquillar	VGFSE
ahorquillándomelas	ahorquillar	VGFPE
ahorquillándotelas	ahorquillar	VGFPE
ahorquillándoselas	ahorquillar	VGFPE
ahorquillándonoslas	ahorquillar	VGFPE
ahorquillándooslas	ahorquillar	VGFPE
ahorquillares	ahorquillar	P
ahorrar	ahorrar	O
ahorro	ahorrar	VIP1
ahorras	ahorrar	VIP2
ahorra	ahorrar	VIP3
ahorramos	ahorrar	VIP4
ahorráis	ahorrar	VIP5
ahorran	ahorrar	VIP6
ahorraba	ahorrar	VII1
ahorrabas	ahorrar	VII2
ahorrábamos	ahorrar	VII4
ahorrabais	ahorrar	VII5
ahorraban	ahorrar	VII6
ahorraré	ahorrar	VIF1
ahorrarás	ahorrar	VIF2
ahorrará	ahorrar	VIF3
ahorraremos	ahorrar	VIF4
ahorraréis	ahorrar	VIF5
ahorrarán	ahorrar	VIF6
ahorraría	ahorrar	VIC1
ahorrarías	ahorrar	VIC2
ahorraría	ahorrar	VIC3
ahorraríamos	ahorrar	VIC4
ahorraríais	ahorrar	VIC5
ahorrarían	ahorrar	VIC6
ahorré	ahorrar	VIX1
ahorraste	ahorrar	VIX2
ahorró	ahorrar	VIX3
ahorrasteis	ahorrar	VIX5
ahorraron	ahorrar	VIX6
ahorre	ahorrar	VSP1
ahorres	ahorrar	VSP2
ahorremos	ahorrar	VSP4
ahorréis	ahorrar	VSP5
ahorren	ahorrar	VSP6
ahorrara	ahorrar	VSX1
ahorraras	ahorrar	VSX2
ahorráramos	ahorrar	VSX4
ahorrarais	ahorrar	VSX5
ahorraran	ahorrar	VSX6
ahorrare	ahorrar	VSF1
ahorrares	ahorrar	VSF2
ahorráremos	ahorrar	VSF4
ahorrareis	ahorrar	VSF5
ahorraren	ahorrar	VSF6
ahorrase	ahorrar	VSI1
ahorrases	ahorrar	VSI2
ahorrásemos	ahorrar	VSI4
ahorraseis	ahorrar	VSI5
ahorrasen	ahorrar	VSI6
ahorrad	ahorrar	VMP
ahorradme	ahorrar	VMSE
ahorradle	ahorrar	VMSE
ahorradnos	ahorrar	VMPE
ahorraos	ahorrar	VMPE
ahorradles	ahorrar	VMPE
ahorradlo	ahorrar	VMMSE
ahorradla	ahorrar	VMFSE
ahorradlos	ahorrar	VMMPE
ahorradlas	ahorrar	VMFPE
ahorrádmelo	ahorrar	VMMSE
ahorrádselo	ahorrar	VMMSE
ahorrádnoslo	ahorrar	VMMSE
ahorráoslo	ahorrar	VMMSE
ahorrádmelos	ahorrar	VMMPE
ahorrádselos	ahorrar	VMMPE
ahorrádnoslos	ahorrar	VMMPE
ahorráoslos	ahorrar	VMMPE
ahorrádmela	ahorrar	VMFSE
ahorrádsela	ahorrar	VMFSE
ahorrádnosla	ahorrar	VMFSE
ahorráosla	ahorrar	VMFSE
ahorrádmelas	ahorrar	VMFPE
ahorrádselas	ahorrar	VMFPE
ahorrádnoslas	ahorrar	VMFPE
ahorráoslas	ahorrar	VMFPE
ahorrado	ahorrar	VPM
ahorrados	ahorrar	VPMP
ahorrada	ahorrar	VPF
ahorradas	ahorrar	VPFP
ahorrando	ahorrar	VG
ahorrándome	ahorrar	VGSE
ahorrándote	ahorrar	VGSE
ahorrándole	ahorrar	VGSE
ahorrándonos	ahorrar	VGPE
ahorrándoos	ahorrar	VGPE
ahorrándolo	ahorrar	VGMSE
ahorrándola	ahorrar	VGFSE
ahorrándolos	ahorrar	VGMPE
ahorrándolas	ahorrar	VGFPE
ahorrándomelo	ahorrar	VGMSE
ahorrándotelo	ahorrar	VGMSE
ahorrándoselo	ahorrar	VGMSE
ahorrándonoslo	ahorrar	VGMSE
ahorrándooslo	ahorrar	VGMSE
ahorrándomelos	ahorrar	VGMPE
ahorrándotelos	ahorrar	VGMPE
ahorrándoselos	ahorrar	VGMPE
ahorrándonoslos	ahorrar	VGMPE
ahorrándooslos	ahorrar	VGMPE
ahorrándomela	ahorrar	VGFSE
ahorrándotela	ahorrar	VGFSE
ahorrándosela	ahorrar	VGFSE
ahorrándonosla	ahorrar	VGFSE
ahorrándoosla	ahorrar	VGFSE
ahorrándomelas	ahorrar	VGFPE
ahorrándotelas	ahorrar	VGFPE
ahorrándoselas	ahorrar	VGFPE
ahorrándonoslas	ahorrar	VGFPE
ahorrándooslas	ahorrar	VGFPE
ahotar	ahotar	O
ahoto	ahotar	VIP1
ahotas	ahotar	VIP2
ahota	ahotar	VIP3
ahotamos	ahotar	VIP4
ahotáis	ahotar	VIP5
ahotan	ahotar	VIP6
ahotaba	ahotar	VII1
ahotabas	ahotar	VII2
ahotábamos	ahotar	VII4
ahotabais	ahotar	VII5
ahotaban	ahotar	VII6
ahotaré	ahotar	VIF1
ahotarás	ahotar	VIF2
ahotará	ahotar	VIF3
ahotaremos	ahotar	VIF4
ahotaréis	ahotar	VIF5
ahotarán	ahotar	VIF6
ahotaría	ahotar	VIC1
ahotarías	ahotar	VIC2
ahotaría	ahotar	VIC3
ahotaríamos	ahotar	VIC4
ahotaríais	ahotar	VIC5
ahotarían	ahotar	VIC6
ahoté	ahotar	VIX1
ahotaste	ahotar	VIX2
ahotó	ahotar	VIX3
ahotasteis	ahotar	VIX5
ahotaron	ahotar	VIX6
ahote	ahotar	VSP1
ahotes	ahotar	VSP2
ahotemos	ahotar	VSP4
ahotéis	ahotar	VSP5
ahoten	ahotar	VSP6
ahotara	ahotar	VSX1
ahotaras	ahotar	VSX2
ahotáramos	ahotar	VSX4
ahotarais	ahotar	VSX5
ahotaran	ahotar	VSX6
ahotare	ahotar	VSF1
ahotares	ahotar	VSF2
ahotáremos	ahotar	VSF4
ahotareis	ahotar	VSF5
ahotaren	ahotar	VSF6
ahotase	ahotar	VSI1
ahotases	ahotar	VSI2
ahotásemos	ahotar	VSI4
ahotaseis	ahotar	VSI5
ahotasen	ahotar	VSI6
ahotad	ahotar	VMP
ahotadme	ahotar	VMSE
ahotadle	ahotar	VMSE
ahotadnos	ahotar	VMPE
ahotaos	ahotar	VMPE
ahotadles	ahotar	VMPE
ahotadlo	ahotar	VMMSE
ahotadla	ahotar	VMFSE
ahotadlos	ahotar	VMMPE
ahotadlas	ahotar	VMFPE
ahotádmelo	ahotar	VMMSE
ahotádselo	ahotar	VMMSE
ahotádnoslo	ahotar	VMMSE
ahotáoslo	ahotar	VMMSE
ahotádmelos	ahotar	VMMPE
ahotádselos	ahotar	VMMPE
ahotádnoslos	ahotar	VMMPE
ahotáoslos	ahotar	VMMPE
ahotádmela	ahotar	VMFSE
ahotádsela	ahotar	VMFSE
ahotádnosla	ahotar	VMFSE
ahotáosla	ahotar	VMFSE
ahotádmelas	ahotar	VMFPE
ahotádselas	ahotar	VMFPE
ahotádnoslas	ahotar	VMFPE
ahotáoslas	ahotar	VMFPE
ahotado	ahotar	VPM
ahotados	ahotar	VPMP
ahotada	ahotar	VPF
ahotadas	ahotar	VPFP
ahotando	ahotar	VG
ahotándome	ahotar	VGSE
ahotándote	ahotar	VGSE
ahotándole	ahotar	VGSE
ahotándonos	ahotar	VGPE
ahotándoos	ahotar	VGPE
ahotándolo	ahotar	VGMSE
ahotándola	ahotar	VGFSE
ahotándolos	ahotar	VGMPE
ahotándolas	ahotar	VGFPE
ahotándomelo	ahotar	VGMSE
ahotándotelo	ahotar	VGMSE
ahotándoselo	ahotar	VGMSE
ahotándonoslo	ahotar	VGMSE
ahotándooslo	ahotar	VGMSE
ahotándomelos	ahotar	VGMPE
ahotándotelos	ahotar	VGMPE
ahotándoselos	ahotar	VGMPE
ahotándonoslos	ahotar	VGMPE
ahotándooslos	ahotar	VGMPE
ahotándomela	ahotar	VGFSE
ahotándotela	ahotar	VGFSE
ahotándosela	ahotar	VGFSE
ahotándonosla	ahotar	VGFSE
ahotándoosla	ahotar	VGFSE
ahotándomelas	ahotar	VGFPE
ahotándotelas	ahotar	VGFPE
ahotándoselas	ahotar	VGFPE
ahotándonoslas	ahotar	VGFPE
ahotándooslas	ahotar	VGFPE
ahoyar	ahoyar	O
ahoyo	ahoyar	VIP1
ahoyas	ahoyar	VIP2
ahoya	ahoyar	VIP3
ahoyamos	ahoyar	VIP4
ahoyáis	ahoyar	VIP5
ahoyan	ahoyar	VIP6
ahoyaba	ahoyar	VII1
ahoyabas	ahoyar	VII2
ahoyábamos	ahoyar	VII4
ahoyabais	ahoyar	VII5
ahoyaban	ahoyar	VII6
ahoyaré	ahoyar	VIF1
ahoyarás	ahoyar	VIF2
ahoyará	ahoyar	VIF3
ahoyaremos	ahoyar	VIF4
ahoyaréis	ahoyar	VIF5
ahoyarán	ahoyar	VIF6
ahoyaría	ahoyar	VIC1
ahoyarías	ahoyar	VIC2
ahoyaría	ahoyar	VIC3
ahoyaríamos	ahoyar	VIC4
ahoyaríais	ahoyar	VIC5
ahoyarían	ahoyar	VIC6
ahoyé	ahoyar	VIX1
ahoyaste	ahoyar	VIX2
ahoyó	ahoyar	VIX3
ahoyasteis	ahoyar	VIX5
ahoyaron	ahoyar	VIX6
ahoye	ahoyar	VSP1
ahoyes	ahoyar	VSP2
ahoyemos	ahoyar	VSP4
ahoyéis	ahoyar	VSP5
ahoyen	ahoyar	VSP6
ahoyara	ahoyar	VSX1
ahoyaras	ahoyar	VSX2
ahoyáramos	ahoyar	VSX4
ahoyarais	ahoyar	VSX5
ahoyaran	ahoyar	VSX6
ahoyare	ahoyar	VSF1
ahoyares	ahoyar	VSF2
ahoyáremos	ahoyar	VSF4
ahoyareis	ahoyar	VSF5
ahoyaren	ahoyar	VSF6
ahoyase	ahoyar	VSI1
ahoyases	ahoyar	VSI2
ahoyásemos	ahoyar	VSI4
ahoyaseis	ahoyar	VSI5
ahoyasen	ahoyar	VSI6
ahoyad	ahoyar	VMP
ahoyadme	ahoyar	VMSE
ahoyadle	ahoyar	VMSE
ahoyadnos	ahoyar	VMPE
ahoyaos	ahoyar	VMPE
ahoyadles	ahoyar	VMPE
ahoyado	ahoyar	VPM
ahoyados	ahoyar	VPMP
ahoyada	ahoyar	VPF
ahoyadas	ahoyar	VPFP
ahoyando	ahoyar	VG
ahoyándome	ahoyar	VGSE
ahoyándote	ahoyar	VGSE
ahoyándole	ahoyar	VGSE
ahoyándonos	ahoyar	VGPE
ahoyándoos	ahoyar	VGPE
