apraxia	apraxia	O
apraxias	apraxia	P
apreciabilidad	apreciabilidad	O
apreciabilidades	apreciabilidad	P
apreciable	apreciable	O
apreciables	apreciable	P
apreciación	apreciación	O
apreciaciones	apreciación	P
apreciadamente	apreciadamente	O
apreciador	apreciador	O
apreciadoras	apreciador	FP
apreciadora	apreciador	F
apreciadores	apreciador	P
apreciativo	apreciativo	O
apreciativas	apreciativo	FP
apreciativa	apreciativo	F
apreciativos	apreciativo	P
aprecio	aprecio	O
aprecios	aprecio	P
aprehensivo	aprehensivo	O
aprehensivas	aprehensivo	FP
aprehensiva	aprehensivo	F
aprehensivos	aprehensivo	P
aprehensión	aprehensión	O
aprehensiones	aprehensión	P
aprehensor	aprehensor	O
aprehensoras	aprehensor	FP
aprehensora	aprehensor	F
aprehensores	aprehensor	P
aprehensorio	aprehensorio	O
aprehensorias	aprehensorio	FP
aprehensoria	aprehensorio	F
aprehensorios	aprehensorio	P
apremiadamente	apremiadamente	O
apremiador	apremiador	O
apremiadoras	apremiador	FP
apremiadora	apremiador	F
apremiadores	apremiador	P
apremiamiento	apremiamiento	O
apremiamientos	apremiamiento	P
apremiante	apremiante	O
apremiantes	apremiante	P
apremiantemente	apremiantemente	O
apremio	apremio	O
apremios	apremio	P
aprendedor	aprendedor	O
aprendedoras	aprendedor	FP
aprendedora	aprendedor	F
aprendedores	aprendedor	P
aprendiente	aprendiente	O
aprendientes	aprendiente	P
aprendiz	aprendiz	O
aprendizas	aprendiz	FP
aprendiza	aprendiz	F
aprendices	aprendiz	P
aprendizaje	aprendizaje	O
aprendizajes	aprendizaje	P
aprensador	aprensador	O
aprensadoras	aprensador	FP
aprensadora	aprensador	F
aprensadores	aprensador	P
aprensadura	aprensadura	O
aprensaduras	aprensadura	P
aprensivo	aprensivo	O
aprensivas	aprensivo	FP
aprensiva	aprensivo	F
aprensivos	aprensivo	P
aprensión	aprensión	O
aprensiones	aprensión	P
apresador	apresador	O
apresadoras	apresador	FP
apresadora	apresador	F
apresadores	apresador	P
apresamiento	apresamiento	O
apresamientos	apresamiento	P
apresivamente	apresivamente	O
apreso	apreso	O
apresas	apreso	FP
apresa	apreso	F
apresos	apreso	P
apresto	apresto	O
aprestos	apresto	P
apresura	apresura	O
apresuras	apresura	P
apresuración	apresuración	O
apresuraciones	apresuración	P
apresurado	apresurado	O
apresuradas	apresurado	FP
apresurada	apresurado	F
apresurados	apresurado	P
apresuramiento	apresuramiento	O
apresuramientos	apresuramiento	P
apretadamente	apretadamente	O
apretadero	apretadero	O
apretaderas	apretadero	FP
apretadera	apretadero	F
apretaderos	apretadero	P
apretadizo	apretadizo	O
apretadizas	apretadizo	FP
apretadiza	apretadizo	F
apretadizos	apretadizo	P
apretado	apretado	O
apretadas	apretado	FP
apretada	apretado	F
apretados	apretado	P
apretador	apretador	O
apretadoras	apretador	FP
apretadora	apretador	F
apretadores	apretador	P
apretadura	apretadura	O
apretaduras	apretadura	P
apretamiento	apretamiento	O
apretamientos	apretamiento	P
apretujamiento	apretujamiento	O
apretujamientos	apretujamiento	P
apretujón	apretujón	O
apretujones	apretujón	P
apretura	apretura	O
apreturas	apretura	P
apretón	apretón	O
apretones	apretón	P
apriesa	apriesa	O
aprieto	aprieto	O
aprietos	aprieto	P
apriorismo	apriorismo	O
apriorismos	apriorismo	P
apriorístico	apriorístico	O
apriorísticas	apriorístico	FP
apriorística	apriorístico	F
apriorísticos	apriorístico	P
aprisa	aprisa	O
aprisco	aprisco	O
apriscos	aprisco	P
aprisionamiento	aprisionamiento	O
aprisionamientos	aprisionamiento	P
aprobación	aprobación	O
aprobaciones	aprobación	P
aprobado	aprobado	O
aprobados	aprobado	P
aprobador	aprobador	O
aprobadoras	aprobador	FP
aprobadora	aprobador	F
aprobadores	aprobador	P
aprobante	aprobante	O
aprobantes	aprobante	P
aprobanza	aprobanza	O
aprobanzas	aprobanza	P
aprobativo	aprobativo	O
aprobativas	aprobativo	FP
aprobativa	aprobativo	F
aprobativos	aprobativo	P
aprobatorio	aprobatorio	O
aprobatorias	aprobatorio	FP
aprobatoria	aprobatorio	F
aprobatorios	aprobatorio	P
aproches	aproches	O
aprontamiento	aprontamiento	O
aprontamientos	aprontamiento	P
apronte	apronte	O
aprontes	apronte	P
apropiable	apropiable	O
apropiables	apropiable	P
apropiación	apropiación	O
apropiaciones	apropiación	P
apropiadamente	apropiadamente	O
apropiador	apropiador	O
apropiadoras	apropiador	FP
apropiadora	apropiador	F
apropiadores	apropiador	P
apropincuación	apropincuación	O
apropincuaciones	apropincuación	P
apropósito	apropósito	O
apropósitos	apropósito	P
aprovechable	aprovechable	O
aprovechables	aprovechable	P
aprovechadamente	aprovechadamente	O
aprovechado	aprovechado	O
aprovechadas	aprovechado	FP
aprovechada	aprovechado	F
aprovechados	aprovechado	P
aprovechador	aprovechador	O
aprovechadoras	aprovechador	FP
aprovechadora	aprovechador	F
aprovechadores	aprovechador	P
aprovechamiento	aprovechamiento	O
aprovechamientos	aprovechamiento	P
aprovechante	aprovechante	O
aprovechantes	aprovechante	P
aprovecimiento	aprovecimiento	O
aprovecimientos	aprovecimiento	P
aprovisionamiento	aprovisionamiento	O
aprovisionamientos	aprovisionamiento	P
aproximación	aproximación	O
aproximaciones	aproximación	P
aproximadamente	aproximadamente	O
aproximado	aproximado	O
aproximadas	aproximado	FP
aproximada	aproximado	F
aproximados	aproximado	P
aproximativo	aproximativo	O
aproximativas	aproximativo	FP
aproximativa	aproximativo	F
aproximativos	aproximativo	P
aproxis	aproxis	O
aprés	aprés	O
apremir	apremir	O
apremo	apremir	VIP1
apremes	apremir	VIP2
apreme	apremir	VIP3
apremimos	apremir	VIP4
apremís	apremir	VIP5
apremen	apremir	VIP6
apremía	apremir	VII1
apremías	apremir	VII2
apremíamos	apremir	VII4
apremíais	apremir	VII5
apremían	apremir	VII6
apremiré	apremir	VIF1
apremirás	apremir	VIF2
apremirá	apremir	VIF3
apremiremos	apremir	VIF4
apremiréis	apremir	VIF5
apremirán	apremir	VIF6
apremiría	apremir	VIC1
apremirías	apremir	VIC2
apremiría	apremir	VIC3
apremiríamos	apremir	VIC4
apremiríais	apremir	VIC5
apremirían	apremir	VIC6
apremí	apremir	VIX1
apremiste	apremir	VIX2
apremió	apremir	VIX3
apremisteis	apremir	VIX5
apremieron	apremir	VIX6
aprema	apremir	VSP1
apremas	apremir	VSP2
apremamos	apremir	VSP4
apremáis	apremir	VSP5
apreman	apremir	VSP6
apremiera	apremir	VSX1
apremieras	apremir	VSX2
apremiéramos	apremir	VSX4
apremierais	apremir	VSX5
apremieran	apremir	VSX6
apremiere	apremir	VSF1
apremieres	apremir	VSF2
apremiéremos	apremir	VSF4
apremiereis	apremir	VSF5
apremieren	apremir	VSF6
apremiese	apremir	VSI1
apremieses	apremir	VSI2
apremiésemos	apremir	VSI4
apremieseis	apremir	VSI5
apremiesen	apremir	VSI6
apremid	apremir	VMP
apremidme	apremir	VMSE
apremidle	apremir	VMSE
apremidnos	apremir	VMPE
apremios	apremir	VMPE
apremidles	apremir	VMPE
apremidlo	apremir	VMMSE
apremidla	apremir	VMFSE
apremidlos	apremir	VMMPE
apremidlas	apremir	VMFPE
apremídmelo	apremir	VMMSE
apremídselo	apremir	VMMSE
apremídnoslo	apremir	VMMSE
apremíoslo	apremir	VMMSE
apremídmelos	apremir	VMMPE
apremídselos	apremir	VMMPE
apremídnoslos	apremir	VMMPE
apremíoslos	apremir	VMMPE
apremídmela	apremir	VMFSE
apremídsela	apremir	VMFSE
apremídnosla	apremir	VMFSE
apremíosla	apremir	VMFSE
apremídmelas	apremir	VMFPE
apremídselas	apremir	VMFPE
apremídnoslas	apremir	VMFPE
apremíoslas	apremir	VMFPE
apremido	apremir	VPM
apremidos	apremir	VPMP
apremida	apremir	VPF
apremidas	apremir	VPFP
apremiendo	apremir	VG
apremiéndome	apremir	VGSE
apremiéndote	apremir	VGSE
apremiéndole	apremir	VGSE
apremiéndonos	apremir	VGPE
apremiéndoos	apremir	VGPE
apremiéndolo	apremir	VGMSE
apremiéndola	apremir	VGFSE
apremiéndolos	apremir	VGMPE
apremiéndolas	apremir	VGFPE
apremiéndomelo	apremir	VGMSE
apremiéndotelo	apremir	VGMSE
apremiéndoselo	apremir	VGMSE
apremiéndonoslo	apremir	VGMSE
apremiéndooslo	apremir	VGMSE
apremiéndomelos	apremir	VGMPE
apremiéndotelos	apremir	VGMPE
apremiéndoselos	apremir	VGMPE
apremiéndonoslos	apremir	VGMPE
apremiéndooslos	apremir	VGMPE
apremiéndomela	apremir	VGFSE
apremiéndotela	apremir	VGFSE
apremiéndosela	apremir	VGFSE
apremiéndonosla	apremir	VGFSE
apremiéndoosla	apremir	VGFSE
apremiéndomelas	apremir	VGFPE
apremiéndotelas	apremir	VGFPE
apremiéndoselas	apremir	VGFPE
apremiéndonoslas	apremir	VGFPE
apremiéndooslas	apremir	VGFPE
aprevenir	aprevenir	O
aprevienes	aprevenir	VIP2
apreviene	aprevenir	VIP3
aprevenimos	aprevenir	VIP4
aprevenís	aprevenir	VIP5
aprevienen	aprevenir	VIP6
aprevenía	aprevenir	VII1
aprevenías	aprevenir	VII2
apreveníamos	aprevenir	VII4
apreveníais	aprevenir	VII5
aprevenían	aprevenir	VII6
aprevenid	aprevenir	VMP
aprevenidme	aprevenir	VMSE
aprevenidle	aprevenir	VMSE
aprevenidnos	aprevenir	VMPE
aprevenios	aprevenir	VMPE
aprevenidles	aprevenir	VMPE
aprevenidlo	aprevenir	VMMSE
aprevenidla	aprevenir	VMFSE
aprevenidlos	aprevenir	VMMPE
aprevenidlas	aprevenir	VMFPE
aprevenídmelo	aprevenir	VMMSE
aprevenídselo	aprevenir	VMMSE
aprevenídnoslo	aprevenir	VMMSE
apreveníoslo	aprevenir	VMMSE
aprevenídmelos	aprevenir	VMMPE
aprevenídselos	aprevenir	VMMPE
aprevenídnoslos	aprevenir	VMMPE
apreveníoslos	aprevenir	VMMPE
aprevenídmela	aprevenir	VMFSE
aprevenídsela	aprevenir	VMFSE
aprevenídnosla	aprevenir	VMFSE
apreveníosla	aprevenir	VMFSE
aprevenídmelas	aprevenir	VMFPE
aprevenídselas	aprevenir	VMFPE
aprevenídnoslas	aprevenir	VMFPE
apreveníoslas	aprevenir	VMFPE
aprevenido	aprevenir	VPM
aprevenidos	aprevenir	VPMP
aprevenida	aprevenir	VPF
aprevenidas	aprevenir	VPFP
apreviniendo	aprevenir	VG
apreviniéndome	aprevenir	VGSE
apreviniéndote	aprevenir	VGSE
apreviniéndole	aprevenir	VGSE
apreviniéndonos	aprevenir	VGPE
apreviniéndoos	aprevenir	VGPE
apreviniéndolo	aprevenir	VGMSE
apreviniéndola	aprevenir	VGFSE
apreviniéndolos	aprevenir	VGMPE
apreviniéndolas	aprevenir	VGFPE
apreviniéndomelo	aprevenir	VGMSE
apreviniéndotelo	aprevenir	VGMSE
apreviniéndoselo	aprevenir	VGMSE
apreviniéndonoslo	aprevenir	VGMSE
apreviniéndooslo	aprevenir	VGMSE
apreviniéndomelos	aprevenir	VGMPE
apreviniéndotelos	aprevenir	VGMPE
apreviniéndoselos	aprevenir	VGMPE
apreviniéndonoslos	aprevenir	VGMPE
apreviniéndooslos	aprevenir	VGMPE
apreviniéndomela	aprevenir	VGFSE
apreviniéndotela	aprevenir	VGFSE
apreviniéndosela	aprevenir	VGFSE
apreviniéndonosla	aprevenir	VGFSE
apreviniéndoosla	aprevenir	VGFSE
apreviniéndomelas	aprevenir	VGFPE
apreviniéndotelas	aprevenir	VGFPE
apreviniéndoselas	aprevenir	VGFPE
apreviniéndonoslas	aprevenir	VGFPE
apreviniéndooslas	aprevenir	VGFPE
aprehender	aprehender	O
aprehendo	aprehender	VIP1
aprehendes	aprehender	VIP2
aprehende	aprehender	VIP3
aprehendemos	aprehender	VIP4
aprehendéis	aprehender	VIP5
aprehenden	aprehender	VIP6
aprehendía	aprehender	VII1
aprehendías	aprehender	VII2
aprehendíamos	aprehender	VII4
aprehendíais	aprehender	VII5
aprehendían	aprehender	VII6
aprehenderé	aprehender	VIF1
aprehenderás	aprehender	VIF2
aprehenderá	aprehender	VIF3
aprehenderemos	aprehender	VIF4
aprehenderéis	aprehender	VIF5
aprehenderán	aprehender	VIF6
aprehendería	aprehender	VIC1
aprehenderías	aprehender	VIC2
aprehendería	aprehender	VIC3
aprehenderíamos	aprehender	VIC4
aprehenderíais	aprehender	VIC5
aprehenderían	aprehender	VIC6
aprehendí	aprehender	VIX1
aprehendiste	aprehender	VIX2
aprehendió	aprehender	VIX3
aprehendisteis	aprehender	VIX5
aprehendieron	aprehender	VIX6
aprehenda	aprehender	VSP1
aprehendas	aprehender	VSP2
aprehendamos	aprehender	VSP4
aprehendáis	aprehender	VSP5
aprehendan	aprehender	VSP6
aprehendiera	aprehender	VSX1
aprehendieras	aprehender	VSX2
aprehendiéramos	aprehender	VSX4
aprehendierais	aprehender	VSX5
aprehendieran	aprehender	VSX6
aprehendiere	aprehender	VSF1
aprehendieres	aprehender	VSF2
aprehendiéremos	aprehender	VSF4
aprehendiereis	aprehender	VSF5
aprehendieren	aprehender	VSF6
aprehendiese	aprehender	VSI1
aprehendieses	aprehender	VSI2
aprehendiésemos	aprehender	VSI4
aprehendieseis	aprehender	VSI5
aprehendiesen	aprehender	VSI6
aprehended	aprehender	VMP
aprehendedme	aprehender	VMSE
aprehendedle	aprehender	VMSE
aprehendednos	aprehender	VMPE
aprehendeos	aprehender	VMPE
aprehendedles	aprehender	VMPE
aprehendedlo	aprehender	VMMSE
aprehendedla	aprehender	VMFSE
aprehendedlos	aprehender	VMMPE
aprehendedlas	aprehender	VMFPE
aprehendédmelo	aprehender	VMMSE
aprehendédselo	aprehender	VMMSE
aprehendédnoslo	aprehender	VMMSE
aprehendéoslo	aprehender	VMMSE
aprehendédmelos	aprehender	VMMPE
aprehendédselos	aprehender	VMMPE
aprehendédnoslos	aprehender	VMMPE
aprehendéoslos	aprehender	VMMPE
aprehendédmela	aprehender	VMFSE
aprehendédsela	aprehender	VMFSE
aprehendédnosla	aprehender	VMFSE
aprehendéosla	aprehender	VMFSE
aprehendédmelas	aprehender	VMFPE
aprehendédselas	aprehender	VMFPE
aprehendédnoslas	aprehender	VMFPE
aprehendéoslas	aprehender	VMFPE
aprehendido	aprehender	VPM
aprehendidos	aprehender	VPMP
aprehendida	aprehender	VPF
aprehendidas	aprehender	VPFP
aprehendiendo	aprehender	VG
aprehendiéndome	aprehender	VGSE
aprehendiéndote	aprehender	VGSE
aprehendiéndole	aprehender	VGSE
aprehendiéndonos	aprehender	VGPE
aprehendiéndoos	aprehender	VGPE
aprehendiéndolo	aprehender	VGMSE
aprehendiéndola	aprehender	VGFSE
aprehendiéndolos	aprehender	VGMPE
aprehendiéndolas	aprehender	VGFPE
aprehendiéndomelo	aprehender	VGMSE
aprehendiéndotelo	aprehender	VGMSE
aprehendiéndoselo	aprehender	VGMSE
aprehendiéndonoslo	aprehender	VGMSE
aprehendiéndooslo	aprehender	VGMSE
aprehendiéndomelos	aprehender	VGMPE
aprehendiéndotelos	aprehender	VGMPE
aprehendiéndoselos	aprehender	VGMPE
aprehendiéndonoslos	aprehender	VGMPE
aprehendiéndooslos	aprehender	VGMPE
aprehendiéndomela	aprehender	VGFSE
aprehendiéndotela	aprehender	VGFSE
aprehendiéndosela	aprehender	VGFSE
aprehendiéndonosla	aprehender	VGFSE
aprehendiéndoosla	aprehender	VGFSE
aprehendiéndomelas	aprehender	VGFPE
aprehendiéndotelas	aprehender	VGFPE
aprehendiéndoselas	aprehender	VGFPE
aprehendiéndonoslas	aprehender	VGFPE
aprehendiéndooslas	aprehender	VGFPE
aprender	aprender	O
aprendo	aprender	VIP1
aprendes	aprender	VIP2
aprende	aprender	VIP3
aprendemos	aprender	VIP4
aprendéis	aprender	VIP5
aprenden	aprender	VIP6
aprendía	aprender	VII1
aprendías	aprender	VII2
aprendíamos	aprender	VII4
aprendíais	aprender	VII5
aprendían	aprender	VII6
aprenderé	aprender	VIF1
aprenderás	aprender	VIF2
aprenderá	aprender	VIF3
aprenderemos	aprender	VIF4
aprenderéis	aprender	VIF5
aprenderán	aprender	VIF6
aprendería	aprender	VIC1
aprenderías	aprender	VIC2
aprendería	aprender	VIC3
aprenderíamos	aprender	VIC4
aprenderíais	aprender	VIC5
aprenderían	aprender	VIC6
aprendí	aprender	VIX1
aprendiste	aprender	VIX2
aprendió	aprender	VIX3
aprendisteis	aprender	VIX5
aprendieron	aprender	VIX6
aprenda	aprender	VSP1
aprendas	aprender	VSP2
aprendamos	aprender	VSP4
aprendáis	aprender	VSP5
aprendan	aprender	VSP6
aprendiera	aprender	VSX1
aprendieras	aprender	VSX2
aprendiéramos	aprender	VSX4
aprendierais	aprender	VSX5
aprendieran	aprender	VSX6
aprendiere	aprender	VSF1
aprendieres	aprender	VSF2
aprendiéremos	aprender	VSF4
aprendiereis	aprender	VSF5
aprendieren	aprender	VSF6
aprendiese	aprender	VSI1
aprendieses	aprender	VSI2
aprendiésemos	aprender	VSI4
aprendieseis	aprender	VSI5
aprendiesen	aprender	VSI6
aprended	aprender	VMP
aprendedme	aprender	VMSE
aprendedle	aprender	VMSE
aprendednos	aprender	VMPE
aprendeos	aprender	VMPE
aprendedles	aprender	VMPE
aprendedlo	aprender	VMMSE
aprendedla	aprender	VMFSE
aprendedlos	aprender	VMMPE
aprendedlas	aprender	VMFPE
aprendédmelo	aprender	VMMSE
aprendédselo	aprender	VMMSE
aprendédnoslo	aprender	VMMSE
aprendéoslo	aprender	VMMSE
aprendédmelos	aprender	VMMPE
aprendédselos	aprender	VMMPE
aprendédnoslos	aprender	VMMPE
aprendéoslos	aprender	VMMPE
aprendédmela	aprender	VMFSE
aprendédsela	aprender	VMFSE
aprendédnosla	aprender	VMFSE
aprendéosla	aprender	VMFSE
aprendédmelas	aprender	VMFPE
aprendédselas	aprender	VMFPE
aprendédnoslas	aprender	VMFPE
aprendéoslas	aprender	VMFPE
aprendido	aprender	VPM
aprendidos	aprender	VPMP
aprendida	aprender	VPF
aprendidas	aprender	VPFP
aprendiendo	aprender	VG
aprendiéndome	aprender	VGSE
aprendiéndote	aprender	VGSE
aprendiéndole	aprender	VGSE
aprendiéndonos	aprender	VGPE
aprendiéndoos	aprender	VGPE
aprendiéndolo	aprender	VGMSE
aprendiéndola	aprender	VGFSE
aprendiéndolos	aprender	VGMPE
aprendiéndolas	aprender	VGFPE
aprendiéndomelo	aprender	VGMSE
aprendiéndotelo	aprender	VGMSE
aprendiéndoselo	aprender	VGMSE
aprendiéndonoslo	aprender	VGMSE
aprendiéndooslo	aprender	VGMSE
aprendiéndomelos	aprender	VGMPE
aprendiéndotelos	aprender	VGMPE
aprendiéndoselos	aprender	VGMPE
aprendiéndonoslos	aprender	VGMPE
aprendiéndooslos	aprender	VGMPE
aprendiéndomela	aprender	VGFSE
aprendiéndotela	aprender	VGFSE
aprendiéndosela	aprender	VGFSE
aprendiéndonosla	aprender	VGFSE
aprendiéndoosla	aprender	VGFSE
aprendiéndomelas	aprender	VGFPE
aprendiéndotelas	aprender	VGFPE
aprendiéndoselas	aprender	VGFPE
aprendiéndonoslas	aprender	VGFPE
aprendiéndooslas	aprender	VGFPE
aprometer	aprometer	O
aprometo	aprometer	VIP1
aprometes	aprometer	VIP2
apromete	aprometer	VIP3
aprometemos	aprometer	VIP4
aprometéis	aprometer	VIP5
aprometen	aprometer	VIP6
aprometía	aprometer	VII1
aprometías	aprometer	VII2
aprometíamos	aprometer	VII4
aprometíais	aprometer	VII5
aprometían	aprometer	VII6
aprometeré	aprometer	VIF1
aprometerás	aprometer	VIF2
aprometerá	aprometer	VIF3
aprometeremos	aprometer	VIF4
aprometeréis	aprometer	VIF5
aprometerán	aprometer	VIF6
aprometería	aprometer	VIC1
aprometerías	aprometer	VIC2
aprometería	aprometer	VIC3
aprometeríamos	aprometer	VIC4
aprometeríais	aprometer	VIC5
aprometerían	aprometer	VIC6
aprometí	aprometer	VIX1
aprometiste	aprometer	VIX2
aprometió	aprometer	VIX3
aprometisteis	aprometer	VIX5
aprometieron	aprometer	VIX6
aprometa	aprometer	VSP1
aprometas	aprometer	VSP2
aprometamos	aprometer	VSP4
aprometáis	aprometer	VSP5
aprometan	aprometer	VSP6
aprometiera	aprometer	VSX1
aprometieras	aprometer	VSX2
aprometiéramos	aprometer	VSX4
aprometierais	aprometer	VSX5
aprometieran	aprometer	VSX6
aprometiere	aprometer	VSF1
aprometieres	aprometer	VSF2
aprometiéremos	aprometer	VSF4
aprometiereis	aprometer	VSF5
aprometieren	aprometer	VSF6
aprometiese	aprometer	VSI1
aprometieses	aprometer	VSI2
aprometiésemos	aprometer	VSI4
aprometieseis	aprometer	VSI5
aprometiesen	aprometer	VSI6
aprometed	aprometer	VMP
aprometedme	aprometer	VMSE
aprometedle	aprometer	VMSE
aprometednos	aprometer	VMPE
aprometeos	aprometer	VMPE
aprometedles	aprometer	VMPE
aprometedlo	aprometer	VMMSE
aprometedla	aprometer	VMFSE
aprometedlos	aprometer	VMMPE
aprometedlas	aprometer	VMFPE
aprometédmelo	aprometer	VMMSE
aprometédselo	aprometer	VMMSE
aprometédnoslo	aprometer	VMMSE
aprometéoslo	aprometer	VMMSE
aprometédmelos	aprometer	VMMPE
aprometédselos	aprometer	VMMPE
aprometédnoslos	aprometer	VMMPE
aprometéoslos	aprometer	VMMPE
aprometédmela	aprometer	VMFSE
aprometédsela	aprometer	VMFSE
aprometédnosla	aprometer	VMFSE
aprometéosla	aprometer	VMFSE
aprometédmelas	aprometer	VMFPE
aprometédselas	aprometer	VMFPE
aprometédnoslas	aprometer	VMFPE
aprometéoslas	aprometer	VMFPE
aprometido	aprometer	VPM
aprometidos	aprometer	VPMP
aprometida	aprometer	VPF
aprometidas	aprometer	VPFP
aprometiendo	aprometer	VG
aprometiéndome	aprometer	VGSE
aprometiéndote	aprometer	VGSE
aprometiéndole	aprometer	VGSE
aprometiéndonos	aprometer	VGPE
aprometiéndoos	aprometer	VGPE
aprometiéndolo	aprometer	VGMSE
aprometiéndola	aprometer	VGFSE
aprometiéndolos	aprometer	VGMPE
aprometiéndolas	aprometer	VGFPE
aprometiéndomelo	aprometer	VGMSE
aprometiéndotelo	aprometer	VGMSE
aprometiéndoselo	aprometer	VGMSE
aprometiéndonoslo	aprometer	VGMSE
aprometiéndooslo	aprometer	VGMSE
aprometiéndomelos	aprometer	VGMPE
aprometiéndotelos	aprometer	VGMPE
aprometiéndoselos	aprometer	VGMPE
aprometiéndonoslos	aprometer	VGMPE
aprometiéndooslos	aprometer	VGMPE
aprometiéndomela	aprometer	VGFSE
aprometiéndotela	aprometer	VGFSE
aprometiéndosela	aprometer	VGFSE
aprometiéndonosla	aprometer	VGFSE
aprometiéndoosla	aprometer	VGFSE
aprometiéndomelas	aprometer	VGFPE
aprometiéndotelas	aprometer	VGFPE
aprometiéndoselas	aprometer	VGFPE
aprometiéndonoslas	aprometer	VGFPE
aprometiéndooslas	aprometer	VGFPE
aprovecer	aprovecer	O
aproveco	aprovecer	VIP1
aproveces	aprovecer	VIP2
aprovece	aprovecer	VIP3
aprovecemos	aprovecer	VIP4
aprovecéis	aprovecer	VIP5
aprovecen	aprovecer	VIP6
aprovecía	aprovecer	VII1
aprovecías	aprovecer	VII2
aprovecíamos	aprovecer	VII4
aprovecíais	aprovecer	VII5
aprovecían	aprovecer	VII6
aproveceré	aprovecer	VIF1
aprovecerás	aprovecer	VIF2
aprovecerá	aprovecer	VIF3
aproveceremos	aprovecer	VIF4
aproveceréis	aprovecer	VIF5
aprovecerán	aprovecer	VIF6
aprovecería	aprovecer	VIC1
aprovecerías	aprovecer	VIC2
aprovecería	aprovecer	VIC3
aproveceríamos	aprovecer	VIC4
aproveceríais	aprovecer	VIC5
aprovecerían	aprovecer	VIC6
aprovecí	aprovecer	VIX1
aproveciste	aprovecer	VIX2
aproveció	aprovecer	VIX3
aprovecisteis	aprovecer	VIX5
aprovecieron	aprovecer	VIX6
aproveca	aprovecer	VSP1
aprovecas	aprovecer	VSP2
aprovecamos	aprovecer	VSP4
aprovecáis	aprovecer	VSP5
aprovecan	aprovecer	VSP6
aproveciera	aprovecer	VSX1
aprovecieras	aprovecer	VSX2
aproveciéramos	aprovecer	VSX4
aprovecierais	aprovecer	VSX5
aprovecieran	aprovecer	VSX6
aproveciere	aprovecer	VSF1
aprovecieres	aprovecer	VSF2
aproveciéremos	aprovecer	VSF4
aproveciereis	aprovecer	VSF5
aprovecieren	aprovecer	VSF6
aproveciese	aprovecer	VSI1
aprovecieses	aprovecer	VSI2
aproveciésemos	aprovecer	VSI4
aprovecieseis	aprovecer	VSI5
aproveciesen	aprovecer	VSI6
aproveced	aprovecer	VMP
aprovecedme	aprovecer	VMSE
aprovecedle	aprovecer	VMSE
aprovecednos	aprovecer	VMPE
aproveceos	aprovecer	VMPE
aprovecedles	aprovecer	VMPE
aprovecido	aprovecer	VPM
aprovecidos	aprovecer	VPMP
aprovecida	aprovecer	VPF
aprovecidas	aprovecer	VPFP
aproveciendo	aprovecer	VG
aproveciéndome	aprovecer	VGSE
aproveciéndote	aprovecer	VGSE
aproveciéndole	aprovecer	VGSE
aproveciéndonos	aprovecer	VGPE
aproveciéndoos	aprovecer	VGPE
apreciar	apreciar	O
aprecio	apreciar	VIP1
aprecias	apreciar	VIP2
aprecia	apreciar	VIP3
apreciamos	apreciar	VIP4
apreciáis	apreciar	VIP5
aprecian	apreciar	VIP6
apreciaba	apreciar	VII1
apreciabas	apreciar	VII2
apreciábamos	apreciar	VII4
apreciabais	apreciar	VII5
apreciaban	apreciar	VII6
apreciaré	apreciar	VIF1
apreciarás	apreciar	VIF2
apreciará	apreciar	VIF3
apreciaremos	apreciar	VIF4
apreciaréis	apreciar	VIF5
apreciarán	apreciar	VIF6
apreciaría	apreciar	VIC1
apreciarías	apreciar	VIC2
apreciaría	apreciar	VIC3
apreciaríamos	apreciar	VIC4
apreciaríais	apreciar	VIC5
apreciarían	apreciar	VIC6
aprecié	apreciar	VIX1
apreciaste	apreciar	VIX2
apreció	apreciar	VIX3
apreciasteis	apreciar	VIX5
apreciaron	apreciar	VIX6
aprecie	apreciar	VSP1
aprecies	apreciar	VSP2
apreciemos	apreciar	VSP4
apreciéis	apreciar	VSP5
aprecien	apreciar	VSP6
apreciara	apreciar	VSX1
apreciaras	apreciar	VSX2
apreciáramos	apreciar	VSX4
apreciarais	apreciar	VSX5
apreciaran	apreciar	VSX6
apreciare	apreciar	VSF1
apreciares	apreciar	VSF2
apreciáremos	apreciar	VSF4
apreciareis	apreciar	VSF5
apreciaren	apreciar	VSF6
apreciase	apreciar	VSI1
apreciases	apreciar	VSI2
apreciásemos	apreciar	VSI4
apreciaseis	apreciar	VSI5
apreciasen	apreciar	VSI6
apreciad	apreciar	VMP
apreciadme	apreciar	VMSE
apreciadle	apreciar	VMSE
apreciadnos	apreciar	VMPE
apreciaos	apreciar	VMPE
apreciadles	apreciar	VMPE
apreciadlo	apreciar	VMMSE
apreciadla	apreciar	VMFSE
apreciadlos	apreciar	VMMPE
apreciadlas	apreciar	VMFPE
apreciádmelo	apreciar	VMMSE
apreciádselo	apreciar	VMMSE
apreciádnoslo	apreciar	VMMSE
apreciáoslo	apreciar	VMMSE
apreciádmelos	apreciar	VMMPE
apreciádselos	apreciar	VMMPE
apreciádnoslos	apreciar	VMMPE
apreciáoslos	apreciar	VMMPE
apreciádmela	apreciar	VMFSE
apreciádsela	apreciar	VMFSE
apreciádnosla	apreciar	VMFSE
apreciáosla	apreciar	VMFSE
apreciádmelas	apreciar	VMFPE
apreciádselas	apreciar	VMFPE
apreciádnoslas	apreciar	VMFPE
apreciáoslas	apreciar	VMFPE
apreciado	apreciar	VPM
apreciados	apreciar	VPMP
apreciada	apreciar	VPF
apreciadas	apreciar	VPFP
apreciando	apreciar	VG
apreciándome	apreciar	VGSE
apreciándote	apreciar	VGSE
apreciándole	apreciar	VGSE
apreciándonos	apreciar	VGPE
apreciándoos	apreciar	VGPE
apreciándolo	apreciar	VGMSE
apreciándola	apreciar	VGFSE
apreciándolos	apreciar	VGMPE
apreciándolas	apreciar	VGFPE
apreciándomelo	apreciar	VGMSE
apreciándotelo	apreciar	VGMSE
apreciándoselo	apreciar	VGMSE
apreciándonoslo	apreciar	VGMSE
apreciándooslo	apreciar	VGMSE
apreciándomelos	apreciar	VGMPE
apreciándotelos	apreciar	VGMPE
apreciándoselos	apreciar	VGMPE
apreciándonoslos	apreciar	VGMPE
apreciándooslos	apreciar	VGMPE
apreciándomela	apreciar	VGFSE
apreciándotela	apreciar	VGFSE
apreciándosela	apreciar	VGFSE
apreciándonosla	apreciar	VGFSE
apreciándoosla	apreciar	VGFSE
apreciándomelas	apreciar	VGFPE
apreciándotelas	apreciar	VGFPE
apreciándoselas	apreciar	VGFPE
apreciándonoslas	apreciar	VGFPE
apreciándooslas	apreciar	VGFPE
apremiar	apremiar	O
apremio	apremiar	VIP1
apremias	apremiar	VIP2
apremia	apremiar	VIP3
apremiamos	apremiar	VIP4
apremiáis	apremiar	VIP5
apremian	apremiar	VIP6
apremiaba	apremiar	VII1
apremiabas	apremiar	VII2
apremiábamos	apremiar	VII4
apremiabais	apremiar	VII5
apremiaban	apremiar	VII6
apremiaré	apremiar	VIF1
apremiarás	apremiar	VIF2
apremiará	apremiar	VIF3
apremiaremos	apremiar	VIF4
apremiaréis	apremiar	VIF5
apremiarán	apremiar	VIF6
apremiaría	apremiar	VIC1
apremiarías	apremiar	VIC2
apremiaría	apremiar	VIC3
apremiaríamos	apremiar	VIC4
apremiaríais	apremiar	VIC5
apremiarían	apremiar	VIC6
apremié	apremiar	VIX1
apremiaste	apremiar	VIX2
apremió	apremiar	VIX3
apremiasteis	apremiar	VIX5
apremiaron	apremiar	VIX6
apremie	apremiar	VSP1
apremies	apremiar	VSP2
apremiemos	apremiar	VSP4
apremiéis	apremiar	VSP5
apremien	apremiar	VSP6
apremiara	apremiar	VSX1
apremiaras	apremiar	VSX2
apremiáramos	apremiar	VSX4
apremiarais	apremiar	VSX5
apremiaran	apremiar	VSX6
apremiare	apremiar	VSF1
apremiares	apremiar	VSF2
apremiáremos	apremiar	VSF4
apremiareis	apremiar	VSF5
apremiaren	apremiar	VSF6
apremiase	apremiar	VSI1
apremiases	apremiar	VSI2
apremiásemos	apremiar	VSI4
apremiaseis	apremiar	VSI5
apremiasen	apremiar	VSI6
apremiad	apremiar	VMP
apremiadme	apremiar	VMSE
apremiadle	apremiar	VMSE
apremiadnos	apremiar	VMPE
apremiaos	apremiar	VMPE
apremiadles	apremiar	VMPE
apremiadlo	apremiar	VMMSE
apremiadla	apremiar	VMFSE
apremiadlos	apremiar	VMMPE
apremiadlas	apremiar	VMFPE
apremiádmelo	apremiar	VMMSE
apremiádselo	apremiar	VMMSE
apremiádnoslo	apremiar	VMMSE
apremiáoslo	apremiar	VMMSE
apremiádmelos	apremiar	VMMPE
apremiádselos	apremiar	VMMPE
apremiádnoslos	apremiar	VMMPE
apremiáoslos	apremiar	VMMPE
apremiádmela	apremiar	VMFSE
apremiádsela	apremiar	VMFSE
apremiádnosla	apremiar	VMFSE
apremiáosla	apremiar	VMFSE
apremiádmelas	apremiar	VMFPE
apremiádselas	apremiar	VMFPE
apremiádnoslas	apremiar	VMFPE
apremiáoslas	apremiar	VMFPE
apremiado	apremiar	VPM
apremiados	apremiar	VPMP
apremiada	apremiar	VPF
apremiadas	apremiar	VPFP
apremiando	apremiar	VG
apremiándome	apremiar	VGSE
apremiándote	apremiar	VGSE
apremiándole	apremiar	VGSE
apremiándonos	apremiar	VGPE
apremiándoos	apremiar	VGPE
apremiándolo	apremiar	VGMSE
apremiándola	apremiar	VGFSE
apremiándolos	apremiar	VGMPE
apremiándolas	apremiar	VGFPE
apremiándomelo	apremiar	VGMSE
apremiándotelo	apremiar	VGMSE
apremiándoselo	apremiar	VGMSE
apremiándonoslo	apremiar	VGMSE
apremiándooslo	apremiar	VGMSE
apremiándomelos	apremiar	VGMPE
apremiándotelos	apremiar	VGMPE
apremiándoselos	apremiar	VGMPE
apremiándonoslos	apremiar	VGMPE
apremiándooslos	apremiar	VGMPE
apremiándomela	apremiar	VGFSE
apremiándotela	apremiar	VGFSE
apremiándosela	apremiar	VGFSE
apremiándonosla	apremiar	VGFSE
apremiándoosla	apremiar	VGFSE
apremiándomelas	apremiar	VGFPE
apremiándotelas	apremiar	VGFPE
apremiándoselas	apremiar	VGFPE
apremiándonoslas	apremiar	VGFPE
apremiándooslas	apremiar	VGFPE
aprensar	aprensar	O
aprenso	aprensar	VIP1
aprensas	aprensar	VIP2
aprensa	aprensar	VIP3
aprensamos	aprensar	VIP4
aprensáis	aprensar	VIP5
aprensan	aprensar	VIP6
aprensaba	aprensar	VII1
aprensabas	aprensar	VII2
aprensábamos	aprensar	VII4
aprensabais	aprensar	VII5
aprensaban	aprensar	VII6
aprensaré	aprensar	VIF1
aprensarás	aprensar	VIF2
aprensará	aprensar	VIF3
aprensaremos	aprensar	VIF4
aprensaréis	aprensar	VIF5
aprensarán	aprensar	VIF6
aprensaría	aprensar	VIC1
aprensarías	aprensar	VIC2
aprensaría	aprensar	VIC3
aprensaríamos	aprensar	VIC4
aprensaríais	aprensar	VIC5
aprensarían	aprensar	VIC6
aprensé	aprensar	VIX1
aprensaste	aprensar	VIX2
aprensó	aprensar	VIX3
aprensasteis	aprensar	VIX5
aprensaron	aprensar	VIX6
aprense	aprensar	VSP1
aprenses	aprensar	VSP2
aprensemos	aprensar	VSP4
aprenséis	aprensar	VSP5
aprensen	aprensar	VSP6
aprensara	aprensar	VSX1
aprensaras	aprensar	VSX2
aprensáramos	aprensar	VSX4
aprensarais	aprensar	VSX5
aprensaran	aprensar	VSX6
aprensare	aprensar	VSF1
aprensares	aprensar	VSF2
aprensáremos	aprensar	VSF4
aprensareis	aprensar	VSF5
aprensaren	aprensar	VSF6
aprensase	aprensar	VSI1
aprensases	aprensar	VSI2
aprensásemos	aprensar	VSI4
aprensaseis	aprensar	VSI5
aprensasen	aprensar	VSI6
aprensad	aprensar	VMP
aprensadme	aprensar	VMSE
aprensadle	aprensar	VMSE
aprensadnos	aprensar	VMPE
aprensaos	aprensar	VMPE
aprensadles	aprensar	VMPE
aprensadlo	aprensar	VMMSE
aprensadla	aprensar	VMFSE
aprensadlos	aprensar	VMMPE
aprensadlas	aprensar	VMFPE
aprensádmelo	aprensar	VMMSE
aprensádselo	aprensar	VMMSE
aprensádnoslo	aprensar	VMMSE
aprensáoslo	aprensar	VMMSE
aprensádmelos	aprensar	VMMPE
aprensádselos	aprensar	VMMPE
aprensádnoslos	aprensar	VMMPE
aprensáoslos	aprensar	VMMPE
aprensádmela	aprensar	VMFSE
aprensádsela	aprensar	VMFSE
aprensádnosla	aprensar	VMFSE
aprensáosla	aprensar	VMFSE
aprensádmelas	aprensar	VMFPE
aprensádselas	aprensar	VMFPE
aprensádnoslas	aprensar	VMFPE
aprensáoslas	aprensar	VMFPE
aprensado	aprensar	VPM
aprensados	aprensar	VPMP
aprensada	aprensar	VPF
aprensadas	aprensar	VPFP
aprensando	aprensar	VG
aprensándome	aprensar	VGSE
aprensándote	aprensar	VGSE
aprensándole	aprensar	VGSE
aprensándonos	aprensar	VGPE
aprensándoos	aprensar	VGPE
aprensándolo	aprensar	VGMSE
aprensándola	aprensar	VGFSE
aprensándolos	aprensar	VGMPE
aprensándolas	aprensar	VGFPE
aprensándomelo	aprensar	VGMSE
aprensándotelo	aprensar	VGMSE
aprensándoselo	aprensar	VGMSE
aprensándonoslo	aprensar	VGMSE
aprensándooslo	aprensar	VGMSE
aprensándomelos	aprensar	VGMPE
aprensándotelos	aprensar	VGMPE
aprensándoselos	aprensar	VGMPE
aprensándonoslos	aprensar	VGMPE
aprensándooslos	aprensar	VGMPE
aprensándomela	aprensar	VGFSE
aprensándotela	aprensar	VGFSE
aprensándosela	aprensar	VGFSE
aprensándonosla	aprensar	VGFSE
aprensándoosla	aprensar	VGFSE
aprensándomelas	aprensar	VGFPE
aprensándotelas	aprensar	VGFPE
aprensándoselas	aprensar	VGFPE
aprensándonoslas	aprensar	VGFPE
aprensándooslas	aprensar	VGFPE
apresar	apresar	O
apreso	apresar	VIP1
apresas	apresar	VIP2
apresa	apresar	VIP3
apresamos	apresar	VIP4
apresáis	apresar	VIP5
apresan	apresar	VIP6
apresaba	apresar	VII1
apresabas	apresar	VII2
apresábamos	apresar	VII4
apresabais	apresar	VII5
apresaban	apresar	VII6
apresaré	apresar	VIF1
apresarás	apresar	VIF2
apresará	apresar	VIF3
apresaremos	apresar	VIF4
apresaréis	apresar	VIF5
apresarán	apresar	VIF6
apresaría	apresar	VIC1
apresarías	apresar	VIC2
apresaría	apresar	VIC3
apresaríamos	apresar	VIC4
apresaríais	apresar	VIC5
apresarían	apresar	VIC6
apresé	apresar	VIX1
apresaste	apresar	VIX2
apresó	apresar	VIX3
apresasteis	apresar	VIX5
apresaron	apresar	VIX6
aprese	apresar	VSP1
apreses	apresar	VSP2
apresemos	apresar	VSP4
apreséis	apresar	VSP5
apresen	apresar	VSP6
apresara	apresar	VSX1
apresaras	apresar	VSX2
apresáramos	apresar	VSX4
apresarais	apresar	VSX5
apresaran	apresar	VSX6
apresare	apresar	VSF1
apresares	apresar	VSF2
apresáremos	apresar	VSF4
apresareis	apresar	VSF5
apresaren	apresar	VSF6
apresase	apresar	VSI1
apresases	apresar	VSI2
apresásemos	apresar	VSI4
apresaseis	apresar	VSI5
apresasen	apresar	VSI6
apresad	apresar	VMP
apresadme	apresar	VMSE
apresadle	apresar	VMSE
apresadnos	apresar	VMPE
apresaos	apresar	VMPE
apresadles	apresar	VMPE
apresadlo	apresar	VMMSE
apresadla	apresar	VMFSE
apresadlos	apresar	VMMPE
apresadlas	apresar	VMFPE
apresádmelo	apresar	VMMSE
apresádselo	apresar	VMMSE
apresádnoslo	apresar	VMMSE
apresáoslo	apresar	VMMSE
apresádmelos	apresar	VMMPE
apresádselos	apresar	VMMPE
apresádnoslos	apresar	VMMPE
apresáoslos	apresar	VMMPE
apresádmela	apresar	VMFSE
apresádsela	apresar	VMFSE
apresádnosla	apresar	VMFSE
apresáosla	apresar	VMFSE
apresádmelas	apresar	VMFPE
apresádselas	apresar	VMFPE
apresádnoslas	apresar	VMFPE
apresáoslas	apresar	VMFPE
apresado	apresar	VPM
apresados	apresar	VPMP
apresada	apresar	VPF
apresadas	apresar	VPFP
apresando	apresar	VG
apresándome	apresar	VGSE
apresándote	apresar	VGSE
apresándole	apresar	VGSE
apresándonos	apresar	VGPE
apresándoos	apresar	VGPE
apresándolo	apresar	VGMSE
apresándola	apresar	VGFSE
apresándolos	apresar	VGMPE
apresándolas	apresar	VGFPE
apresándomelo	apresar	VGMSE
apresándotelo	apresar	VGMSE
apresándoselo	apresar	VGMSE
apresándonoslo	apresar	VGMSE
apresándooslo	apresar	VGMSE
apresándomelos	apresar	VGMPE
apresándotelos	apresar	VGMPE
apresándoselos	apresar	VGMPE
apresándonoslos	apresar	VGMPE
apresándooslos	apresar	VGMPE
apresándomela	apresar	VGFSE
apresándotela	apresar	VGFSE
apresándosela	apresar	VGFSE
apresándonosla	apresar	VGFSE
apresándoosla	apresar	VGFSE
apresándomelas	apresar	VGFPE
apresándotelas	apresar	VGFPE
apresándoselas	apresar	VGFPE
apresándonoslas	apresar	VGFPE
apresándooslas	apresar	VGFPE
aprestar	aprestar	O
apresto	aprestar	VIP1
aprestas	aprestar	VIP2
apresta	aprestar	VIP3
aprestamos	aprestar	VIP4
aprestáis	aprestar	VIP5
aprestan	aprestar	VIP6
aprestaba	aprestar	VII1
aprestabas	aprestar	VII2
aprestábamos	aprestar	VII4
aprestabais	aprestar	VII5
aprestaban	aprestar	VII6
aprestaré	aprestar	VIF1
aprestarás	aprestar	VIF2
aprestará	aprestar	VIF3
aprestaremos	aprestar	VIF4
aprestaréis	aprestar	VIF5
aprestarán	aprestar	VIF6
aprestaría	aprestar	VIC1
aprestarías	aprestar	VIC2
aprestaría	aprestar	VIC3
aprestaríamos	aprestar	VIC4
aprestaríais	aprestar	VIC5
aprestarían	aprestar	VIC6
apresté	aprestar	VIX1
aprestaste	aprestar	VIX2
aprestó	aprestar	VIX3
aprestasteis	aprestar	VIX5
aprestaron	aprestar	VIX6
apreste	aprestar	VSP1
aprestes	aprestar	VSP2
aprestemos	aprestar	VSP4
aprestéis	aprestar	VSP5
apresten	aprestar	VSP6
aprestara	aprestar	VSX1
aprestaras	aprestar	VSX2
aprestáramos	aprestar	VSX4
aprestarais	aprestar	VSX5
aprestaran	aprestar	VSX6
aprestare	aprestar	VSF1
aprestares	aprestar	VSF2
aprestáremos	aprestar	VSF4
aprestareis	aprestar	VSF5
aprestaren	aprestar	VSF6
aprestase	aprestar	VSI1
aprestases	aprestar	VSI2
aprestásemos	aprestar	VSI4
aprestaseis	aprestar	VSI5
aprestasen	aprestar	VSI6
aprestad	aprestar	VMP
aprestadme	aprestar	VMSE
aprestadle	aprestar	VMSE
aprestadnos	aprestar	VMPE
aprestaos	aprestar	VMPE
aprestadles	aprestar	VMPE
aprestadlo	aprestar	VMMSE
aprestadla	aprestar	VMFSE
aprestadlos	aprestar	VMMPE
aprestadlas	aprestar	VMFPE
aprestádmelo	aprestar	VMMSE
aprestádselo	aprestar	VMMSE
aprestádnoslo	aprestar	VMMSE
aprestáoslo	aprestar	VMMSE
aprestádmelos	aprestar	VMMPE
aprestádselos	aprestar	VMMPE
aprestádnoslos	aprestar	VMMPE
aprestáoslos	aprestar	VMMPE
aprestádmela	aprestar	VMFSE
aprestádsela	aprestar	VMFSE
aprestádnosla	aprestar	VMFSE
aprestáosla	aprestar	VMFSE
aprestádmelas	aprestar	VMFPE
aprestádselas	aprestar	VMFPE
aprestádnoslas	aprestar	VMFPE
aprestáoslas	aprestar	VMFPE
aprestado	aprestar	VPM
aprestados	aprestar	VPMP
aprestada	aprestar	VPF
aprestadas	aprestar	VPFP
aprestando	aprestar	VG
aprestándome	aprestar	VGSE
aprestándote	aprestar	VGSE
aprestándole	aprestar	VGSE
aprestándonos	aprestar	VGPE
aprestándoos	aprestar	VGPE
aprestándolo	aprestar	VGMSE
aprestándola	aprestar	VGFSE
aprestándolos	aprestar	VGMPE
aprestándolas	aprestar	VGFPE
aprestándomelo	aprestar	VGMSE
aprestándotelo	aprestar	VGMSE
aprestándoselo	aprestar	VGMSE
aprestándonoslo	aprestar	VGMSE
aprestándooslo	aprestar	VGMSE
aprestándomelos	aprestar	VGMPE
aprestándotelos	aprestar	VGMPE
aprestándoselos	aprestar	VGMPE
aprestándonoslos	aprestar	VGMPE
aprestándooslos	aprestar	VGMPE
aprestándomela	aprestar	VGFSE
aprestándotela	aprestar	VGFSE
aprestándosela	aprestar	VGFSE
aprestándonosla	aprestar	VGFSE
aprestándoosla	aprestar	VGFSE
aprestándomelas	aprestar	VGFPE
aprestándotelas	aprestar	VGFPE
aprestándoselas	aprestar	VGFPE
aprestándonoslas	aprestar	VGFPE
aprestándooslas	aprestar	VGFPE
aprestigiar	aprestigiar	O
aprestigio	aprestigiar	VIP1
aprestigias	aprestigiar	VIP2
aprestigia	aprestigiar	VIP3
aprestigiamos	aprestigiar	VIP4
aprestigiáis	aprestigiar	VIP5
aprestigian	aprestigiar	VIP6
aprestigiaba	aprestigiar	VII1
aprestigiabas	aprestigiar	VII2
aprestigiábamos	aprestigiar	VII4
aprestigiabais	aprestigiar	VII5
aprestigiaban	aprestigiar	VII6
aprestigiaré	aprestigiar	VIF1
aprestigiarás	aprestigiar	VIF2
aprestigiará	aprestigiar	VIF3
aprestigiaremos	aprestigiar	VIF4
aprestigiaréis	aprestigiar	VIF5
aprestigiarán	aprestigiar	VIF6
aprestigiaría	aprestigiar	VIC1
aprestigiarías	aprestigiar	VIC2
aprestigiaría	aprestigiar	VIC3
aprestigiaríamos	aprestigiar	VIC4
aprestigiaríais	aprestigiar	VIC5
aprestigiarían	aprestigiar	VIC6
aprestigié	aprestigiar	VIX1
aprestigiaste	aprestigiar	VIX2
aprestigió	aprestigiar	VIX3
aprestigiasteis	aprestigiar	VIX5
aprestigiaron	aprestigiar	VIX6
aprestigie	aprestigiar	VSP1
aprestigies	aprestigiar	VSP2
aprestigiemos	aprestigiar	VSP4
aprestigiéis	aprestigiar	VSP5
aprestigien	aprestigiar	VSP6
aprestigiara	aprestigiar	VSX1
aprestigiaras	aprestigiar	VSX2
aprestigiáramos	aprestigiar	VSX4
aprestigiarais	aprestigiar	VSX5
aprestigiaran	aprestigiar	VSX6
aprestigiare	aprestigiar	VSF1
aprestigiares	aprestigiar	VSF2
aprestigiáremos	aprestigiar	VSF4
aprestigiareis	aprestigiar	VSF5
aprestigiaren	aprestigiar	VSF6
aprestigiase	aprestigiar	VSI1
aprestigiases	aprestigiar	VSI2
aprestigiásemos	aprestigiar	VSI4
aprestigiaseis	aprestigiar	VSI5
aprestigiasen	aprestigiar	VSI6
aprestigiad	aprestigiar	VMP
aprestigiadme	aprestigiar	VMSE
aprestigiadle	aprestigiar	VMSE
aprestigiadnos	aprestigiar	VMPE
aprestigiaos	aprestigiar	VMPE
aprestigiadles	aprestigiar	VMPE
aprestigiadlo	aprestigiar	VMMSE
aprestigiadla	aprestigiar	VMFSE
aprestigiadlos	aprestigiar	VMMPE
aprestigiadlas	aprestigiar	VMFPE
aprestigiádmelo	aprestigiar	VMMSE
aprestigiádselo	aprestigiar	VMMSE
aprestigiádnoslo	aprestigiar	VMMSE
aprestigiáoslo	aprestigiar	VMMSE
aprestigiádmelos	aprestigiar	VMMPE
aprestigiádselos	aprestigiar	VMMPE
aprestigiádnoslos	aprestigiar	VMMPE
aprestigiáoslos	aprestigiar	VMMPE
aprestigiádmela	aprestigiar	VMFSE
aprestigiádsela	aprestigiar	VMFSE
aprestigiádnosla	aprestigiar	VMFSE
aprestigiáosla	aprestigiar	VMFSE
aprestigiádmelas	aprestigiar	VMFPE
aprestigiádselas	aprestigiar	VMFPE
aprestigiádnoslas	aprestigiar	VMFPE
aprestigiáoslas	aprestigiar	VMFPE
aprestigiado	aprestigiar	VPM
aprestigiados	aprestigiar	VPMP
aprestigiada	aprestigiar	VPF
aprestigiadas	aprestigiar	VPFP
aprestigiando	aprestigiar	VG
aprestigiándome	aprestigiar	VGSE
aprestigiándote	aprestigiar	VGSE
aprestigiándole	aprestigiar	VGSE
aprestigiándonos	aprestigiar	VGPE
aprestigiándoos	aprestigiar	VGPE
aprestigiándolo	aprestigiar	VGMSE
aprestigiándola	aprestigiar	VGFSE
aprestigiándolos	aprestigiar	VGMPE
aprestigiándolas	aprestigiar	VGFPE
aprestigiándomelo	aprestigiar	VGMSE
aprestigiándotelo	aprestigiar	VGMSE
aprestigiándoselo	aprestigiar	VGMSE
aprestigiándonoslo	aprestigiar	VGMSE
aprestigiándooslo	aprestigiar	VGMSE
aprestigiándomelos	aprestigiar	VGMPE
aprestigiándotelos	aprestigiar	VGMPE
aprestigiándoselos	aprestigiar	VGMPE
aprestigiándonoslos	aprestigiar	VGMPE
aprestigiándooslos	aprestigiar	VGMPE
aprestigiándomela	aprestigiar	VGFSE
aprestigiándotela	aprestigiar	VGFSE
aprestigiándosela	aprestigiar	VGFSE
aprestigiándonosla	aprestigiar	VGFSE
aprestigiándoosla	aprestigiar	VGFSE
aprestigiándomelas	aprestigiar	VGFPE
aprestigiándotelas	aprestigiar	VGFPE
aprestigiándoselas	aprestigiar	VGFPE
aprestigiándonoslas	aprestigiar	VGFPE
aprestigiándooslas	aprestigiar	VGFPE
apresurar	apresurar	O
apresuro	apresurar	VIP1
apresuras	apresurar	VIP2
apresura	apresurar	VIP3
apresuramos	apresurar	VIP4
apresuráis	apresurar	VIP5
apresuran	apresurar	VIP6
apresuraba	apresurar	VII1
apresurabas	apresurar	VII2
apresurábamos	apresurar	VII4
apresurabais	apresurar	VII5
apresuraban	apresurar	VII6
apresuraré	apresurar	VIF1
apresurarás	apresurar	VIF2
apresurará	apresurar	VIF3
apresuraremos	apresurar	VIF4
apresuraréis	apresurar	VIF5
apresurarán	apresurar	VIF6
apresuraría	apresurar	VIC1
apresurarías	apresurar	VIC2
apresuraría	apresurar	VIC3
apresuraríamos	apresurar	VIC4
apresuraríais	apresurar	VIC5
apresurarían	apresurar	VIC6
apresuré	apresurar	VIX1
apresuraste	apresurar	VIX2
apresuró	apresurar	VIX3
apresurasteis	apresurar	VIX5
apresuraron	apresurar	VIX6
apresure	apresurar	VSP1
apresures	apresurar	VSP2
apresuremos	apresurar	VSP4
apresuréis	apresurar	VSP5
apresuren	apresurar	VSP6
apresurara	apresurar	VSX1
apresuraras	apresurar	VSX2
apresuráramos	apresurar	VSX4
apresurarais	apresurar	VSX5
apresuraran	apresurar	VSX6
apresurare	apresurar	VSF1
apresurares	apresurar	VSF2
apresuráremos	apresurar	VSF4
apresurareis	apresurar	VSF5
apresuraren	apresurar	VSF6
apresurase	apresurar	VSI1
apresurases	apresurar	VSI2
apresurásemos	apresurar	VSI4
apresuraseis	apresurar	VSI5
apresurasen	apresurar	VSI6
apresurad	apresurar	VMP
apresuradme	apresurar	VMSE
apresuradle	apresurar	VMSE
apresuradnos	apresurar	VMPE
apresuraos	apresurar	VMPE
apresuradles	apresurar	VMPE
apresuradlo	apresurar	VMMSE
apresuradla	apresurar	VMFSE
apresuradlos	apresurar	VMMPE
apresuradlas	apresurar	VMFPE
apresurádmelo	apresurar	VMMSE
apresurádselo	apresurar	VMMSE
apresurádnoslo	apresurar	VMMSE
apresuráoslo	apresurar	VMMSE
apresurádmelos	apresurar	VMMPE
apresurádselos	apresurar	VMMPE
apresurádnoslos	apresurar	VMMPE
apresuráoslos	apresurar	VMMPE
apresurádmela	apresurar	VMFSE
apresurádsela	apresurar	VMFSE
apresurádnosla	apresurar	VMFSE
apresuráosla	apresurar	VMFSE
apresurádmelas	apresurar	VMFPE
apresurádselas	apresurar	VMFPE
apresurádnoslas	apresurar	VMFPE
apresuráoslas	apresurar	VMFPE
apresurado	apresurar	VPM
apresurados	apresurar	VPMP
apresurada	apresurar	VPF
apresuradas	apresurar	VPFP
apresurando	apresurar	VG
apresurándome	apresurar	VGSE
apresurándote	apresurar	VGSE
apresurándole	apresurar	VGSE
apresurándonos	apresurar	VGPE
apresurándoos	apresurar	VGPE
apresurándolo	apresurar	VGMSE
apresurándola	apresurar	VGFSE
apresurándolos	apresurar	VGMPE
apresurándolas	apresurar	VGFPE
apresurándomelo	apresurar	VGMSE
apresurándotelo	apresurar	VGMSE
apresurándoselo	apresurar	VGMSE
apresurándonoslo	apresurar	VGMSE
apresurándooslo	apresurar	VGMSE
apresurándomelos	apresurar	VGMPE
apresurándotelos	apresurar	VGMPE
apresurándoselos	apresurar	VGMPE
apresurándonoslos	apresurar	VGMPE
apresurándooslos	apresurar	VGMPE
apresurándomela	apresurar	VGFSE
apresurándotela	apresurar	VGFSE
apresurándosela	apresurar	VGFSE
apresurándonosla	apresurar	VGFSE
apresurándoosla	apresurar	VGFSE
apresurándomelas	apresurar	VGFPE
apresurándotelas	apresurar	VGFPE
apresurándoselas	apresurar	VGFPE
apresurándonoslas	apresurar	VGFPE
apresurándooslas	apresurar	VGFPE
apretar	apretar	O
aprieto	apretar	VIP1
aprietas	apretar	VIP2
aprieta	apretar	VIP3
apretamos	apretar	VIP4
apretáis	apretar	VIP5
aprietan	apretar	VIP6
apretaba	apretar	VII1
apretabas	apretar	VII2
apretábamos	apretar	VII4
apretabais	apretar	VII5
apretaban	apretar	VII6
apretaré	apretar	VIF1
apretarás	apretar	VIF2
apretará	apretar	VIF3
apretaremos	apretar	VIF4
apretaréis	apretar	VIF5
apretarán	apretar	VIF6
apretaría	apretar	VIC1
apretarías	apretar	VIC2
apretaría	apretar	VIC3
apretaríamos	apretar	VIC4
apretaríais	apretar	VIC5
apretarían	apretar	VIC6
apreté	apretar	VIX1
apretaste	apretar	VIX2
apretó	apretar	VIX3
apretasteis	apretar	VIX5
apretaron	apretar	VIX6
apriete	apretar	VSP1
aprietes	apretar	VSP2
apretemos	apretar	VSP4
apretéis	apretar	VSP5
aprieten	apretar	VSP6
apretara	apretar	VSX1
apretaras	apretar	VSX2
apretáramos	apretar	VSX4
apretarais	apretar	VSX5
apretaran	apretar	VSX6
apretare	apretar	VSF1
apretares	apretar	VSF2
apretáremos	apretar	VSF4
apretareis	apretar	VSF5
apretaren	apretar	VSF6
apretase	apretar	VSI1
apretases	apretar	VSI2
apretásemos	apretar	VSI4
apretaseis	apretar	VSI5
apretasen	apretar	VSI6
apretad	apretar	VMP
apretadme	apretar	VMSE
apretadle	apretar	VMSE
apretadnos	apretar	VMPE
apretaos	apretar	VMPE
apretadles	apretar	VMPE
apretadlo	apretar	VMMSE
apretadla	apretar	VMFSE
apretadlos	apretar	VMMPE
apretadlas	apretar	VMFPE
apretádmelo	apretar	VMMSE
apretádselo	apretar	VMMSE
apretádnoslo	apretar	VMMSE
apretáoslo	apretar	VMMSE
apretádmelos	apretar	VMMPE
apretádselos	apretar	VMMPE
apretádnoslos	apretar	VMMPE
apretáoslos	apretar	VMMPE
apretádmela	apretar	VMFSE
apretádsela	apretar	VMFSE
apretádnosla	apretar	VMFSE
apretáosla	apretar	VMFSE
apretádmelas	apretar	VMFPE
apretádselas	apretar	VMFPE
apretádnoslas	apretar	VMFPE
apretáoslas	apretar	VMFPE
apretado	apretar	VPM
apretados	apretar	VPMP
apretada	apretar	VPF
apretadas	apretar	VPFP
apretando	apretar	VG
apretándome	apretar	VGSE
apretándote	apretar	VGSE
apretándole	apretar	VGSE
apretándonos	apretar	VGPE
apretándoos	apretar	VGPE
apretándolo	apretar	VGMSE
apretándola	apretar	VGFSE
apretándolos	apretar	VGMPE
apretándolas	apretar	VGFPE
apretándomelo	apretar	VGMSE
apretándotelo	apretar	VGMSE
apretándoselo	apretar	VGMSE
apretándonoslo	apretar	VGMSE
apretándooslo	apretar	VGMSE
apretándomelos	apretar	VGMPE
apretándotelos	apretar	VGMPE
apretándoselos	apretar	VGMPE
apretándonoslos	apretar	VGMPE
apretándooslos	apretar	VGMPE
apretándomela	apretar	VGFSE
apretándotela	apretar	VGFSE
apretándosela	apretar	VGFSE
apretándonosla	apretar	VGFSE
apretándoosla	apretar	VGFSE
apretándomelas	apretar	VGFPE
apretándotelas	apretar	VGFPE
apretándoselas	apretar	VGFPE
apretándonoslas	apretar	VGFPE
apretándooslas	apretar	VGFPE
apretujar	apretujar	O
apretujo	apretujar	VIP1
apretujas	apretujar	VIP2
apretuja	apretujar	VIP3
apretujamos	apretujar	VIP4
apretujáis	apretujar	VIP5
apretujan	apretujar	VIP6
apretujaba	apretujar	VII1
apretujabas	apretujar	VII2
apretujábamos	apretujar	VII4
apretujabais	apretujar	VII5
apretujaban	apretujar	VII6
apretujaré	apretujar	VIF1
apretujarás	apretujar	VIF2
apretujará	apretujar	VIF3
apretujaremos	apretujar	VIF4
apretujaréis	apretujar	VIF5
apretujarán	apretujar	VIF6
apretujaría	apretujar	VIC1
apretujarías	apretujar	VIC2
apretujaría	apretujar	VIC3
apretujaríamos	apretujar	VIC4
apretujaríais	apretujar	VIC5
apretujarían	apretujar	VIC6
apretujé	apretujar	VIX1
apretujaste	apretujar	VIX2
apretujó	apretujar	VIX3
apretujasteis	apretujar	VIX5
apretujaron	apretujar	VIX6
apretuje	apretujar	VSP1
apretujes	apretujar	VSP2
apretujemos	apretujar	VSP4
apretujéis	apretujar	VSP5
apretujen	apretujar	VSP6
apretujara	apretujar	VSX1
apretujaras	apretujar	VSX2
apretujáramos	apretujar	VSX4
apretujarais	apretujar	VSX5
apretujaran	apretujar	VSX6
apretujare	apretujar	VSF1
apretujares	apretujar	VSF2
apretujáremos	apretujar	VSF4
apretujareis	apretujar	VSF5
apretujaren	apretujar	VSF6
apretujase	apretujar	VSI1
apretujases	apretujar	VSI2
apretujásemos	apretujar	VSI4
apretujaseis	apretujar	VSI5
apretujasen	apretujar	VSI6
apretujad	apretujar	VMP
apretujadme	apretujar	VMSE
apretujadle	apretujar	VMSE
apretujadnos	apretujar	VMPE
apretujaos	apretujar	VMPE
apretujadles	apretujar	VMPE
apretujadlo	apretujar	VMMSE
apretujadla	apretujar	VMFSE
apretujadlos	apretujar	VMMPE
apretujadlas	apretujar	VMFPE
apretujádmelo	apretujar	VMMSE
apretujádselo	apretujar	VMMSE
apretujádnoslo	apretujar	VMMSE
apretujáoslo	apretujar	VMMSE
apretujádmelos	apretujar	VMMPE
apretujádselos	apretujar	VMMPE
apretujádnoslos	apretujar	VMMPE
apretujáoslos	apretujar	VMMPE
apretujádmela	apretujar	VMFSE
apretujádsela	apretujar	VMFSE
apretujádnosla	apretujar	VMFSE
apretujáosla	apretujar	VMFSE
apretujádmelas	apretujar	VMFPE
apretujádselas	apretujar	VMFPE
apretujádnoslas	apretujar	VMFPE
apretujáoslas	apretujar	VMFPE
apretujado	apretujar	VPM
apretujados	apretujar	VPMP
apretujada	apretujar	VPF
apretujadas	apretujar	VPFP
apretujando	apretujar	VG
apretujándome	apretujar	VGSE
apretujándote	apretujar	VGSE
apretujándole	apretujar	VGSE
apretujándonos	apretujar	VGPE
apretujándoos	apretujar	VGPE
apretujándolo	apretujar	VGMSE
apretujándola	apretujar	VGFSE
apretujándolos	apretujar	VGMPE
apretujándolas	apretujar	VGFPE
apretujándomelo	apretujar	VGMSE
apretujándotelo	apretujar	VGMSE
apretujándoselo	apretujar	VGMSE
apretujándonoslo	apretujar	VGMSE
apretujándooslo	apretujar	VGMSE
apretujándomelos	apretujar	VGMPE
apretujándotelos	apretujar	VGMPE
apretujándoselos	apretujar	VGMPE
apretujándonoslos	apretujar	VGMPE
apretujándooslos	apretujar	VGMPE
apretujándomela	apretujar	VGFSE
apretujándotela	apretujar	VGFSE
apretujándosela	apretujar	VGFSE
apretujándonosla	apretujar	VGFSE
apretujándoosla	apretujar	VGFSE
apretujándomelas	apretujar	VGFPE
apretujándotelas	apretujar	VGFPE
apretujándoselas	apretujar	VGFPE
apretujándonoslas	apretujar	VGFPE
apretujándooslas	apretujar	VGFPE
aprimar	aprimar	O
aprimo	aprimar	VIP1
aprimas	aprimar	VIP2
aprima	aprimar	VIP3
aprimamos	aprimar	VIP4
aprimáis	aprimar	VIP5
apriman	aprimar	VIP6
aprimaba	aprimar	VII1
aprimabas	aprimar	VII2
aprimábamos	aprimar	VII4
aprimabais	aprimar	VII5
aprimaban	aprimar	VII6
aprimaré	aprimar	VIF1
aprimarás	aprimar	VIF2
aprimará	aprimar	VIF3
aprimaremos	aprimar	VIF4
aprimaréis	aprimar	VIF5
aprimarán	aprimar	VIF6
aprimaría	aprimar	VIC1
aprimarías	aprimar	VIC2
aprimaría	aprimar	VIC3
aprimaríamos	aprimar	VIC4
aprimaríais	aprimar	VIC5
aprimarían	aprimar	VIC6
aprimé	aprimar	VIX1
aprimaste	aprimar	VIX2
aprimó	aprimar	VIX3
aprimasteis	aprimar	VIX5
aprimaron	aprimar	VIX6
aprime	aprimar	VSP1
aprimes	aprimar	VSP2
aprimemos	aprimar	VSP4
apriméis	aprimar	VSP5
aprimen	aprimar	VSP6
aprimara	aprimar	VSX1
aprimaras	aprimar	VSX2
aprimáramos	aprimar	VSX4
aprimarais	aprimar	VSX5
aprimaran	aprimar	VSX6
aprimare	aprimar	VSF1
aprimares	aprimar	VSF2
aprimáremos	aprimar	VSF4
aprimareis	aprimar	VSF5
aprimaren	aprimar	VSF6
aprimase	aprimar	VSI1
aprimases	aprimar	VSI2
aprimásemos	aprimar	VSI4
aprimaseis	aprimar	VSI5
aprimasen	aprimar	VSI6
aprimad	aprimar	VMP
aprimadme	aprimar	VMSE
aprimadle	aprimar	VMSE
aprimadnos	aprimar	VMPE
aprimaos	aprimar	VMPE
aprimadles	aprimar	VMPE
aprimadlo	aprimar	VMMSE
aprimadla	aprimar	VMFSE
aprimadlos	aprimar	VMMPE
aprimadlas	aprimar	VMFPE
aprimádmelo	aprimar	VMMSE
aprimádselo	aprimar	VMMSE
aprimádnoslo	aprimar	VMMSE
aprimáoslo	aprimar	VMMSE
aprimádmelos	aprimar	VMMPE
aprimádselos	aprimar	VMMPE
aprimádnoslos	aprimar	VMMPE
aprimáoslos	aprimar	VMMPE
aprimádmela	aprimar	VMFSE
aprimádsela	aprimar	VMFSE
aprimádnosla	aprimar	VMFSE
aprimáosla	aprimar	VMFSE
aprimádmelas	aprimar	VMFPE
aprimádselas	aprimar	VMFPE
aprimádnoslas	aprimar	VMFPE
aprimáoslas	aprimar	VMFPE
aprimado	aprimar	VPM
aprimados	aprimar	VPMP
aprimada	aprimar	VPF
aprimadas	aprimar	VPFP
aprimando	aprimar	VG
aprimándome	aprimar	VGSE
aprimándote	aprimar	VGSE
aprimándole	aprimar	VGSE
aprimándonos	aprimar	VGPE
aprimándoos	aprimar	VGPE
aprimándolo	aprimar	VGMSE
aprimándola	aprimar	VGFSE
aprimándolos	aprimar	VGMPE
aprimándolas	aprimar	VGFPE
aprimándomelo	aprimar	VGMSE
aprimándotelo	aprimar	VGMSE
aprimándoselo	aprimar	VGMSE
aprimándonoslo	aprimar	VGMSE
aprimándooslo	aprimar	VGMSE
aprimándomelos	aprimar	VGMPE
aprimándotelos	aprimar	VGMPE
aprimándoselos	aprimar	VGMPE
aprimándonoslos	aprimar	VGMPE
aprimándooslos	aprimar	VGMPE
aprimándomela	aprimar	VGFSE
aprimándotela	aprimar	VGFSE
aprimándosela	aprimar	VGFSE
aprimándonosla	aprimar	VGFSE
aprimándoosla	aprimar	VGFSE
aprimándomelas	aprimar	VGFPE
aprimándotelas	aprimar	VGFPE
aprimándoselas	aprimar	VGFPE
aprimándonoslas	aprimar	VGFPE
aprimándooslas	aprimar	VGFPE
apriscar	apriscar	O
aprisco	apriscar	VIP1
apriscas	apriscar	VIP2
aprisca	apriscar	VIP3
apriscamos	apriscar	VIP4
apriscáis	apriscar	VIP5
apriscan	apriscar	VIP6
apriscaba	apriscar	VII1
apriscabas	apriscar	VII2
apriscábamos	apriscar	VII4
apriscabais	apriscar	VII5
apriscaban	apriscar	VII6
apriscaré	apriscar	VIF1
apriscarás	apriscar	VIF2
apriscará	apriscar	VIF3
apriscaremos	apriscar	VIF4
apriscaréis	apriscar	VIF5
apriscarán	apriscar	VIF6
apriscaría	apriscar	VIC1
apriscarías	apriscar	VIC2
apriscaría	apriscar	VIC3
apriscaríamos	apriscar	VIC4
apriscaríais	apriscar	VIC5
apriscarían	apriscar	VIC6
aprisqué	apriscar	VIX1
apriscaste	apriscar	VIX2
apriscó	apriscar	VIX3
apriscasteis	apriscar	VIX5
apriscaron	apriscar	VIX6
aprisque	apriscar	VSP1
aprisques	apriscar	VSP2
aprisquemos	apriscar	VSP4
aprisquéis	apriscar	VSP5
aprisquen	apriscar	VSP6
apriscara	apriscar	VSX1
apriscaras	apriscar	VSX2
apriscáramos	apriscar	VSX4
apriscarais	apriscar	VSX5
apriscaran	apriscar	VSX6
apriscare	apriscar	VSF1
apriscares	apriscar	VSF2
apriscáremos	apriscar	VSF4
apriscareis	apriscar	VSF5
apriscaren	apriscar	VSF6
apriscase	apriscar	VSI1
apriscases	apriscar	VSI2
apriscásemos	apriscar	VSI4
apriscaseis	apriscar	VSI5
apriscasen	apriscar	VSI6
apriscad	apriscar	VMP
apriscadme	apriscar	VMSE
apriscadle	apriscar	VMSE
apriscadnos	apriscar	VMPE
apriscaos	apriscar	VMPE
apriscadles	apriscar	VMPE
apriscadlo	apriscar	VMMSE
apriscadla	apriscar	VMFSE
apriscadlos	apriscar	VMMPE
apriscadlas	apriscar	VMFPE
apriscádmelo	apriscar	VMMSE
apriscádselo	apriscar	VMMSE
apriscádnoslo	apriscar	VMMSE
apriscáoslo	apriscar	VMMSE
apriscádmelos	apriscar	VMMPE
apriscádselos	apriscar	VMMPE
apriscádnoslos	apriscar	VMMPE
apriscáoslos	apriscar	VMMPE
apriscádmela	apriscar	VMFSE
apriscádsela	apriscar	VMFSE
apriscádnosla	apriscar	VMFSE
apriscáosla	apriscar	VMFSE
apriscádmelas	apriscar	VMFPE
apriscádselas	apriscar	VMFPE
apriscádnoslas	apriscar	VMFPE
apriscáoslas	apriscar	VMFPE
apriscado	apriscar	VPM
apriscados	apriscar	VPMP
apriscada	apriscar	VPF
apriscadas	apriscar	VPFP
apriscando	apriscar	VG
apriscándome	apriscar	VGSE
apriscándote	apriscar	VGSE
apriscándole	apriscar	VGSE
apriscándonos	apriscar	VGPE
apriscándoos	apriscar	VGPE
apriscándolo	apriscar	VGMSE
apriscándola	apriscar	VGFSE
apriscándolos	apriscar	VGMPE
apriscándolas	apriscar	VGFPE
apriscándomelo	apriscar	VGMSE
apriscándotelo	apriscar	VGMSE
apriscándoselo	apriscar	VGMSE
apriscándonoslo	apriscar	VGMSE
apriscándooslo	apriscar	VGMSE
apriscándomelos	apriscar	VGMPE
apriscándotelos	apriscar	VGMPE
apriscándoselos	apriscar	VGMPE
apriscándonoslos	apriscar	VGMPE
apriscándooslos	apriscar	VGMPE
apriscándomela	apriscar	VGFSE
apriscándotela	apriscar	VGFSE
apriscándosela	apriscar	VGFSE
apriscándonosla	apriscar	VGFSE
apriscándoosla	apriscar	VGFSE
apriscándomelas	apriscar	VGFPE
apriscándotelas	apriscar	VGFPE
apriscándoselas	apriscar	VGFPE
apriscándonoslas	apriscar	VGFPE
apriscándooslas	apriscar	VGFPE
aprisionar	aprisionar	O
aprisiono	aprisionar	VIP1
aprisionas	aprisionar	VIP2
aprisiona	aprisionar	VIP3
aprisionamos	aprisionar	VIP4
aprisionáis	aprisionar	VIP5
aprisionan	aprisionar	VIP6
aprisionaba	aprisionar	VII1
aprisionabas	aprisionar	VII2
aprisionábamos	aprisionar	VII4
aprisionabais	aprisionar	VII5
aprisionaban	aprisionar	VII6
aprisionaré	aprisionar	VIF1
aprisionarás	aprisionar	VIF2
aprisionará	aprisionar	VIF3
aprisionaremos	aprisionar	VIF4
aprisionaréis	aprisionar	VIF5
aprisionarán	aprisionar	VIF6
aprisionaría	aprisionar	VIC1
aprisionarías	aprisionar	VIC2
aprisionaría	aprisionar	VIC3
aprisionaríamos	aprisionar	VIC4
aprisionaríais	aprisionar	VIC5
aprisionarían	aprisionar	VIC6
aprisioné	aprisionar	VIX1
aprisionaste	aprisionar	VIX2
aprisionó	aprisionar	VIX3
aprisionasteis	aprisionar	VIX5
aprisionaron	aprisionar	VIX6
aprisione	aprisionar	VSP1
aprisiones	aprisionar	VSP2
aprisionemos	aprisionar	VSP4
aprisionéis	aprisionar	VSP5
aprisionen	aprisionar	VSP6
aprisionara	aprisionar	VSX1
aprisionaras	aprisionar	VSX2
aprisionáramos	aprisionar	VSX4
aprisionarais	aprisionar	VSX5
aprisionaran	aprisionar	VSX6
aprisionare	aprisionar	VSF1
aprisionares	aprisionar	VSF2
aprisionáremos	aprisionar	VSF4
aprisionareis	aprisionar	VSF5
aprisionaren	aprisionar	VSF6
aprisionase	aprisionar	VSI1
aprisionases	aprisionar	VSI2
aprisionásemos	aprisionar	VSI4
aprisionaseis	aprisionar	VSI5
aprisionasen	aprisionar	VSI6
aprisionad	aprisionar	VMP
aprisionadme	aprisionar	VMSE
aprisionadle	aprisionar	VMSE
aprisionadnos	aprisionar	VMPE
aprisionaos	aprisionar	VMPE
aprisionadles	aprisionar	VMPE
aprisionadlo	aprisionar	VMMSE
aprisionadla	aprisionar	VMFSE
aprisionadlos	aprisionar	VMMPE
aprisionadlas	aprisionar	VMFPE
aprisionádmelo	aprisionar	VMMSE
aprisionádselo	aprisionar	VMMSE
aprisionádnoslo	aprisionar	VMMSE
aprisionáoslo	aprisionar	VMMSE
aprisionádmelos	aprisionar	VMMPE
aprisionádselos	aprisionar	VMMPE
aprisionádnoslos	aprisionar	VMMPE
aprisionáoslos	aprisionar	VMMPE
aprisionádmela	aprisionar	VMFSE
aprisionádsela	aprisionar	VMFSE
aprisionádnosla	aprisionar	VMFSE
aprisionáosla	aprisionar	VMFSE
aprisionádmelas	aprisionar	VMFPE
aprisionádselas	aprisionar	VMFPE
aprisionádnoslas	aprisionar	VMFPE
aprisionáoslas	aprisionar	VMFPE
aprisionado	aprisionar	VPM
aprisionados	aprisionar	VPMP
aprisionada	aprisionar	VPF
aprisionadas	aprisionar	VPFP
aprisionando	aprisionar	VG
aprisionándome	aprisionar	VGSE
aprisionándote	aprisionar	VGSE
aprisionándole	aprisionar	VGSE
aprisionándonos	aprisionar	VGPE
aprisionándoos	aprisionar	VGPE
aprisionándolo	aprisionar	VGMSE
aprisionándola	aprisionar	VGFSE
aprisionándolos	aprisionar	VGMPE
aprisionándolas	aprisionar	VGFPE
aprisionándomelo	aprisionar	VGMSE
aprisionándotelo	aprisionar	VGMSE
aprisionándoselo	aprisionar	VGMSE
aprisionándonoslo	aprisionar	VGMSE
aprisionándooslo	aprisionar	VGMSE
aprisionándomelos	aprisionar	VGMPE
aprisionándotelos	aprisionar	VGMPE
aprisionándoselos	aprisionar	VGMPE
aprisionándonoslos	aprisionar	VGMPE
aprisionándooslos	aprisionar	VGMPE
aprisionándomela	aprisionar	VGFSE
aprisionándotela	aprisionar	VGFSE
aprisionándosela	aprisionar	VGFSE
aprisionándonosla	aprisionar	VGFSE
aprisionándoosla	aprisionar	VGFSE
aprisionándomelas	aprisionar	VGFPE
aprisionándotelas	aprisionar	VGFPE
aprisionándoselas	aprisionar	VGFPE
aprisionándonoslas	aprisionar	VGFPE
aprisionándooslas	aprisionar	VGFPE
aproar	aproar	O
aproo	aproar	VIP1
aproas	aproar	VIP2
aproa	aproar	VIP3
aproamos	aproar	VIP4
aproáis	aproar	VIP5
aproan	aproar	VIP6
aproaba	aproar	VII1
aproabas	aproar	VII2
aproábamos	aproar	VII4
aproabais	aproar	VII5
aproaban	aproar	VII6
aproaré	aproar	VIF1
aproarás	aproar	VIF2
aproará	aproar	VIF3
aproaremos	aproar	VIF4
aproaréis	aproar	VIF5
aproarán	aproar	VIF6
aproaría	aproar	VIC1
aproarías	aproar	VIC2
aproaría	aproar	VIC3
aproaríamos	aproar	VIC4
aproaríais	aproar	VIC5
aproarían	aproar	VIC6
aproé	aproar	VIX1
aproaste	aproar	VIX2
aproó	aproar	VIX3
aproasteis	aproar	VIX5
aproaron	aproar	VIX6
aproe	aproar	VSP1
aproes	aproar	VSP2
aproemos	aproar	VSP4
aproéis	aproar	VSP5
aproen	aproar	VSP6
aproara	aproar	VSX1
aproaras	aproar	VSX2
aproáramos	aproar	VSX4
aproarais	aproar	VSX5
aproaran	aproar	VSX6
aproare	aproar	VSF1
aproares	aproar	VSF2
aproáremos	aproar	VSF4
aproareis	aproar	VSF5
aproaren	aproar	VSF6
aproase	aproar	VSI1
aproases	aproar	VSI2
aproásemos	aproar	VSI4
aproaseis	aproar	VSI5
aproasen	aproar	VSI6
aproad	aproar	VMP
aproadme	aproar	VMSE
aproadle	aproar	VMSE
aproadnos	aproar	VMPE
aproaos	aproar	VMPE
aproadles	aproar	VMPE
aproado	aproar	VPM
aproados	aproar	VPMP
aproada	aproar	VPF
aproadas	aproar	VPFP
aproando	aproar	VG
aproándome	aproar	VGSE
aproándote	aproar	VGSE
aproándole	aproar	VGSE
aproándonos	aproar	VGPE
aproándoos	aproar	VGPE
aprobar	aprobar	O
apruebo	aprobar	VIP1
apruebas	aprobar	VIP2
aprueba	aprobar	VIP3
aprobamos	aprobar	VIP4
aprobáis	aprobar	VIP5
aprueban	aprobar	VIP6
aprobaba	aprobar	VII1
aprobabas	aprobar	VII2
aprobábamos	aprobar	VII4
aprobabais	aprobar	VII5
aprobaban	aprobar	VII6
aprobaré	aprobar	VIF1
aprobarás	aprobar	VIF2
aprobará	aprobar	VIF3
aprobaremos	aprobar	VIF4
aprobaréis	aprobar	VIF5
aprobarán	aprobar	VIF6
aprobaría	aprobar	VIC1
aprobarías	aprobar	VIC2
aprobaría	aprobar	VIC3
aprobaríamos	aprobar	VIC4
aprobaríais	aprobar	VIC5
aprobarían	aprobar	VIC6
aprobé	aprobar	VIX1
aprobaste	aprobar	VIX2
aprobó	aprobar	VIX3
aprobasteis	aprobar	VIX5
aprobaron	aprobar	VIX6
apruebe	aprobar	VSP1
apruebes	aprobar	VSP2
aprobemos	aprobar	VSP4
aprobéis	aprobar	VSP5
aprueben	aprobar	VSP6
aprobara	aprobar	VSX1
aprobaras	aprobar	VSX2
aprobáramos	aprobar	VSX4
aprobarais	aprobar	VSX5
aprobaran	aprobar	VSX6
aprobare	aprobar	VSF1
aprobares	aprobar	VSF2
aprobáremos	aprobar	VSF4
aprobareis	aprobar	VSF5
aprobaren	aprobar	VSF6
aprobase	aprobar	VSI1
aprobases	aprobar	VSI2
aprobásemos	aprobar	VSI4
aprobaseis	aprobar	VSI5
aprobasen	aprobar	VSI6
aprobad	aprobar	VMP
aprobadme	aprobar	VMSE
aprobadle	aprobar	VMSE
aprobadnos	aprobar	VMPE
aprobaos	aprobar	VMPE
aprobadles	aprobar	VMPE
aprobadlo	aprobar	VMMSE
aprobadla	aprobar	VMFSE
aprobadlos	aprobar	VMMPE
aprobadlas	aprobar	VMFPE
aprobádmelo	aprobar	VMMSE
aprobádselo	aprobar	VMMSE
aprobádnoslo	aprobar	VMMSE
aprobáoslo	aprobar	VMMSE
aprobádmelos	aprobar	VMMPE
aprobádselos	aprobar	VMMPE
aprobádnoslos	aprobar	VMMPE
aprobáoslos	aprobar	VMMPE
aprobádmela	aprobar	VMFSE
aprobádsela	aprobar	VMFSE
aprobádnosla	aprobar	VMFSE
aprobáosla	aprobar	VMFSE
aprobádmelas	aprobar	VMFPE
aprobádselas	aprobar	VMFPE
aprobádnoslas	aprobar	VMFPE
aprobáoslas	aprobar	VMFPE
aprobado	aprobar	VPM
aprobados	aprobar	VPMP
aprobada	aprobar	VPF
aprobadas	aprobar	VPFP
aprobando	aprobar	VG
aprobándome	aprobar	VGSE
aprobándote	aprobar	VGSE
aprobándole	aprobar	VGSE
aprobándonos	aprobar	VGPE
aprobándoos	aprobar	VGPE
aprobándolo	aprobar	VGMSE
aprobándola	aprobar	VGFSE
aprobándolos	aprobar	VGMPE
aprobándolas	aprobar	VGFPE
aprobándomelo	aprobar	VGMSE
aprobándotelo	aprobar	VGMSE
aprobándoselo	aprobar	VGMSE
aprobándonoslo	aprobar	VGMSE
aprobándooslo	aprobar	VGMSE
aprobándomelos	aprobar	VGMPE
aprobándotelos	aprobar	VGMPE
aprobándoselos	aprobar	VGMPE
aprobándonoslos	aprobar	VGMPE
aprobándooslos	aprobar	VGMPE
aprobándomela	aprobar	VGFSE
aprobándotela	aprobar	VGFSE
aprobándosela	aprobar	VGFSE
aprobándonosla	aprobar	VGFSE
aprobándoosla	aprobar	VGFSE
aprobándomelas	aprobar	VGFPE
aprobándotelas	aprobar	VGFPE
aprobándoselas	aprobar	VGFPE
aprobándonoslas	aprobar	VGFPE
aprobándooslas	aprobar	VGFPE
aprodar	aprodar	O
aprodo	aprodar	VIP1
aprodas	aprodar	VIP2
aproda	aprodar	VIP3
aprodamos	aprodar	VIP4
aprodáis	aprodar	VIP5
aprodan	aprodar	VIP6
aprodaba	aprodar	VII1
aprodabas	aprodar	VII2
aprodábamos	aprodar	VII4
aprodabais	aprodar	VII5
aprodaban	aprodar	VII6
aprodaré	aprodar	VIF1
aprodarás	aprodar	VIF2
aprodará	aprodar	VIF3
aprodaremos	aprodar	VIF4
aprodaréis	aprodar	VIF5
aprodarán	aprodar	VIF6
aprodaría	aprodar	VIC1
aprodarías	aprodar	VIC2
aprodaría	aprodar	VIC3
aprodaríamos	aprodar	VIC4
aprodaríais	aprodar	VIC5
aprodarían	aprodar	VIC6
aprodé	aprodar	VIX1
aprodaste	aprodar	VIX2
aprodó	aprodar	VIX3
aprodasteis	aprodar	VIX5
aprodaron	aprodar	VIX6
aprode	aprodar	VSP1
aprodes	aprodar	VSP2
aprodemos	aprodar	VSP4
aprodéis	aprodar	VSP5
aproden	aprodar	VSP6
aprodara	aprodar	VSX1
aprodaras	aprodar	VSX2
aprodáramos	aprodar	VSX4
aprodarais	aprodar	VSX5
aprodaran	aprodar	VSX6
aprodare	aprodar	VSF1
aprodares	aprodar	VSF2
aprodáremos	aprodar	VSF4
aprodareis	aprodar	VSF5
aprodaren	aprodar	VSF6
aprodase	aprodar	VSI1
aprodases	aprodar	VSI2
aprodásemos	aprodar	VSI4
aprodaseis	aprodar	VSI5
aprodasen	aprodar	VSI6
aprodad	aprodar	VMP
aprodadme	aprodar	VMSE
aprodadle	aprodar	VMSE
aprodadnos	aprodar	VMPE
aprodaos	aprodar	VMPE
aprodadles	aprodar	VMPE
aprodado	aprodar	VPM
aprodados	aprodar	VPMP
aprodada	aprodar	VPF
aprodadas	aprodar	VPFP
aprodando	aprodar	VG
aprodándome	aprodar	VGSE
aprodándote	aprodar	VGSE
aprodándole	aprodar	VGSE
aprodándonos	aprodar	VGPE
aprodándoos	aprodar	VGPE
aprontar	aprontar	O
apronto	aprontar	VIP1
aprontas	aprontar	VIP2
apronta	aprontar	VIP3
aprontamos	aprontar	VIP4
aprontáis	aprontar	VIP5
aprontan	aprontar	VIP6
aprontaba	aprontar	VII1
aprontabas	aprontar	VII2
aprontábamos	aprontar	VII4
aprontabais	aprontar	VII5
aprontaban	aprontar	VII6
aprontaré	aprontar	VIF1
aprontarás	aprontar	VIF2
aprontará	aprontar	VIF3
aprontaremos	aprontar	VIF4
aprontaréis	aprontar	VIF5
aprontarán	aprontar	VIF6
aprontaría	aprontar	VIC1
aprontarías	aprontar	VIC2
aprontaría	aprontar	VIC3
aprontaríamos	aprontar	VIC4
aprontaríais	aprontar	VIC5
aprontarían	aprontar	VIC6
apronté	aprontar	VIX1
aprontaste	aprontar	VIX2
aprontó	aprontar	VIX3
aprontasteis	aprontar	VIX5
aprontaron	aprontar	VIX6
apronte	aprontar	VSP1
aprontes	aprontar	VSP2
aprontemos	aprontar	VSP4
aprontéis	aprontar	VSP5
apronten	aprontar	VSP6
aprontara	aprontar	VSX1
aprontaras	aprontar	VSX2
aprontáramos	aprontar	VSX4
aprontarais	aprontar	VSX5
aprontaran	aprontar	VSX6
aprontare	aprontar	VSF1
aprontares	aprontar	VSF2
aprontáremos	aprontar	VSF4
aprontareis	aprontar	VSF5
aprontaren	aprontar	VSF6
aprontase	aprontar	VSI1
aprontases	aprontar	VSI2
aprontásemos	aprontar	VSI4
aprontaseis	aprontar	VSI5
aprontasen	aprontar	VSI6
aprontad	aprontar	VMP
aprontadme	aprontar	VMSE
aprontadle	aprontar	VMSE
aprontadnos	aprontar	VMPE
aprontaos	aprontar	VMPE
aprontadles	aprontar	VMPE
aprontadlo	aprontar	VMMSE
aprontadla	aprontar	VMFSE
aprontadlos	aprontar	VMMPE
aprontadlas	aprontar	VMFPE
aprontádmelo	aprontar	VMMSE
aprontádselo	aprontar	VMMSE
aprontádnoslo	aprontar	VMMSE
aprontáoslo	aprontar	VMMSE
aprontádmelos	aprontar	VMMPE
aprontádselos	aprontar	VMMPE
aprontádnoslos	aprontar	VMMPE
aprontáoslos	aprontar	VMMPE
aprontádmela	aprontar	VMFSE
aprontádsela	aprontar	VMFSE
aprontádnosla	aprontar	VMFSE
aprontáosla	aprontar	VMFSE
aprontádmelas	aprontar	VMFPE
aprontádselas	aprontar	VMFPE
aprontádnoslas	aprontar	VMFPE
aprontáoslas	aprontar	VMFPE
aprontado	aprontar	VPM
aprontados	aprontar	VPMP
aprontada	aprontar	VPF
aprontadas	aprontar	VPFP
aprontando	aprontar	VG
aprontándome	aprontar	VGSE
aprontándote	aprontar	VGSE
aprontándole	aprontar	VGSE
aprontándonos	aprontar	VGPE
aprontándoos	aprontar	VGPE
aprontándolo	aprontar	VGMSE
aprontándola	aprontar	VGFSE
aprontándolos	aprontar	VGMPE
aprontándolas	aprontar	VGFPE
aprontándomelo	aprontar	VGMSE
aprontándotelo	aprontar	VGMSE
aprontándoselo	aprontar	VGMSE
aprontándonoslo	aprontar	VGMSE
aprontándooslo	aprontar	VGMSE
aprontándomelos	aprontar	VGMPE
aprontándotelos	aprontar	VGMPE
aprontándoselos	aprontar	VGMPE
aprontándonoslos	aprontar	VGMPE
aprontándooslos	aprontar	VGMPE
aprontándomela	aprontar	VGFSE
aprontándotela	aprontar	VGFSE
aprontándosela	aprontar	VGFSE
aprontándonosla	aprontar	VGFSE
aprontándoosla	aprontar	VGFSE
aprontándomelas	aprontar	VGFPE
aprontándotelas	aprontar	VGFPE
aprontándoselas	aprontar	VGFPE
aprontándonoslas	aprontar	VGFPE
aprontándooslas	aprontar	VGFPE
apropiar	apropiar	O
apropio	apropiar	VIP1
apropias	apropiar	VIP2
apropia	apropiar	VIP3
apropiamos	apropiar	VIP4
apropiáis	apropiar	VIP5
apropian	apropiar	VIP6
apropiaba	apropiar	VII1
apropiabas	apropiar	VII2
apropiábamos	apropiar	VII4
apropiabais	apropiar	VII5
apropiaban	apropiar	VII6
apropiaré	apropiar	VIF1
apropiarás	apropiar	VIF2
apropiará	apropiar	VIF3
apropiaremos	apropiar	VIF4
apropiaréis	apropiar	VIF5
apropiarán	apropiar	VIF6
apropiaría	apropiar	VIC1
apropiarías	apropiar	VIC2
apropiaría	apropiar	VIC3
apropiaríamos	apropiar	VIC4
apropiaríais	apropiar	VIC5
apropiarían	apropiar	VIC6
apropié	apropiar	VIX1
apropiaste	apropiar	VIX2
apropió	apropiar	VIX3
apropiasteis	apropiar	VIX5
apropiaron	apropiar	VIX6
apropie	apropiar	VSP1
apropies	apropiar	VSP2
apropiemos	apropiar	VSP4
apropiéis	apropiar	VSP5
apropien	apropiar	VSP6
apropiara	apropiar	VSX1
apropiaras	apropiar	VSX2
apropiáramos	apropiar	VSX4
apropiarais	apropiar	VSX5
apropiaran	apropiar	VSX6
apropiare	apropiar	VSF1
apropiares	apropiar	VSF2
apropiáremos	apropiar	VSF4
apropiareis	apropiar	VSF5
apropiaren	apropiar	VSF6
apropiase	apropiar	VSI1
apropiases	apropiar	VSI2
apropiásemos	apropiar	VSI4
apropiaseis	apropiar	VSI5
apropiasen	apropiar	VSI6
apropiad	apropiar	VMP
apropiadme	apropiar	VMSE
apropiadle	apropiar	VMSE
apropiadnos	apropiar	VMPE
apropiaos	apropiar	VMPE
apropiadles	apropiar	VMPE
apropiadlo	apropiar	VMMSE
apropiadla	apropiar	VMFSE
apropiadlos	apropiar	VMMPE
apropiadlas	apropiar	VMFPE
apropiádmelo	apropiar	VMMSE
apropiádselo	apropiar	VMMSE
apropiádnoslo	apropiar	VMMSE
apropiáoslo	apropiar	VMMSE
apropiádmelos	apropiar	VMMPE
apropiádselos	apropiar	VMMPE
apropiádnoslos	apropiar	VMMPE
apropiáoslos	apropiar	VMMPE
apropiádmela	apropiar	VMFSE
apropiádsela	apropiar	VMFSE
apropiádnosla	apropiar	VMFSE
apropiáosla	apropiar	VMFSE
apropiádmelas	apropiar	VMFPE
apropiádselas	apropiar	VMFPE
apropiádnoslas	apropiar	VMFPE
apropiáoslas	apropiar	VMFPE
apropiado	apropiar	VPM
apropiados	apropiar	VPMP
apropiada	apropiar	VPF
apropiadas	apropiar	VPFP
apropiando	apropiar	VG
apropiándome	apropiar	VGSE
apropiándote	apropiar	VGSE
apropiándole	apropiar	VGSE
apropiándonos	apropiar	VGPE
apropiándoos	apropiar	VGPE
apropiándolo	apropiar	VGMSE
apropiándola	apropiar	VGFSE
apropiándolos	apropiar	VGMPE
apropiándolas	apropiar	VGFPE
apropiándomelo	apropiar	VGMSE
apropiándotelo	apropiar	VGMSE
apropiándoselo	apropiar	VGMSE
apropiándonoslo	apropiar	VGMSE
apropiándooslo	apropiar	VGMSE
apropiándomelos	apropiar	VGMPE
apropiándotelos	apropiar	VGMPE
apropiándoselos	apropiar	VGMPE
apropiándonoslos	apropiar	VGMPE
apropiándooslos	apropiar	VGMPE
apropiándomela	apropiar	VGFSE
apropiándotela	apropiar	VGFSE
apropiándosela	apropiar	VGFSE
apropiándonosla	apropiar	VGFSE
apropiándoosla	apropiar	VGFSE
apropiándomelas	apropiar	VGFPE
apropiándotelas	apropiar	VGFPE
apropiándoselas	apropiar	VGFPE
apropiándonoslas	apropiar	VGFPE
apropiándooslas	apropiar	VGFPE
apropincuar	apropincuar	O
apropincúo	apropincuar	VIP1
apropincuas	apropincuar	VIP2
apropincua	apropincuar	VIP3
apropincuamos	apropincuar	VIP4
apropincuáis	apropincuar	VIP5
apropincuan	apropincuar	VIP6
apropincuaba	apropincuar	VII1
apropincuabas	apropincuar	VII2
apropincuábamos	apropincuar	VII4
apropincuabais	apropincuar	VII5
apropincuaban	apropincuar	VII6
apropincuaré	apropincuar	VIF1
apropincuarás	apropincuar	VIF2
apropincuará	apropincuar	VIF3
apropincuaremos	apropincuar	VIF4
apropincuaréis	apropincuar	VIF5
apropincuarán	apropincuar	VIF6
apropincuaría	apropincuar	VIC1
apropincuarías	apropincuar	VIC2
apropincuaría	apropincuar	VIC3
apropincuaríamos	apropincuar	VIC4
apropincuaríais	apropincuar	VIC5
apropincuarían	apropincuar	VIC6
apropincué	apropincuar	VIX1
apropincuaste	apropincuar	VIX2
apropincuó	apropincuar	VIX3
apropincuasteis	apropincuar	VIX5
apropincuaron	apropincuar	VIX6
apropincúe	apropincuar	VSP1
apropincúes	apropincuar	VSP2
apropincuemos	apropincuar	VSP4
apropincuéis	apropincuar	VSP5
apropincúen	apropincuar	VSP6
apropincuara	apropincuar	VSX1
apropincuaras	apropincuar	VSX2
apropincuáramos	apropincuar	VSX4
apropincuarais	apropincuar	VSX5
apropincuaran	apropincuar	VSX6
apropincuare	apropincuar	VSF1
apropincuares	apropincuar	VSF2
apropincuáremos	apropincuar	VSF4
apropincuareis	apropincuar	VSF5
apropincuaren	apropincuar	VSF6
apropincuase	apropincuar	VSI1
apropincuases	apropincuar	VSI2
apropincuásemos	apropincuar	VSI4
apropincuaseis	apropincuar	VSI5
apropincuasen	apropincuar	VSI6
apropincuad	apropincuar	VMP
apropincuadme	apropincuar	VMSE
apropincuadle	apropincuar	VMSE
apropincuadnos	apropincuar	VMPE
apropincuaos	apropincuar	VMPE
apropincuadles	apropincuar	VMPE
apropincuadlo	apropincuar	VMMSE
apropincuadla	apropincuar	VMFSE
apropincuadlos	apropincuar	VMMPE
apropincuadlas	apropincuar	VMFPE
apropincuádmelo	apropincuar	VMMSE
apropincuádselo	apropincuar	VMMSE
apropincuádnoslo	apropincuar	VMMSE
apropincuáoslo	apropincuar	VMMSE
apropincuádmelos	apropincuar	VMMPE
apropincuádselos	apropincuar	VMMPE
apropincuádnoslos	apropincuar	VMMPE
apropincuáoslos	apropincuar	VMMPE
apropincuádmela	apropincuar	VMFSE
apropincuádsela	apropincuar	VMFSE
apropincuádnosla	apropincuar	VMFSE
apropincuáosla	apropincuar	VMFSE
apropincuádmelas	apropincuar	VMFPE
apropincuádselas	apropincuar	VMFPE
apropincuádnoslas	apropincuar	VMFPE
apropincuáoslas	apropincuar	VMFPE
apropincuado	apropincuar	VPM
apropincuados	apropincuar	VPMP
apropincuada	apropincuar	VPF
apropincuadas	apropincuar	VPFP
apropincuando	apropincuar	VG
apropincuándome	apropincuar	VGSE
apropincuándote	apropincuar	VGSE
apropincuándole	apropincuar	VGSE
apropincuándonos	apropincuar	VGPE
apropincuándoos	apropincuar	VGPE
apropincuándolo	apropincuar	VGMSE
apropincuándola	apropincuar	VGFSE
apropincuándolos	apropincuar	VGMPE
apropincuándolas	apropincuar	VGFPE
apropincuándomelo	apropincuar	VGMSE
apropincuándotelo	apropincuar	VGMSE
apropincuándoselo	apropincuar	VGMSE
apropincuándonoslo	apropincuar	VGMSE
apropincuándooslo	apropincuar	VGMSE
apropincuándomelos	apropincuar	VGMPE
apropincuándotelos	apropincuar	VGMPE
apropincuándoselos	apropincuar	VGMPE
apropincuándonoslos	apropincuar	VGMPE
apropincuándooslos	apropincuar	VGMPE
apropincuándomela	apropincuar	VGFSE
apropincuándotela	apropincuar	VGFSE
apropincuándosela	apropincuar	VGFSE
apropincuándonosla	apropincuar	VGFSE
apropincuándoosla	apropincuar	VGFSE
apropincuándomelas	apropincuar	VGFPE
apropincuándotelas	apropincuar	VGFPE
apropincuándoselas	apropincuar	VGFPE
apropincuándonoslas	apropincuar	VGFPE
apropincuándooslas	apropincuar	VGFPE
aprovechar	aprovechar	O
aprovecho	aprovechar	VIP1
aprovechas	aprovechar	VIP2
aprovecha	aprovechar	VIP3
aprovechamos	aprovechar	VIP4
aprovecháis	aprovechar	VIP5
aprovechan	aprovechar	VIP6
aprovechaba	aprovechar	VII1
aprovechabas	aprovechar	VII2
aprovechábamos	aprovechar	VII4
aprovechabais	aprovechar	VII5
aprovechaban	aprovechar	VII6
aprovecharé	aprovechar	VIF1
aprovecharás	aprovechar	VIF2
aprovechará	aprovechar	VIF3
aprovecharemos	aprovechar	VIF4
aprovecharéis	aprovechar	VIF5
aprovecharán	aprovechar	VIF6
aprovecharía	aprovechar	VIC1
aprovecharías	aprovechar	VIC2
aprovecharía	aprovechar	VIC3
aprovecharíamos	aprovechar	VIC4
aprovecharíais	aprovechar	VIC5
aprovecharían	aprovechar	VIC6
aproveché	aprovechar	VIX1
aprovechaste	aprovechar	VIX2
aprovechó	aprovechar	VIX3
aprovechasteis	aprovechar	VIX5
aprovecharon	aprovechar	VIX6
aproveche	aprovechar	VSP1
aproveches	aprovechar	VSP2
aprovechemos	aprovechar	VSP4
aprovechéis	aprovechar	VSP5
aprovechen	aprovechar	VSP6
aprovechara	aprovechar	VSX1
aprovecharas	aprovechar	VSX2
aprovecháramos	aprovechar	VSX4
aprovecharais	aprovechar	VSX5
aprovecharan	aprovechar	VSX6
aprovechare	aprovechar	VSF1
aprovechares	aprovechar	VSF2
aprovecháremos	aprovechar	VSF4
aprovechareis	aprovechar	VSF5
aprovecharen	aprovechar	VSF6
aprovechase	aprovechar	VSI1
aprovechases	aprovechar	VSI2
aprovechásemos	aprovechar	VSI4
aprovechaseis	aprovechar	VSI5
aprovechasen	aprovechar	VSI6
aprovechad	aprovechar	VMP
aprovechadme	aprovechar	VMSE
aprovechadle	aprovechar	VMSE
aprovechadnos	aprovechar	VMPE
aprovechaos	aprovechar	VMPE
aprovechadles	aprovechar	VMPE
aprovechadlo	aprovechar	VMMSE
aprovechadla	aprovechar	VMFSE
aprovechadlos	aprovechar	VMMPE
aprovechadlas	aprovechar	VMFPE
aprovechádmelo	aprovechar	VMMSE
aprovechádselo	aprovechar	VMMSE
aprovechádnoslo	aprovechar	VMMSE
aprovecháoslo	aprovechar	VMMSE
aprovechádmelos	aprovechar	VMMPE
aprovechádselos	aprovechar	VMMPE
aprovechádnoslos	aprovechar	VMMPE
aprovecháoslos	aprovechar	VMMPE
aprovechádmela	aprovechar	VMFSE
aprovechádsela	aprovechar	VMFSE
aprovechádnosla	aprovechar	VMFSE
aprovecháosla	aprovechar	VMFSE
aprovechádmelas	aprovechar	VMFPE
aprovechádselas	aprovechar	VMFPE
aprovechádnoslas	aprovechar	VMFPE
aprovecháoslas	aprovechar	VMFPE
aprovechado	aprovechar	VPM
aprovechados	aprovechar	VPMP
aprovechada	aprovechar	VPF
aprovechadas	aprovechar	VPFP
aprovechando	aprovechar	VG
aprovechándome	aprovechar	VGSE
aprovechándote	aprovechar	VGSE
aprovechándole	aprovechar	VGSE
aprovechándonos	aprovechar	VGPE
aprovechándoos	aprovechar	VGPE
aprovechándolo	aprovechar	VGMSE
aprovechándola	aprovechar	VGFSE
aprovechándolos	aprovechar	VGMPE
aprovechándolas	aprovechar	VGFPE
aprovechándomelo	aprovechar	VGMSE
aprovechándotelo	aprovechar	VGMSE
aprovechándoselo	aprovechar	VGMSE
aprovechándonoslo	aprovechar	VGMSE
aprovechándooslo	aprovechar	VGMSE
aprovechándomelos	aprovechar	VGMPE
aprovechándotelos	aprovechar	VGMPE
aprovechándoselos	aprovechar	VGMPE
aprovechándonoslos	aprovechar	VGMPE
aprovechándooslos	aprovechar	VGMPE
aprovechándomela	aprovechar	VGFSE
aprovechándotela	aprovechar	VGFSE
aprovechándosela	aprovechar	VGFSE
aprovechándonosla	aprovechar	VGFSE
aprovechándoosla	aprovechar	VGFSE
aprovechándomelas	aprovechar	VGFPE
aprovechándotelas	aprovechar	VGFPE
aprovechándoselas	aprovechar	VGFPE
aprovechándonoslas	aprovechar	VGFPE
aprovechándooslas	aprovechar	VGFPE
aprovisionar	aprovisionar	O
aprovisiono	aprovisionar	VIP1
aprovisionas	aprovisionar	VIP2
aprovisiona	aprovisionar	VIP3
aprovisionamos	aprovisionar	VIP4
aprovisionáis	aprovisionar	VIP5
aprovisionan	aprovisionar	VIP6
aprovisionaba	aprovisionar	VII1
aprovisionabas	aprovisionar	VII2
aprovisionábamos	aprovisionar	VII4
aprovisionabais	aprovisionar	VII5
aprovisionaban	aprovisionar	VII6
aprovisionaré	aprovisionar	VIF1
aprovisionarás	aprovisionar	VIF2
aprovisionará	aprovisionar	VIF3
aprovisionaremos	aprovisionar	VIF4
aprovisionaréis	aprovisionar	VIF5
aprovisionarán	aprovisionar	VIF6
aprovisionaría	aprovisionar	VIC1
aprovisionarías	aprovisionar	VIC2
aprovisionaría	aprovisionar	VIC3
aprovisionaríamos	aprovisionar	VIC4
aprovisionaríais	aprovisionar	VIC5
aprovisionarían	aprovisionar	VIC6
aprovisioné	aprovisionar	VIX1
aprovisionaste	aprovisionar	VIX2
aprovisionó	aprovisionar	VIX3
aprovisionasteis	aprovisionar	VIX5
aprovisionaron	aprovisionar	VIX6
aprovisione	aprovisionar	VSP1
aprovisiones	aprovisionar	VSP2
aprovisionemos	aprovisionar	VSP4
aprovisionéis	aprovisionar	VSP5
aprovisionen	aprovisionar	VSP6
aprovisionara	aprovisionar	VSX1
aprovisionaras	aprovisionar	VSX2
aprovisionáramos	aprovisionar	VSX4
aprovisionarais	aprovisionar	VSX5
aprovisionaran	aprovisionar	VSX6
aprovisionare	aprovisionar	VSF1
aprovisionares	aprovisionar	VSF2
aprovisionáremos	aprovisionar	VSF4
aprovisionareis	aprovisionar	VSF5
aprovisionaren	aprovisionar	VSF6
aprovisionase	aprovisionar	VSI1
aprovisionases	aprovisionar	VSI2
aprovisionásemos	aprovisionar	VSI4
aprovisionaseis	aprovisionar	VSI5
aprovisionasen	aprovisionar	VSI6
aprovisionad	aprovisionar	VMP
aprovisionadme	aprovisionar	VMSE
aprovisionadle	aprovisionar	VMSE
aprovisionadnos	aprovisionar	VMPE
aprovisionaos	aprovisionar	VMPE
aprovisionadles	aprovisionar	VMPE
aprovisionadlo	aprovisionar	VMMSE
aprovisionadla	aprovisionar	VMFSE
aprovisionadlos	aprovisionar	VMMPE
aprovisionadlas	aprovisionar	VMFPE
aprovisionádmelo	aprovisionar	VMMSE
aprovisionádselo	aprovisionar	VMMSE
aprovisionádnoslo	aprovisionar	VMMSE
aprovisionáoslo	aprovisionar	VMMSE
aprovisionádmelos	aprovisionar	VMMPE
aprovisionádselos	aprovisionar	VMMPE
aprovisionádnoslos	aprovisionar	VMMPE
aprovisionáoslos	aprovisionar	VMMPE
aprovisionádmela	aprovisionar	VMFSE
aprovisionádsela	aprovisionar	VMFSE
aprovisionádnosla	aprovisionar	VMFSE
aprovisionáosla	aprovisionar	VMFSE
aprovisionádmelas	aprovisionar	VMFPE
aprovisionádselas	aprovisionar	VMFPE
aprovisionádnoslas	aprovisionar	VMFPE
aprovisionáoslas	aprovisionar	VMFPE
aprovisionado	aprovisionar	VPM
aprovisionados	aprovisionar	VPMP
aprovisionada	aprovisionar	VPF
aprovisionadas	aprovisionar	VPFP
aprovisionando	aprovisionar	VG
aprovisionándome	aprovisionar	VGSE
aprovisionándote	aprovisionar	VGSE
aprovisionándole	aprovisionar	VGSE
aprovisionándonos	aprovisionar	VGPE
aprovisionándoos	aprovisionar	VGPE
aprovisionándolo	aprovisionar	VGMSE
aprovisionándola	aprovisionar	VGFSE
aprovisionándolos	aprovisionar	VGMPE
aprovisionándolas	aprovisionar	VGFPE
aprovisionándomelo	aprovisionar	VGMSE
aprovisionándotelo	aprovisionar	VGMSE
aprovisionándoselo	aprovisionar	VGMSE
aprovisionándonoslo	aprovisionar	VGMSE
aprovisionándooslo	aprovisionar	VGMSE
aprovisionándomelos	aprovisionar	VGMPE
aprovisionándotelos	aprovisionar	VGMPE
aprovisionándoselos	aprovisionar	VGMPE
aprovisionándonoslos	aprovisionar	VGMPE
aprovisionándooslos	aprovisionar	VGMPE
aprovisionándomela	aprovisionar	VGFSE
aprovisionándotela	aprovisionar	VGFSE
aprovisionándosela	aprovisionar	VGFSE
aprovisionándonosla	aprovisionar	VGFSE
aprovisionándoosla	aprovisionar	VGFSE
aprovisionándomelas	aprovisionar	VGFPE
aprovisionándotelas	aprovisionar	VGFPE
aprovisionándoselas	aprovisionar	VGFPE
aprovisionándonoslas	aprovisionar	VGFPE
aprovisionándooslas	aprovisionar	VGFPE
aproximar	aproximar	O
aproximo	aproximar	VIP1
aproximas	aproximar	VIP2
aproxima	aproximar	VIP3
aproximamos	aproximar	VIP4
aproximáis	aproximar	VIP5
aproximan	aproximar	VIP6
aproximaba	aproximar	VII1
aproximabas	aproximar	VII2
aproximábamos	aproximar	VII4
aproximabais	aproximar	VII5
aproximaban	aproximar	VII6
aproximaré	aproximar	VIF1
aproximarás	aproximar	VIF2
aproximará	aproximar	VIF3
aproximaremos	aproximar	VIF4
aproximaréis	aproximar	VIF5
aproximarán	aproximar	VIF6
aproximaría	aproximar	VIC1
aproximarías	aproximar	VIC2
aproximaría	aproximar	VIC3
aproximaríamos	aproximar	VIC4
aproximaríais	aproximar	VIC5
aproximarían	aproximar	VIC6
aproximé	aproximar	VIX1
aproximaste	aproximar	VIX2
aproximó	aproximar	VIX3
aproximasteis	aproximar	VIX5
aproximaron	aproximar	VIX6
aproxime	aproximar	VSP1
aproximes	aproximar	VSP2
aproximemos	aproximar	VSP4
aproximéis	aproximar	VSP5
aproximen	aproximar	VSP6
aproximara	aproximar	VSX1
aproximaras	aproximar	VSX2
aproximáramos	aproximar	VSX4
aproximarais	aproximar	VSX5
aproximaran	aproximar	VSX6
aproximare	aproximar	VSF1
aproximares	aproximar	VSF2
aproximáremos	aproximar	VSF4
aproximareis	aproximar	VSF5
aproximaren	aproximar	VSF6
aproximase	aproximar	VSI1
aproximases	aproximar	VSI2
aproximásemos	aproximar	VSI4
aproximaseis	aproximar	VSI5
aproximasen	aproximar	VSI6
aproximad	aproximar	VMP
aproximadme	aproximar	VMSE
aproximadle	aproximar	VMSE
aproximadnos	aproximar	VMPE
aproximaos	aproximar	VMPE
aproximadles	aproximar	VMPE
aproximadlo	aproximar	VMMSE
aproximadla	aproximar	VMFSE
aproximadlos	aproximar	VMMPE
aproximadlas	aproximar	VMFPE
aproximádmelo	aproximar	VMMSE
aproximádselo	aproximar	VMMSE
aproximádnoslo	aproximar	VMMSE
aproximáoslo	aproximar	VMMSE
aproximádmelos	aproximar	VMMPE
aproximádselos	aproximar	VMMPE
aproximádnoslos	aproximar	VMMPE
aproximáoslos	aproximar	VMMPE
aproximádmela	aproximar	VMFSE
aproximádsela	aproximar	VMFSE
aproximádnosla	aproximar	VMFSE
aproximáosla	aproximar	VMFSE
aproximádmelas	aproximar	VMFPE
aproximádselas	aproximar	VMFPE
aproximádnoslas	aproximar	VMFPE
aproximáoslas	aproximar	VMFPE
aproximado	aproximar	VPM
aproximados	aproximar	VPMP
aproximada	aproximar	VPF
aproximadas	aproximar	VPFP
aproximando	aproximar	VG
aproximándome	aproximar	VGSE
aproximándote	aproximar	VGSE
aproximándole	aproximar	VGSE
aproximándonos	aproximar	VGPE
aproximándoos	aproximar	VGPE
aproximándolo	aproximar	VGMSE
aproximándola	aproximar	VGFSE
aproximándolos	aproximar	VGMPE
aproximándolas	aproximar	VGFPE
aproximándomelo	aproximar	VGMSE
aproximándotelo	aproximar	VGMSE
aproximándoselo	aproximar	VGMSE
aproximándonoslo	aproximar	VGMSE
aproximándooslo	aproximar	VGMSE
aproximándomelos	aproximar	VGMPE
aproximándotelos	aproximar	VGMPE
aproximándoselos	aproximar	VGMPE
aproximándonoslos	aproximar	VGMPE
aproximándooslos	aproximar	VGMPE
aproximándomela	aproximar	VGFSE
aproximándotela	aproximar	VGFSE
aproximándosela	aproximar	VGFSE
aproximándonosla	aproximar	VGFSE
aproximándoosla	aproximar	VGFSE
aproximándomelas	aproximar	VGFPE
aproximándotelas	aproximar	VGFPE
aproximándoselas	aproximar	VGFPE
aproximándonoslas	aproximar	VGFPE
aproximándooslas	aproximar	VGFPE
