axial	axial	O
axiales	axial	P
axil	axil	O
axiles	axil	P
axila	axila	O
axilas	axila	P
axilar	axilar	O
axilares	axilar	P
axinita	axinita	O
axinitas	axinita	P
axiología	axiología	O
axiologías	axiología	P
axiológico	axiológico	O
axiológicas	axiológico	FP
axiológica	axiológico	F
axiológicos	axiológico	P
axioma	axioma	O
axiomas	axioma	P
axiomatización	axiomatización	O
axiomatizaciones	axiomatización	P
axiomático	axiomático	O
axiomáticas	axiomático	FP
axiomática	axiomático	F
axiomáticos	axiomático	P
axis	axis	O
axiómetro	axiómetro	O
axiómetros	axiómetro	P
axiomatizar	axiomatizar	O
axiomatizo	axiomatizar	VIP1
axiomatizas	axiomatizar	VIP2
axiomatiza	axiomatizar	VIP3
axiomatizamos	axiomatizar	VIP4
axiomatizáis	axiomatizar	VIP5
axiomatizan	axiomatizar	VIP6
axiomatizaba	axiomatizar	VII1
axiomatizabas	axiomatizar	VII2
axiomatizábamos	axiomatizar	VII4
axiomatizabais	axiomatizar	VII5
axiomatizaban	axiomatizar	VII6
axiomatizaré	axiomatizar	VIF1
axiomatizarás	axiomatizar	VIF2
axiomatizará	axiomatizar	VIF3
axiomatizaremos	axiomatizar	VIF4
axiomatizaréis	axiomatizar	VIF5
axiomatizarán	axiomatizar	VIF6
axiomatizaría	axiomatizar	VIC1
axiomatizarías	axiomatizar	VIC2
axiomatizaría	axiomatizar	VIC3
axiomatizaríamos	axiomatizar	VIC4
axiomatizaríais	axiomatizar	VIC5
axiomatizarían	axiomatizar	VIC6
axiomaticé	axiomatizar	VIX1
axiomatizaste	axiomatizar	VIX2
axiomatizó	axiomatizar	VIX3
axiomatizasteis	axiomatizar	VIX5
axiomatizaron	axiomatizar	VIX6
axiomatice	axiomatizar	VSP1
axiomatices	axiomatizar	VSP2
axiomaticemos	axiomatizar	VSP4
axiomaticéis	axiomatizar	VSP5
axiomaticen	axiomatizar	VSP6
axiomatizara	axiomatizar	VSX1
axiomatizaras	axiomatizar	VSX2
axiomatizáramos	axiomatizar	VSX4
axiomatizarais	axiomatizar	VSX5
axiomatizaran	axiomatizar	VSX6
axiomatizare	axiomatizar	VSF1
axiomatizares	axiomatizar	VSF2
axiomatizáremos	axiomatizar	VSF4
axiomatizareis	axiomatizar	VSF5
axiomatizaren	axiomatizar	VSF6
axiomatizase	axiomatizar	VSI1
axiomatizases	axiomatizar	VSI2
axiomatizásemos	axiomatizar	VSI4
axiomatizaseis	axiomatizar	VSI5
axiomatizasen	axiomatizar	VSI6
axiomatizad	axiomatizar	VMP
axiomatizadme	axiomatizar	VMSE
axiomatizadle	axiomatizar	VMSE
axiomatizadnos	axiomatizar	VMPE
axiomatizaos	axiomatizar	VMPE
axiomatizadles	axiomatizar	VMPE
axiomatizadlo	axiomatizar	VMMSE
axiomatizadla	axiomatizar	VMFSE
axiomatizadlos	axiomatizar	VMMPE
axiomatizadlas	axiomatizar	VMFPE
axiomatizádmelo	axiomatizar	VMMSE
axiomatizádselo	axiomatizar	VMMSE
axiomatizádnoslo	axiomatizar	VMMSE
axiomatizáoslo	axiomatizar	VMMSE
axiomatizádmelos	axiomatizar	VMMPE
axiomatizádselos	axiomatizar	VMMPE
axiomatizádnoslos	axiomatizar	VMMPE
axiomatizáoslos	axiomatizar	VMMPE
axiomatizádmela	axiomatizar	VMFSE
axiomatizádsela	axiomatizar	VMFSE
axiomatizádnosla	axiomatizar	VMFSE
axiomatizáosla	axiomatizar	VMFSE
axiomatizádmelas	axiomatizar	VMFPE
axiomatizádselas	axiomatizar	VMFPE
axiomatizádnoslas	axiomatizar	VMFPE
axiomatizáoslas	axiomatizar	VMFPE
axiomatizado	axiomatizar	VPM
axiomatizados	axiomatizar	VPMP
axiomatizada	axiomatizar	VPF
axiomatizadas	axiomatizar	VPFP
axiomatizando	axiomatizar	VG
axiomatizándome	axiomatizar	VGSE
axiomatizándote	axiomatizar	VGSE
axiomatizándole	axiomatizar	VGSE
axiomatizándonos	axiomatizar	VGPE
axiomatizándoos	axiomatizar	VGPE
axiomatizándolo	axiomatizar	VGMSE
axiomatizándola	axiomatizar	VGFSE
axiomatizándolos	axiomatizar	VGMPE
axiomatizándolas	axiomatizar	VGFPE
axiomatizándomelo	axiomatizar	VGMSE
axiomatizándotelo	axiomatizar	VGMSE
axiomatizándoselo	axiomatizar	VGMSE
axiomatizándonoslo	axiomatizar	VGMSE
axiomatizándooslo	axiomatizar	VGMSE
axiomatizándomelos	axiomatizar	VGMPE
axiomatizándotelos	axiomatizar	VGMPE
axiomatizándoselos	axiomatizar	VGMPE
axiomatizándonoslos	axiomatizar	VGMPE
axiomatizándooslos	axiomatizar	VGMPE
axiomatizándomela	axiomatizar	VGFSE
axiomatizándotela	axiomatizar	VGFSE
axiomatizándosela	axiomatizar	VGFSE
axiomatizándonosla	axiomatizar	VGFSE
axiomatizándoosla	axiomatizar	VGFSE
axiomatizándomelas	axiomatizar	VGFPE
axiomatizándotelas	axiomatizar	VGFPE
axiomatizándoselas	axiomatizar	VGFPE
axiomatizándonoslas	axiomatizar	VGFPE
axiomatizándooslas	axiomatizar	VGFPE
