baga	baga	O
bagas	baga	P
bagacera	bagacera	O
bagaceras	bagacera	P
bagaje	bagaje	O
bagajes	bagaje	P
bagajero	bagajero	O
bagajeros	bagajero	P
bagarino	bagarino	O
bagarinos	bagarino	P
bagasa	bagasa	O
bagasas	bagasa	P
bagatela	bagatela	O
bagatelas	bagatela	P
bagazal	bagazal	O
bagazales	bagazal	P
bagazo	bagazo	O
bagazos	bagazo	P
bago	bago	O
bagos	bago	P
bagre	bagre	O
bagres	bagre	P
bagrero	bagrero	O
bagreros	bagrero	P
bagual	bagual	O
bagualas	bagual	FP
baguala	bagual	F
baguales	bagual	P
bagualada	bagualada	O
bagualadas	bagualada	P
baguio	baguio	O
baguios	baguio	P
bagá	bagá	O
bagás	bagá	P
bagar	bagar	O
bago	bagar	VIP1
bagas	bagar	VIP2
baga	bagar	VIP3
bagamos	bagar	VIP4
bagáis	bagar	VIP5
bagan	bagar	VIP6
bagaba	bagar	VII1
bagabas	bagar	VII2
bagábamos	bagar	VII4
bagabais	bagar	VII5
bagaban	bagar	VII6
bagaré	bagar	VIF1
bagarás	bagar	VIF2
bagará	bagar	VIF3
bagaremos	bagar	VIF4
bagaréis	bagar	VIF5
bagarán	bagar	VIF6
bagaría	bagar	VIC1
bagarías	bagar	VIC2
bagaría	bagar	VIC3
bagaríamos	bagar	VIC4
bagaríais	bagar	VIC5
bagarían	bagar	VIC6
bagé	bagar	VIX1
bagaste	bagar	VIX2
bagó	bagar	VIX3
bagasteis	bagar	VIX5
bagaron	bagar	VIX6
bague	bagar	VSP1
bagues	bagar	VSP2
baguemos	bagar	VSP4
baguéis	bagar	VSP5
baguen	bagar	VSP6
bagara	bagar	VSX1
bagaras	bagar	VSX2
bagáramos	bagar	VSX4
bagarais	bagar	VSX5
bagaran	bagar	VSX6
bagare	bagar	VSF1
bagares	bagar	VSF2
bagáremos	bagar	VSF4
bagareis	bagar	VSF5
bagaren	bagar	VSF6
bagase	bagar	VSI1
bagases	bagar	VSI2
bagásemos	bagar	VSI4
bagaseis	bagar	VSI5
bagasen	bagar	VSI6
bagad	bagar	VMP
bagadme	bagar	VMSE
bagadle	bagar	VMSE
bagadnos	bagar	VMPE
bagaos	bagar	VMPE
bagadles	bagar	VMPE
bagado	bagar	VPM
bagados	bagar	VPMP
bagada	bagar	VPF
bagadas	bagar	VPFP
bagando	bagar	VG
bagándome	bagar	VGSE
bagándote	bagar	VGSE
bagándole	bagar	VGSE
bagándonos	bagar	VGPE
bagándoos	bagar	VGPE
