baca	baca	O
bacas	baca	P
bacada	bacada	O
bacadas	bacada	P
bacalada	bacalada	O
bacaladas	bacalada	P
bacaladero	bacaladero	O
bacaladeras	bacaladero	FP
bacaladera	bacaladero	F
bacaladeros	bacaladero	P
bacaladilla	bacaladilla	O
bacaladillas	bacaladilla	P
bacalao	bacalao	O
bacalaos	bacalao	P
bacallao	bacallao	O
bacallaos	bacallao	P
bacallar	bacallar	O
bacallares	bacallar	P
bacanal	bacanal	O
bacanales	bacanal	P
bacanora	bacanora	O
bacanoras	bacanora	P
bacante	bacante	O
bacantes	bacante	P
bacaray	bacaray	O
bacarayes	bacaray	P
bacarrá	bacarrá	O
bacarrás	bacarrá	P
bacará	bacará	O
bacarás	bacará	P
bacelar	bacelar	O
bacelares	bacelar	P
bacera	bacera	O
baceras	bacera	P
baceta	baceta	O
bacetas	baceta	P
bachaco	bachaco	O
bachacas	bachaco	FP
bachaca	bachaco	F
bachacos	bachaco	P
bachata	bachata	O
bachatas	bachata	P
bachatero	bachatero	O
bachateras	bachatero	FP
bachatera	bachatero	F
bachateros	bachatero	P
bache	bache	O
baches	bache	P
bacheo	bacheo	O
bacheos	bacheo	P
bachicha	bachicha	O
bachichas	bachicha	P
bachiche	bachiche	O
bachiches	bachiche	P
bachiller	bachiller	O
bachilleras	bachiller	FP
bachillera	bachiller	F
bachilleres	bachiller	P
bachilleramiento	bachilleramiento	O
bachilleramientos	bachilleramiento	P
bachillerato	bachillerato	O
bachilleratos	bachillerato	P
bachillería	bachillería	O
bachillerías	bachillería	P
bacilar	bacilar	O
bacilares	bacilar	P
bacillar	bacillar	O
bacillares	bacillar	P
bacillo	bacillo	O
bacillos	bacillo	P
bacilo	bacilo	O
bacilos	bacilo	P
bacina	bacina	O
bacinas	bacina	P
bacinada	bacinada	O
bacinadas	bacinada	P
bacinador	bacinador	O
bacinadores	bacinador	P
bacinero	bacinero	O
bacineras	bacinero	FP
bacinera	bacinero	F
bacineros	bacinero	P
bacineta	bacineta	O
bacinetas	bacineta	P
bacinete	bacinete	O
bacinetes	bacinete	P
bacinica	bacinica	O
bacinicas	bacinica	P
bacinilla	bacinilla	O
bacinillas	bacinilla	P
bacisco	bacisco	O
baciscos	bacisco	P
bacon	bacon	O
bacones	bacon	P
baconiano	baconiano	O
baconianas	baconiano	FP
baconiana	baconiano	F
baconianos	baconiano	P
bacoreta	bacoreta	O
bacoretas	bacoreta	P
bacteria	bacteria	O
bacterias	bacteria	P
bacteriano	bacteriano	O
bacterianas	bacteriano	FP
bacteriana	bacteriano	F
bacterianos	bacteriano	P
bactericida	bactericida	O
bactericidas	bactericida	P
bacteriemia	bacteriemia	O
bacteriemias	bacteriemia	P
bacteriología	bacteriología	O
bacteriologías	bacteriología	P
bacteriológico	bacteriológico	O
bacteriológicas	bacteriológico	FP
bacteriológica	bacteriológico	F
bacteriológicos	bacteriológico	P
bacteriostático	bacteriostático	O
bacteriostáticas	bacteriostático	FP
bacteriostática	bacteriostático	F
bacteriostáticos	bacteriostático	P
bacteriófago	bacteriófago	O
bacteriófagos	bacteriófago	P
bacteriólogo	bacteriólogo	O
bacteriólogas	bacteriólogo	FP
bacterióloga	bacteriólogo	F
bacteriólogos	bacteriólogo	P
bactriano	bactriano	O
bactrianas	bactriano	FP
bactriana	bactriano	F
bactrianos	bactriano	P
bacán	bacán	O
bacanas	bacán	FP
bacana	bacán	F
bacanes	bacán	P
bacía	bacía	O
bacías	bacía	P
bacín	bacín	O
bacines	bacín	P
bácara	bácara	O
bácaras	bácara	P
bácaris	bácaris	O
báciga	báciga	O
bácigas	báciga	P
báculo	báculo	O
báculos	báculo	P
bachatear	bachatear	O
bachateo	bachatear	VIP1
bachateas	bachatear	VIP2
bachatea	bachatear	VIP3
bachateamos	bachatear	VIP4
bachateáis	bachatear	VIP5
bachatean	bachatear	VIP6
bachateaba	bachatear	VII1
bachateabas	bachatear	VII2
bachateábamos	bachatear	VII4
bachateabais	bachatear	VII5
bachateaban	bachatear	VII6
bachatearé	bachatear	VIF1
bachatearás	bachatear	VIF2
bachateará	bachatear	VIF3
bachatearemos	bachatear	VIF4
bachatearéis	bachatear	VIF5
bachatearán	bachatear	VIF6
bachatearía	bachatear	VIC1
bachatearías	bachatear	VIC2
bachatearía	bachatear	VIC3
bachatearíamos	bachatear	VIC4
bachatearíais	bachatear	VIC5
bachatearían	bachatear	VIC6
bachateé	bachatear	VIX1
bachateaste	bachatear	VIX2
bachateó	bachatear	VIX3
bachateasteis	bachatear	VIX5
bachatearon	bachatear	VIX6
bachatee	bachatear	VSP1
bachatees	bachatear	VSP2
bachateemos	bachatear	VSP4
bachateéis	bachatear	VSP5
bachateen	bachatear	VSP6
bachateara	bachatear	VSX1
bachatearas	bachatear	VSX2
bachateáramos	bachatear	VSX4
bachatearais	bachatear	VSX5
bachatearan	bachatear	VSX6
bachateare	bachatear	VSF1
bachateares	bachatear	VSF2
bachateáremos	bachatear	VSF4
bachateareis	bachatear	VSF5
bachatearen	bachatear	VSF6
bachatease	bachatear	VSI1
bachateases	bachatear	VSI2
bachateásemos	bachatear	VSI4
bachateaseis	bachatear	VSI5
bachateasen	bachatear	VSI6
bachatead	bachatear	VMP
bachateadme	bachatear	VMSE
bachateadle	bachatear	VMSE
bachateadnos	bachatear	VMPE
bachateaos	bachatear	VMPE
bachateadles	bachatear	VMPE
bachateado	bachatear	VPM
bachateados	bachatear	VPMP
bachateada	bachatear	VPF
bachateadas	bachatear	VPFP
bachateando	bachatear	VG
bachateándome	bachatear	VGSE
bachateándote	bachatear	VGSE
bachateándole	bachatear	VGSE
bachateándonos	bachatear	VGPE
bachateándoos	bachatear	VGPE
bachear	bachear	O
bacheo	bachear	VIP1
bacheas	bachear	VIP2
bachea	bachear	VIP3
bacheamos	bachear	VIP4
bacheáis	bachear	VIP5
bachean	bachear	VIP6
bacheaba	bachear	VII1
bacheabas	bachear	VII2
bacheábamos	bachear	VII4
bacheabais	bachear	VII5
bacheaban	bachear	VII6
bachearé	bachear	VIF1
bachearás	bachear	VIF2
bacheará	bachear	VIF3
bachearemos	bachear	VIF4
bachearéis	bachear	VIF5
bachearán	bachear	VIF6
bachearía	bachear	VIC1
bachearías	bachear	VIC2
bachearía	bachear	VIC3
bachearíamos	bachear	VIC4
bachearíais	bachear	VIC5
bachearían	bachear	VIC6
bacheé	bachear	VIX1
bacheaste	bachear	VIX2
bacheó	bachear	VIX3
bacheasteis	bachear	VIX5
bachearon	bachear	VIX6
bachee	bachear	VSP1
bachees	bachear	VSP2
bacheemos	bachear	VSP4
bacheéis	bachear	VSP5
bacheen	bachear	VSP6
bacheara	bachear	VSX1
bachearas	bachear	VSX2
bacheáramos	bachear	VSX4
bachearais	bachear	VSX5
bachearan	bachear	VSX6
bacheare	bachear	VSF1
bacheares	bachear	VSF2
bacheáremos	bachear	VSF4
bacheareis	bachear	VSF5
bachearen	bachear	VSF6
bachease	bachear	VSI1
bacheases	bachear	VSI2
bacheásemos	bachear	VSI4
bacheaseis	bachear	VSI5
bacheasen	bachear	VSI6
bachead	bachear	VMP
bacheadme	bachear	VMSE
bacheadle	bachear	VMSE
bacheadnos	bachear	VMPE
bacheaos	bachear	VMPE
bacheadles	bachear	VMPE
bacheadlo	bachear	VMMSE
bacheadla	bachear	VMFSE
bacheadlos	bachear	VMMPE
bacheadlas	bachear	VMFPE
bacheádmelo	bachear	VMMSE
bacheádselo	bachear	VMMSE
bacheádnoslo	bachear	VMMSE
bacheáoslo	bachear	VMMSE
bacheádmelos	bachear	VMMPE
bacheádselos	bachear	VMMPE
bacheádnoslos	bachear	VMMPE
bacheáoslos	bachear	VMMPE
bacheádmela	bachear	VMFSE
bacheádsela	bachear	VMFSE
bacheádnosla	bachear	VMFSE
bacheáosla	bachear	VMFSE
bacheádmelas	bachear	VMFPE
bacheádselas	bachear	VMFPE
bacheádnoslas	bachear	VMFPE
bacheáoslas	bachear	VMFPE
bacheado	bachear	VPM
bacheados	bachear	VPMP
bacheada	bachear	VPF
bacheadas	bachear	VPFP
bacheando	bachear	VG
bacheándome	bachear	VGSE
bacheándote	bachear	VGSE
bacheándole	bachear	VGSE
bacheándonos	bachear	VGPE
bacheándoos	bachear	VGPE
bacheándolo	bachear	VGMSE
bacheándola	bachear	VGFSE
bacheándolos	bachear	VGMPE
bacheándolas	bachear	VGFPE
bacheándomelo	bachear	VGMSE
bacheándotelo	bachear	VGMSE
bacheándoselo	bachear	VGMSE
bacheándonoslo	bachear	VGMSE
bacheándooslo	bachear	VGMSE
bacheándomelos	bachear	VGMPE
bacheándotelos	bachear	VGMPE
bacheándoselos	bachear	VGMPE
bacheándonoslos	bachear	VGMPE
bacheándooslos	bachear	VGMPE
bacheándomela	bachear	VGFSE
bacheándotela	bachear	VGFSE
bacheándosela	bachear	VGFSE
bacheándonosla	bachear	VGFSE
bacheándoosla	bachear	VGFSE
bacheándomelas	bachear	VGFPE
bacheándotelas	bachear	VGFPE
bacheándoselas	bachear	VGFPE
bacheándonoslas	bachear	VGFPE
bacheándooslas	bachear	VGFPE
bachillerar	bachillerar	O
bachillero	bachillerar	VIP1
bachilleras	bachillerar	VIP2
bachillera	bachillerar	VIP3
bachilleramos	bachillerar	VIP4
bachilleráis	bachillerar	VIP5
bachilleran	bachillerar	VIP6
bachilleraba	bachillerar	VII1
bachillerabas	bachillerar	VII2
bachillerábamos	bachillerar	VII4
bachillerabais	bachillerar	VII5
bachilleraban	bachillerar	VII6
bachilleraré	bachillerar	VIF1
bachillerarás	bachillerar	VIF2
bachillerará	bachillerar	VIF3
bachilleraremos	bachillerar	VIF4
bachilleraréis	bachillerar	VIF5
bachillerarán	bachillerar	VIF6
bachilleraría	bachillerar	VIC1
bachillerarías	bachillerar	VIC2
bachilleraría	bachillerar	VIC3
bachilleraríamos	bachillerar	VIC4
bachilleraríais	bachillerar	VIC5
bachillerarían	bachillerar	VIC6
bachilleré	bachillerar	VIX1
bachilleraste	bachillerar	VIX2
bachilleró	bachillerar	VIX3
bachillerasteis	bachillerar	VIX5
bachilleraron	bachillerar	VIX6
bachillere	bachillerar	VSP1
bachilleres	bachillerar	VSP2
bachilleremos	bachillerar	VSP4
bachilleréis	bachillerar	VSP5
bachilleren	bachillerar	VSP6
bachillerara	bachillerar	VSX1
bachilleraras	bachillerar	VSX2
bachilleráramos	bachillerar	VSX4
bachillerarais	bachillerar	VSX5
bachilleraran	bachillerar	VSX6
bachillerare	bachillerar	VSF1
bachillerares	bachillerar	VSF2
bachilleráremos	bachillerar	VSF4
bachillerareis	bachillerar	VSF5
bachilleraren	bachillerar	VSF6
bachillerase	bachillerar	VSI1
bachillerases	bachillerar	VSI2
bachillerásemos	bachillerar	VSI4
bachilleraseis	bachillerar	VSI5
bachillerasen	bachillerar	VSI6
bachillerad	bachillerar	VMP
bachilleradme	bachillerar	VMSE
bachilleradle	bachillerar	VMSE
bachilleradnos	bachillerar	VMPE
bachilleraos	bachillerar	VMPE
bachilleradles	bachillerar	VMPE
bachilleradlo	bachillerar	VMMSE
bachilleradla	bachillerar	VMFSE
bachilleradlos	bachillerar	VMMPE
bachilleradlas	bachillerar	VMFPE
bachillerádmelo	bachillerar	VMMSE
bachillerádselo	bachillerar	VMMSE
bachillerádnoslo	bachillerar	VMMSE
bachilleráoslo	bachillerar	VMMSE
bachillerádmelos	bachillerar	VMMPE
bachillerádselos	bachillerar	VMMPE
bachillerádnoslos	bachillerar	VMMPE
bachilleráoslos	bachillerar	VMMPE
bachillerádmela	bachillerar	VMFSE
bachillerádsela	bachillerar	VMFSE
bachillerádnosla	bachillerar	VMFSE
bachilleráosla	bachillerar	VMFSE
bachillerádmelas	bachillerar	VMFPE
bachillerádselas	bachillerar	VMFPE
bachillerádnoslas	bachillerar	VMFPE
bachilleráoslas	bachillerar	VMFPE
bachillerado	bachillerar	VPM
bachillerados	bachillerar	VPMP
bachillerada	bachillerar	VPF
bachilleradas	bachillerar	VPFP
bachillerando	bachillerar	VG
bachillerándome	bachillerar	VGSE
bachillerándote	bachillerar	VGSE
bachillerándole	bachillerar	VGSE
bachillerándonos	bachillerar	VGPE
bachillerándoos	bachillerar	VGPE
bachillerándolo	bachillerar	VGMSE
bachillerándola	bachillerar	VGFSE
bachillerándolos	bachillerar	VGMPE
bachillerándolas	bachillerar	VGFPE
bachillerándomelo	bachillerar	VGMSE
bachillerándotelo	bachillerar	VGMSE
bachillerándoselo	bachillerar	VGMSE
bachillerándonoslo	bachillerar	VGMSE
bachillerándooslo	bachillerar	VGMSE
bachillerándomelos	bachillerar	VGMPE
bachillerándotelos	bachillerar	VGMPE
bachillerándoselos	bachillerar	VGMPE
bachillerándonoslos	bachillerar	VGMPE
bachillerándooslos	bachillerar	VGMPE
bachillerándomela	bachillerar	VGFSE
bachillerándotela	bachillerar	VGFSE
bachillerándosela	bachillerar	VGFSE
bachillerándonosla	bachillerar	VGFSE
bachillerándoosla	bachillerar	VGFSE
bachillerándomelas	bachillerar	VGFPE
bachillerándotelas	bachillerar	VGFPE
bachillerándoselas	bachillerar	VGFPE
bachillerándonoslas	bachillerar	VGFPE
bachillerándooslas	bachillerar	VGFPE
bachillerear	bachillerear	O
bachillereo	bachillerear	VIP1
bachillereas	bachillerear	VIP2
bachillerea	bachillerear	VIP3
bachillereamos	bachillerear	VIP4
bachillereáis	bachillerear	VIP5
bachillerean	bachillerear	VIP6
bachillereaba	bachillerear	VII1
bachillereabas	bachillerear	VII2
bachillereábamos	bachillerear	VII4
bachillereabais	bachillerear	VII5
bachillereaban	bachillerear	VII6
bachillerearé	bachillerear	VIF1
bachillerearás	bachillerear	VIF2
bachillereará	bachillerear	VIF3
bachillerearemos	bachillerear	VIF4
bachillerearéis	bachillerear	VIF5
bachillerearán	bachillerear	VIF6
bachillerearía	bachillerear	VIC1
bachillerearías	bachillerear	VIC2
bachillerearía	bachillerear	VIC3
bachillerearíamos	bachillerear	VIC4
bachillerearíais	bachillerear	VIC5
bachillerearían	bachillerear	VIC6
bachillereé	bachillerear	VIX1
bachillereaste	bachillerear	VIX2
bachillereó	bachillerear	VIX3
bachillereasteis	bachillerear	VIX5
bachillerearon	bachillerear	VIX6
bachilleree	bachillerear	VSP1
bachillerees	bachillerear	VSP2
bachillereemos	bachillerear	VSP4
bachillereéis	bachillerear	VSP5
bachillereen	bachillerear	VSP6
bachillereara	bachillerear	VSX1
bachillerearas	bachillerear	VSX2
bachillereáramos	bachillerear	VSX4
bachillerearais	bachillerear	VSX5
bachillerearan	bachillerear	VSX6
bachillereare	bachillerear	VSF1
bachillereares	bachillerear	VSF2
bachillereáremos	bachillerear	VSF4
bachillereareis	bachillerear	VSF5
bachillerearen	bachillerear	VSF6
bachillerease	bachillerear	VSI1
bachillereases	bachillerear	VSI2
bachillereásemos	bachillerear	VSI4
bachillereaseis	bachillerear	VSI5
bachillereasen	bachillerear	VSI6
bachilleread	bachillerear	VMP
bachillereadme	bachillerear	VMSE
bachillereadle	bachillerear	VMSE
bachillereadnos	bachillerear	VMPE
bachillereaos	bachillerear	VMPE
bachillereadles	bachillerear	VMPE
bachillereado	bachillerear	VPM
bachillereados	bachillerear	VPMP
bachillereada	bachillerear	VPF
bachillereadas	bachillerear	VPFP
bachillereando	bachillerear	VG
bachillereándome	bachillerear	VGSE
bachillereándote	bachillerear	VGSE
bachillereándole	bachillerear	VGSE
bachillereándonos	bachillerear	VGPE
bachillereándoos	bachillerear	VGPE
