ben	ben	O
benes	ben	P
benceno	benceno	O
bencenos	benceno	P
bencina	bencina	O
bencinas	bencina	P
bencénico	bencénico	O
bencénicas	bencénico	FP
bencénica	bencénico	F
bencénicos	bencénico	P
bendecidor	bendecidor	O
bendecidoras	bendecidor	FP
bendecidora	bendecidor	F
bendecidores	bendecidor	P
bendicera	bendicera	O
bendiceras	bendicera	P
bendición	bendición	O
bendiciones	bendición	P
benditera	benditera	O
benditeras	benditera	P
bendito	bendito	O
benditas	bendito	FP
bendita	bendito	F
benditos	bendito	P
benedicta	benedicta	O
benedictas	benedicta	P
benedictino	benedictino	O
benedictinas	benedictino	FP
benedictina	benedictino	F
benedictinos	benedictino	P
benedícite	benedícite	O
benedícites	benedícite	P
benefactor	benefactor	O
benefactoras	benefactor	FP
benefactora	benefactor	F
benefactores	benefactor	P
benefactría	benefactría	O
benefactrías	benefactría	P
beneficencia	beneficencia	O
beneficencias	beneficencia	P
beneficiación	beneficiación	O
beneficiaciones	beneficiación	P
beneficiado	beneficiado	O
beneficiados	beneficiado	P
beneficiador	beneficiador	O
beneficiadoras	beneficiador	FP
beneficiadora	beneficiador	F
beneficiadores	beneficiador	P
beneficial	beneficial	O
beneficiales	beneficial	P
beneficiario	beneficiario	O
beneficiarias	beneficiario	FP
beneficiaria	beneficiario	F
beneficiarios	beneficiario	P
beneficio	beneficio	O
beneficios	beneficio	P
beneficioso	beneficioso	O
beneficiosas	beneficioso	FP
beneficiosa	beneficioso	F
beneficiosos	beneficioso	P
benemerencia	benemerencia	O
benemerencias	benemerencia	P
benemérito	benemérito	O
beneméritas	benemérito	FP
benemérita	benemérito	F
beneméritos	benemérito	P
beneplácito	beneplácito	O
beneplácitos	beneplácito	P
benevolencia	benevolencia	O
benevolencias	benevolencia	P
benevolente	benevolente	O
benevolentes	benevolente	P
bengala	bengala	O
bengalas	bengala	P
bengalí	bengalí	O
bengalíes	bengalí	P
beniano	beniano	O
benianas	beniano	FP
beniana	beniano	F
benianos	beniano	P
benignamente	benignamente	O
benignidad	benignidad	O
benignidades	benignidad	P
benigno	benigno	O
benignas	benigno	FP
benigna	benigno	F
benignos	benigno	P
benimerín	benimerín	O
benimerines	benimerín	P
benino	benino	O
beninas	benino	FP
benina	benino	F
beninos	benino	P
benito	benito	O
benitas	benito	FP
benita	benito	F
benitos	benito	P
benjamita	benjamita	O
benjamitas	benjamita	P
benjamín	benjamín	O
benjaminas	benjamín	FP
benjamina	benjamín	F
benjamines	benjamín	P
benjuí	benjuí	O
benjuíes	benjuí	P
benteveo	benteveo	O
benteveos	benteveo	P
bentonita	bentonita	O
bentonitas	bentonita	P
bentos	bentos	O
bentónico	bentónico	O
bentónicas	bentónico	FP
bentónica	bentónico	F
bentónicos	bentónico	P
benzina	benzina	O
benzinas	benzina	P
benzoato	benzoato	O
benzoatos	benzoato	P
benzoe	benzoe	O
benzoes	benzoe	P
benzoico	benzoico	O
benzoicas	benzoico	FP
benzoica	benzoico	F
benzoicos	benzoico	P
benzol	benzol	O
benzoles	benzol	P
benzolismo	benzolismo	O
benzolismos	benzolismo	P
benéfico	benéfico	O
benéficas	benéfico	FP
benéfica	benéfico	F
benéficos	benéfico	P
benévolamente	benévolamente	O
benévolo	benévolo	O
benévolas	benévolo	FP
benévola	benévolo	F
benévolos	benévolo	P
bendecir	bendecir	O
bendieces	bendecir	VIP2
bendiece	bendecir	VIP3
bendecimos	bendecir	VIP4
bendecís	bendecir	VIP5
bendiecen	bendecir	VIP6
bendecía	bendecir	VII1
bendecías	bendecir	VII2
bendecíamos	bendecir	VII4
bendecíais	bendecir	VII5
bendecían	bendecir	VII6
bendeciré	bendecir	VIF1
bendecirás	bendecir	VIF2
bendecirá	bendecir	VIF3
bendeciremos	bendecir	VIF4
bendeciréis	bendecir	VIF5
bendecirán	bendecir	VIF6
bendeciría	bendecir	VIC1
bendecirías	bendecir	VIC2
bendeciría	bendecir	VIC3
bendeciríamos	bendecir	VIC4
bendeciríais	bendecir	VIC5
bendecirían	bendecir	VIC6
bendecid	bendecir	VMP
bendecidme	bendecir	VMSE
bendecidle	bendecir	VMSE
bendecidnos	bendecir	VMPE
bendecios	bendecir	VMPE
bendecidles	bendecir	VMPE
bendecidlo	bendecir	VMMSE
bendecidla	bendecir	VMFSE
bendecidlos	bendecir	VMMPE
bendecidlas	bendecir	VMFPE
bendecídmelo	bendecir	VMMSE
bendecídselo	bendecir	VMMSE
bendecídnoslo	bendecir	VMMSE
bendecíoslo	bendecir	VMMSE
bendecídmelos	bendecir	VMMPE
bendecídselos	bendecir	VMMPE
bendecídnoslos	bendecir	VMMPE
bendecíoslos	bendecir	VMMPE
bendecídmela	bendecir	VMFSE
bendecídsela	bendecir	VMFSE
bendecídnosla	bendecir	VMFSE
bendecíosla	bendecir	VMFSE
bendecídmelas	bendecir	VMFPE
bendecídselas	bendecir	VMFPE
bendecídnoslas	bendecir	VMFPE
bendecíoslas	bendecir	VMFPE
bendecido	bendecir	VPM
bendecidos	bendecir	VPMP
bendecida	bendecir	VPF
bendecidas	bendecir	VPFP
bendeciendo	bendecir	VG
bendeciéndome	bendecir	VGSE
bendeciéndote	bendecir	VGSE
bendeciéndole	bendecir	VGSE
bendeciéndonos	bendecir	VGPE
bendeciéndoos	bendecir	VGPE
bendeciéndolo	bendecir	VGMSE
bendeciéndola	bendecir	VGFSE
bendeciéndolos	bendecir	VGMPE
bendeciéndolas	bendecir	VGFPE
bendeciéndomelo	bendecir	VGMSE
bendeciéndotelo	bendecir	VGMSE
bendeciéndoselo	bendecir	VGMSE
bendeciéndonoslo	bendecir	VGMSE
bendeciéndooslo	bendecir	VGMSE
bendeciéndomelos	bendecir	VGMPE
bendeciéndotelos	bendecir	VGMPE
bendeciéndoselos	bendecir	VGMPE
bendeciéndonoslos	bendecir	VGMPE
bendeciéndooslos	bendecir	VGMPE
bendeciéndomela	bendecir	VGFSE
bendeciéndotela	bendecir	VGFSE
bendeciéndosela	bendecir	VGFSE
bendeciéndonosla	bendecir	VGFSE
bendeciéndoosla	bendecir	VGFSE
bendeciéndomelas	bendecir	VGFPE
bendeciéndotelas	bendecir	VGFPE
bendeciéndoselas	bendecir	VGFPE
bendeciéndonoslas	bendecir	VGFPE
bendeciéndooslas	bendecir	VGFPE
beneficiar	beneficiar	O
beneficio	beneficiar	VIP1
beneficias	beneficiar	VIP2
beneficia	beneficiar	VIP3
beneficiamos	beneficiar	VIP4
beneficiáis	beneficiar	VIP5
benefician	beneficiar	VIP6
beneficiaba	beneficiar	VII1
beneficiabas	beneficiar	VII2
beneficiábamos	beneficiar	VII4
beneficiabais	beneficiar	VII5
beneficiaban	beneficiar	VII6
beneficiaré	beneficiar	VIF1
beneficiarás	beneficiar	VIF2
beneficiará	beneficiar	VIF3
beneficiaremos	beneficiar	VIF4
beneficiaréis	beneficiar	VIF5
beneficiarán	beneficiar	VIF6
beneficiaría	beneficiar	VIC1
beneficiarías	beneficiar	VIC2
beneficiaría	beneficiar	VIC3
beneficiaríamos	beneficiar	VIC4
beneficiaríais	beneficiar	VIC5
beneficiarían	beneficiar	VIC6
beneficié	beneficiar	VIX1
beneficiaste	beneficiar	VIX2
benefició	beneficiar	VIX3
beneficiasteis	beneficiar	VIX5
beneficiaron	beneficiar	VIX6
beneficie	beneficiar	VSP1
beneficies	beneficiar	VSP2
beneficiemos	beneficiar	VSP4
beneficiéis	beneficiar	VSP5
beneficien	beneficiar	VSP6
beneficiara	beneficiar	VSX1
beneficiaras	beneficiar	VSX2
beneficiáramos	beneficiar	VSX4
beneficiarais	beneficiar	VSX5
beneficiaran	beneficiar	VSX6
beneficiare	beneficiar	VSF1
beneficiares	beneficiar	VSF2
beneficiáremos	beneficiar	VSF4
beneficiareis	beneficiar	VSF5
beneficiaren	beneficiar	VSF6
beneficiase	beneficiar	VSI1
beneficiases	beneficiar	VSI2
beneficiásemos	beneficiar	VSI4
beneficiaseis	beneficiar	VSI5
beneficiasen	beneficiar	VSI6
beneficiad	beneficiar	VMP
beneficiadme	beneficiar	VMSE
beneficiadle	beneficiar	VMSE
beneficiadnos	beneficiar	VMPE
beneficiaos	beneficiar	VMPE
beneficiadles	beneficiar	VMPE
beneficiadlo	beneficiar	VMMSE
beneficiadla	beneficiar	VMFSE
beneficiadlos	beneficiar	VMMPE
beneficiadlas	beneficiar	VMFPE
beneficiádmelo	beneficiar	VMMSE
beneficiádselo	beneficiar	VMMSE
beneficiádnoslo	beneficiar	VMMSE
beneficiáoslo	beneficiar	VMMSE
beneficiádmelos	beneficiar	VMMPE
beneficiádselos	beneficiar	VMMPE
beneficiádnoslos	beneficiar	VMMPE
beneficiáoslos	beneficiar	VMMPE
beneficiádmela	beneficiar	VMFSE
beneficiádsela	beneficiar	VMFSE
beneficiádnosla	beneficiar	VMFSE
beneficiáosla	beneficiar	VMFSE
beneficiádmelas	beneficiar	VMFPE
beneficiádselas	beneficiar	VMFPE
beneficiádnoslas	beneficiar	VMFPE
beneficiáoslas	beneficiar	VMFPE
beneficiado	beneficiar	VPM
beneficiados	beneficiar	VPMP
beneficiada	beneficiar	VPF
beneficiadas	beneficiar	VPFP
beneficiando	beneficiar	VG
beneficiándome	beneficiar	VGSE
beneficiándote	beneficiar	VGSE
beneficiándole	beneficiar	VGSE
beneficiándonos	beneficiar	VGPE
beneficiándoos	beneficiar	VGPE
beneficiándolo	beneficiar	VGMSE
beneficiándola	beneficiar	VGFSE
beneficiándolos	beneficiar	VGMPE
beneficiándolas	beneficiar	VGFPE
beneficiándomelo	beneficiar	VGMSE
beneficiándotelo	beneficiar	VGMSE
beneficiándoselo	beneficiar	VGMSE
beneficiándonoslo	beneficiar	VGMSE
beneficiándooslo	beneficiar	VGMSE
beneficiándomelos	beneficiar	VGMPE
beneficiándotelos	beneficiar	VGMPE
beneficiándoselos	beneficiar	VGMPE
beneficiándonoslos	beneficiar	VGMPE
beneficiándooslos	beneficiar	VGMPE
beneficiándomela	beneficiar	VGFSE
beneficiándotela	beneficiar	VGFSE
beneficiándosela	beneficiar	VGFSE
beneficiándonosla	beneficiar	VGFSE
beneficiándoosla	beneficiar	VGFSE
beneficiándomelas	beneficiar	VGFPE
beneficiándotelas	beneficiar	VGFPE
beneficiándoselas	beneficiar	VGFPE
beneficiándonoslas	beneficiar	VGFPE
beneficiándooslas	beneficiar	VGFPE
