bejarano	bejarano	O
bejaranas	bejarano	FP
bejarana	bejarano	F
bejaranos	bejarano	P
bejerano	bejerano	O
bejeranas	bejerano	FP
bejerana	bejerano	F
bejeranos	bejerano	P
bejucal	bejucal	O
bejucales	bejucal	P
bejuco	bejuco	O
bejucos	bejuco	P
bejuqueda	bejuqueda	O
bejuquedas	bejuqueda	P
bejuquillo	bejuquillo	O
bejuquillos	bejuquillo	P
bejín	bejín	O
bejines	bejín	P
bejuquear	bejuquear	O
bejuqueo	bejuquear	VIP1
bejuqueas	bejuquear	VIP2
bejuquea	bejuquear	VIP3
bejuqueamos	bejuquear	VIP4
bejuqueáis	bejuquear	VIP5
bejuquean	bejuquear	VIP6
bejuqueaba	bejuquear	VII1
bejuqueabas	bejuquear	VII2
bejuqueábamos	bejuquear	VII4
bejuqueabais	bejuquear	VII5
bejuqueaban	bejuquear	VII6
bejuquearé	bejuquear	VIF1
bejuquearás	bejuquear	VIF2
bejuqueará	bejuquear	VIF3
bejuquearemos	bejuquear	VIF4
bejuquearéis	bejuquear	VIF5
bejuquearán	bejuquear	VIF6
bejuquearía	bejuquear	VIC1
bejuquearías	bejuquear	VIC2
bejuquearía	bejuquear	VIC3
bejuquearíamos	bejuquear	VIC4
bejuquearíais	bejuquear	VIC5
bejuquearían	bejuquear	VIC6
bejuqueé	bejuquear	VIX1
bejuqueaste	bejuquear	VIX2
bejuqueó	bejuquear	VIX3
bejuqueasteis	bejuquear	VIX5
bejuquearon	bejuquear	VIX6
bejuquee	bejuquear	VSP1
bejuquees	bejuquear	VSP2
bejuqueemos	bejuquear	VSP4
bejuqueéis	bejuquear	VSP5
bejuqueen	bejuquear	VSP6
bejuqueara	bejuquear	VSX1
bejuquearas	bejuquear	VSX2
bejuqueáramos	bejuquear	VSX4
bejuquearais	bejuquear	VSX5
bejuquearan	bejuquear	VSX6
bejuqueare	bejuquear	VSF1
bejuqueares	bejuquear	VSF2
bejuqueáremos	bejuquear	VSF4
bejuqueareis	bejuquear	VSF5
bejuquearen	bejuquear	VSF6
bejuquease	bejuquear	VSI1
bejuqueases	bejuquear	VSI2
bejuqueásemos	bejuquear	VSI4
bejuqueaseis	bejuquear	VSI5
bejuqueasen	bejuquear	VSI6
bejuquead	bejuquear	VMP
bejuqueadme	bejuquear	VMSE
bejuqueadle	bejuquear	VMSE
bejuqueadnos	bejuquear	VMPE
bejuqueaos	bejuquear	VMPE
bejuqueadles	bejuquear	VMPE
bejuqueadlo	bejuquear	VMMSE
bejuqueadla	bejuquear	VMFSE
bejuqueadlos	bejuquear	VMMPE
bejuqueadlas	bejuquear	VMFPE
bejuqueádmelo	bejuquear	VMMSE
bejuqueádselo	bejuquear	VMMSE
bejuqueádnoslo	bejuquear	VMMSE
bejuqueáoslo	bejuquear	VMMSE
bejuqueádmelos	bejuquear	VMMPE
bejuqueádselos	bejuquear	VMMPE
bejuqueádnoslos	bejuquear	VMMPE
bejuqueáoslos	bejuquear	VMMPE
bejuqueádmela	bejuquear	VMFSE
bejuqueádsela	bejuquear	VMFSE
bejuqueádnosla	bejuquear	VMFSE
bejuqueáosla	bejuquear	VMFSE
bejuqueádmelas	bejuquear	VMFPE
bejuqueádselas	bejuquear	VMFPE
bejuqueádnoslas	bejuquear	VMFPE
bejuqueáoslas	bejuquear	VMFPE
bejuqueado	bejuquear	VPM
bejuqueados	bejuquear	VPMP
bejuqueada	bejuquear	VPF
bejuqueadas	bejuquear	VPFP
bejuqueando	bejuquear	VG
bejuqueándome	bejuquear	VGSE
bejuqueándote	bejuquear	VGSE
bejuqueándole	bejuquear	VGSE
bejuqueándonos	bejuquear	VGPE
bejuqueándoos	bejuquear	VGPE
bejuqueándolo	bejuquear	VGMSE
bejuqueándola	bejuquear	VGFSE
bejuqueándolos	bejuquear	VGMPE
bejuqueándolas	bejuquear	VGFPE
bejuqueándomelo	bejuquear	VGMSE
bejuqueándotelo	bejuquear	VGMSE
bejuqueándoselo	bejuquear	VGMSE
bejuqueándonoslo	bejuquear	VGMSE
bejuqueándooslo	bejuquear	VGMSE
bejuqueándomelos	bejuquear	VGMPE
bejuqueándotelos	bejuquear	VGMPE
bejuqueándoselos	bejuquear	VGMPE
bejuqueándonoslos	bejuquear	VGMPE
bejuqueándooslos	bejuquear	VGMPE
bejuqueándomela	bejuquear	VGFSE
bejuqueándotela	bejuquear	VGFSE
bejuqueándosela	bejuquear	VGFSE
bejuqueándonosla	bejuquear	VGFSE
bejuqueándoosla	bejuquear	VGFSE
bejuqueándomelas	bejuquear	VGFPE
bejuqueándotelas	bejuquear	VGFPE
bejuqueándoselas	bejuquear	VGFPE
bejuqueándonoslas	bejuquear	VGFPE
bejuqueándooslas	bejuquear	VGFPE
