cap	cap	O
capes	cap	P
capa	capa	O
capas	capa	P
capaceta	capaceta	O
capacetas	capaceta	P
capacete	capacete	O
capacetes	capacete	P
capacha	capacha	O
capachas	capacha	P
capachada	capachada	O
capachadas	capachada	P
capachero	capachero	O
capacheras	capachero	FP
capachera	capachero	F
capacheros	capachero	P
capacho	capacho	O
capachos	capacho	P
capacidad	capacidad	O
capacidades	capacidad	P
capacitación	capacitación	O
capacitaciones	capacitación	P
capadillo	capadillo	O
capadillos	capadillo	P
capadocio	capadocio	O
capadocias	capadocio	FP
capadocia	capadocio	F
capadocios	capadocio	P
capador	capador	O
capadores	capador	P
capadura	capadura	O
capaduras	capadura	P
capanga	capanga	O
capangas	capanga	P
capararoch	capararoch	O
capararoches	capararoch	P
caparazón	caparazón	O
caparazones	caparazón	P
caparidáceo	caparidáceo	O
caparidáceas	caparidáceo	FP
caparidácea	caparidáceo	F
caparidáceos	caparidáceo	P
caparra	caparra	O
caparras	caparra	P
caparro	caparro	O
caparros	caparro	P
caparrosa	caparrosa	O
caparrosas	caparrosa	P
caparrón	caparrón	O
caparrones	caparrón	P
caparídeo	caparídeo	O
caparídeas	caparídeo	FP
caparídea	caparídeo	F
caparídeos	caparídeo	P
capataz	capataz	O
capatazas	capataz	FP
capataza	capataz	F
capataces	capataz	P
capaz	capaz	O
capaces	capaz	P
capaza	capaza	O
capazas	capaza	P
capazmente	capazmente	O
capazo	capazo	O
capazos	capazo	P
capazón	capazón	O
capazones	capazón	P
capciosidad	capciosidad	O
capciosidades	capciosidad	P
capcioso	capcioso	O
capciosas	capcioso	FP
capciosa	capcioso	F
capciosos	capcioso	P
capción	capción	O
capciones	capción	P
capdal	capdal	O
capdales	capdal	P
capea	capea	O
capeas	capea	P
capeada	capeada	O
capeadas	capeada	P
capeadera	capeadera	O
capeaderas	capeadera	P
capeador	capeador	O
capeadoras	capeador	FP
capeadora	capeador	F
capeadores	capeador	P
capeja	capeja	O
capejas	capeja	P
capel	capel	O
capeles	capel	P
capelardente	capelardente	O
capelardentes	capelardente	P
capelete	capelete	O
capeletes	capelete	P
capelina	capelina	O
capelinas	capelina	P
capellada	capellada	O
capelladas	capellada	P
capellanía	capellanía	O
capellanías	capellanía	P
capellar	capellar	O
capellares	capellar	P
capellina	capellina	O
capellinas	capellina	P
capellán	capellán	O
capellanes	capellán	P
capelo	capelo	O
capelos	capelo	P
capelán	capelán	O
capelanes	capelán	P
capeo	capeo	O
capeos	capeo	P
capero	capero	O
caperos	capero	P
caperol	caperol	O
caperoles	caperol	P
caperuza	caperuza	O
caperuzas	caperuza	P
caperuzado	caperuzado	O
caperuzadas	caperuzado	FP
caperuzada	caperuzado	F
caperuzados	caperuzado	P
caperuzón	caperuzón	O
caperuzones	caperuzón	P
capeta	capeta	O
capetas	capeta	P
capetonada	capetonada	O
capetonadas	capetonada	P
capeón	capeón	O
capeones	capeón	P
capi	capi	O
capis	capi	P
capia	capia	O
capias	capia	P
capialzado	capialzado	O
capialzados	capialzado	P
capialzo	capialzo	O
capialzos	capialzo	P
capibara	capibara	O
capibaras	capibara	P
capicati	capicati	O
capicatis	capicati	P
capicatí	capicatí	O
capicatíes	capicatí	P
capichola	capichola	O
capicholas	capichola	P
capicholado	capicholado	O
capicholadas	capicholado	FP
capicholada	capicholado	F
capicholados	capicholado	P
capicúa	capicúa	O
capicúas	capicúa	P
capidengue	capidengue	O
capidengues	capidengue	P
capigorra	capigorra	O
capigorras	capigorra	P
capigorrista	capigorrista	O
capigorristas	capigorrista	P
capigorrón	capigorrón	O
capigorrones	capigorrón	P
capiguara	capiguara	O
capiguaras	capiguara	P
capilar	capilar	O
capilares	capilar	P
capilaridad	capilaridad	O
capilaridades	capilaridad	P
capilarímetro	capilarímetro	O
capilarímetros	capilarímetro	P
capilla	capilla	O
capillas	capilla	P
capillada	capillada	O
capilladas	capillada	P
capilleja	capilleja	O
capillejas	capilleja	P
capillejo	capillejo	O
capillejos	capillejo	P
capiller	capiller	O
capilleres	capiller	P
capillero	capillero	O
capilleros	capillero	P
capilleta	capilleta	O
capilletas	capilleta	P
capillo	capillo	O
capillos	capillo	P
capilludo	capilludo	O
capilludas	capilludo	FP
capilluda	capilludo	F
capilludos	capilludo	P
capincho	capincho	O
capinchos	capincho	P
capingo	capingo	O
capingos	capingo	P
capio	capio	O
capios	capio	P
capipardo	capipardo	O
capipardos	capipardo	P
capirotado	capirotado	O
capirotadas	capirotado	FP
capirotada	capirotado	F
capirotados	capirotado	P
capirotazo	capirotazo	O
capirotazos	capirotazo	P
capirote	capirote	O
capirotes	capirote	P
capirotero	capirotero	O
capiroteros	capirotero	P
capirucho	capirucho	O
capiruchos	capirucho	P
capirón	capirón	O
capirones	capirón	P
capisayo	capisayo	O
capisayos	capisayo	P
capiscol	capiscol	O
capiscoles	capiscol	P
capiscolía	capiscolía	O
capiscolías	capiscolía	P
capistro	capistro	O
capistros	capistro	P
capitación	capitación	O
capitaciones	capitación	P
capital	capital	O
capitales	capital	P
capitaleño	capitaleño	O
capitaleñas	capitaleño	FP
capitaleña	capitaleño	F
capitaleños	capitaleño	P
capitalidad	capitalidad	O
capitalidades	capitalidad	P
capitalino	capitalino	O
capitalinas	capitalino	FP
capitalina	capitalino	F
capitalinos	capitalino	P
capitalismo	capitalismo	O
capitalismos	capitalismo	P
capitalista	capitalista	O
capitalistas	capitalista	P
capitalizable	capitalizable	O
capitalizables	capitalizable	P
capitalización	capitalización	O
capitalizaciones	capitalización	P
capitalmente	capitalmente	O
capitana	capitana	O
capitanas	capitana	P
capitaneja	capitaneja	O
capitanejas	capitaneja	P
capitanejo	capitanejo	O
capitanejos	capitanejo	P
capitanía	capitanía	O
capitanías	capitanía	P
capitel	capitel	O
capiteles	capitel	P
capitidisminución	capitidisminución	O
capitidisminuciones	capitidisminución	P
capitidisminuido	capitidisminuido	O
capitidisminuidas	capitidisminuido	FP
capitidisminuida	capitidisminuido	F
capitidisminuidos	capitidisminuido	P
capitolino	capitolino	O
capitolinas	capitolino	FP
capitolina	capitolino	F
capitolinos	capitolino	P
capitolio	capitolio	O
capitolios	capitolio	P
capitoné	capitoné	O
capitonés	capitoné	P
capitoso	capitoso	O
capitosas	capitoso	FP
capitosa	capitoso	F
capitosos	capitoso	P
capitoste	capitoste	O
capitostes	capitoste	P
capitulación	capitulación	O
capitulaciones	capitulación	P
capitulado	capitulado	O
capituladas	capitulado	FP
capitulada	capitulado	F
capitulados	capitulado	P
capitulante	capitulante	O
capitulantes	capitulante	P
capitulario	capitulario	O
capitularios	capitulario	P
capitularmente	capitularmente	O
capitá	capitá	O
capitás	capitá	P
capitán	capitán	O
capitanes	capitán	P
capitón	capitón	O
capitones	capitón	P
capizana	capizana	O
capizanas	capizana	P
capnomancia	capnomancia	O
capnomancias	capnomancia	P
capnomancía	capnomancía	O
capnomancías	capnomancía	P
capo	capo	O
capos	capo	P
capolado	capolado	O
capolados	capolado	P
capona	capona	O
caponas	capona	P
caponada	caponada	O
caponadas	caponada	P
caponera	caponera	O
caponeras	caponera	P
caporal	caporal	O
caporales	caporal	P
caporalista	caporalista	O
caporalistas	caporalista	P
capororoca	capororoca	O
capororocas	capororoca	P
caporos	caporos	O
capota	capota	O
capotas	capota	P
capotazo	capotazo	O
capotazos	capotazo	P
capote	capote	O
capotes	capote	P
capoteo	capoteo	O
capoteos	capoteo	P
capotero	capotero	O
capoteras	capotero	FP
capotera	capotero	F
capoteros	capotero	P
capotillo	capotillo	O
capotillos	capotillo	P
capotudo	capotudo	O
capotudas	capotudo	FP
capotuda	capotudo	F
capotudos	capotudo	P
cappa	cappa	O
cappas	cappa	P
caprario	caprario	O
caprarias	caprario	FP
capraria	caprario	F
caprarios	caprario	P
capricho	capricho	O
caprichos	capricho	P
caprichoso	caprichoso	O
caprichosas	caprichoso	FP
caprichosa	caprichoso	F
caprichosos	caprichoso	P
caprichudo	caprichudo	O
caprichudas	caprichudo	FP
caprichuda	caprichudo	F
caprichudos	caprichudo	P
capricornio	capricornio	O
capricornios	capricornio	P
caprifoliáceo	caprifoliáceo	O
caprifoliáceas	caprifoliáceo	FP
caprifoliácea	caprifoliáceo	F
caprifoliáceos	caprifoliáceo	P
caprino	caprino	O
caprinas	caprino	FP
caprina	caprino	F
caprinos	caprino	P
caprípede	caprípede	O
caprípedes	caprípede	P
caprípedo	caprípedo	O
caprípedas	caprípedo	FP
caprípeda	caprípedo	F
caprípedos	caprípedo	P
captación	captación	O
captaciones	captación	P
captador	captador	O
captadoras	captador	FP
captadora	captador	F
captadores	captador	P
captatorio	captatorio	O
captatorias	captatorio	FP
captatoria	captatorio	F
captatorios	captatorio	P
captenencia	captenencia	O
captenencias	captenencia	P
captiverio	captiverio	O
captiverios	captiverio	P
captividad	captividad	O
captividades	captividad	P
captivo	captivo	O
captivas	captivo	FP
captiva	captivo	F
captivos	captivo	P
captor	captor	O
captoras	captor	FP
captora	captor	F
captores	captor	P
captura	captura	O
capturas	captura	P
capuceta	capuceta	O
capucetas	capuceta	P
capucete	capucete	O
capucetes	capucete	P
capucha	capucha	O
capuchas	capucha	P
capuchina	capuchina	O
capuchinas	capuchina	P
capuchino	capuchino	O
capuchinas	capuchino	FP
capuchina	capuchino	F
capuchinos	capuchino	P
capucho	capucho	O
capuchos	capucho	P
capuchón	capuchón	O
capuchones	capuchón	P
capuera	capuera	O
capueras	capuera	P
capuleto	capuleto	O
capuletos	capuleto	P
capulina	capulina	O
capulinas	capulina	P
capullina	capullina	O
capullinas	capullina	P
capullo	capullo	O
capullos	capullo	P
capulí	capulí	O
capulíes	capulí	P
capulín	capulín	O
capulines	capulín	P
capuz	capuz	O
capuces	capuz	P
capuzón	capuzón	O
capuzones	capuzón	P
capá	capá	O
capás	capá	P
capí	capí	O
capíes	capí	P
capín	capín	O
capines	capín	P
capítol	capítol	O
capítoles	capítol	P
capítula	capítula	O
capítulas	capítula	P
capítulo	capítulo	O
capítulos	capítulo	P
capó	capó	O
capós	capó	P
capón	capón	O
capones	capón	P
capúlido	capúlido	O
capúlidos	capúlido	P
cápita	cápita	O
cápitas	cápita	P
cápsula	cápsula	O
cápsulas	cápsula	P
cápulo	cápulo	O
cápulos	cápulo	P
capitidisminuir	capitidisminuir	O
capitidisminuyo	capitidisminuir	VIP1
capitidisminuyes	capitidisminuir	VIP2
capitidisminuye	capitidisminuir	VIP3
capitidisminuimos	capitidisminuir	VIP4
capitidisminuís	capitidisminuir	VIP5
capitidisminuyen	capitidisminuir	VIP6
capitidisminuía	capitidisminuir	VII1
capitidisminuías	capitidisminuir	VII2
capitidisminuíamos	capitidisminuir	VII4
capitidisminuíais	capitidisminuir	VII5
capitidisminuían	capitidisminuir	VII6
capitidisminuiré	capitidisminuir	VIF1
capitidisminuirás	capitidisminuir	VIF2
capitidisminuirá	capitidisminuir	VIF3
capitidisminuiremos	capitidisminuir	VIF4
capitidisminuiréis	capitidisminuir	VIF5
capitidisminuirán	capitidisminuir	VIF6
capitidisminuiría	capitidisminuir	VIC1
capitidisminuirías	capitidisminuir	VIC2
capitidisminuiría	capitidisminuir	VIC3
capitidisminuiríamos	capitidisminuir	VIC4
capitidisminuiríais	capitidisminuir	VIC5
capitidisminuirían	capitidisminuir	VIC6
capitidisminuí	capitidisminuir	VIX1
capitidisminuiste	capitidisminuir	VIX2
capitidisminuyó	capitidisminuir	VIX3
capitidisminuisteis	capitidisminuir	VIX5
capitidisminuyeron	capitidisminuir	VIX6
capitidisminuya	capitidisminuir	VSP1
capitidisminuyas	capitidisminuir	VSP2
capitidisminuyamos	capitidisminuir	VSP4
capitidisminuyáis	capitidisminuir	VSP5
capitidisminuyan	capitidisminuir	VSP6
capitidisminuyera	capitidisminuir	VSX1
capitidisminuyeras	capitidisminuir	VSX2
capitidisminuyéramos	capitidisminuir	VSX4
capitidisminuyerais	capitidisminuir	VSX5
capitidisminuyeran	capitidisminuir	VSX6
capitidisminuyere	capitidisminuir	VSF1
capitidisminuyeres	capitidisminuir	VSF2
capitidisminuyéremos	capitidisminuir	VSF4
capitidisminuyereis	capitidisminuir	VSF5
capitidisminuyeren	capitidisminuir	VSF6
capitidisminuyese	capitidisminuir	VSI1
capitidisminuyeses	capitidisminuir	VSI2
capitidisminuyésemos	capitidisminuir	VSI4
capitidisminuyeseis	capitidisminuir	VSI5
capitidisminuyesen	capitidisminuir	VSI6
capitidisminuid	capitidisminuir	VMP
capitidisminuidme	capitidisminuir	VMSE
capitidisminuidle	capitidisminuir	VMSE
capitidisminuidnos	capitidisminuir	VMPE
capitidisminuios	capitidisminuir	VMPE
capitidisminuidles	capitidisminuir	VMPE
capitidisminuidlo	capitidisminuir	VMMSE
capitidisminuidla	capitidisminuir	VMFSE
capitidisminuidlos	capitidisminuir	VMMPE
capitidisminuidlas	capitidisminuir	VMFPE
capitidisminuídmelo	capitidisminuir	VMMSE
capitidisminuídselo	capitidisminuir	VMMSE
capitidisminuídnoslo	capitidisminuir	VMMSE
capitidisminuíoslo	capitidisminuir	VMMSE
capitidisminuídmelos	capitidisminuir	VMMPE
capitidisminuídselos	capitidisminuir	VMMPE
capitidisminuídnoslos	capitidisminuir	VMMPE
capitidisminuíoslos	capitidisminuir	VMMPE
capitidisminuídmela	capitidisminuir	VMFSE
capitidisminuídsela	capitidisminuir	VMFSE
capitidisminuídnosla	capitidisminuir	VMFSE
capitidisminuíosla	capitidisminuir	VMFSE
capitidisminuídmelas	capitidisminuir	VMFPE
capitidisminuídselas	capitidisminuir	VMFPE
capitidisminuídnoslas	capitidisminuir	VMFPE
capitidisminuíoslas	capitidisminuir	VMFPE
capitidisminuido	capitidisminuir	VPM
capitidisminuidos	capitidisminuir	VPMP
capitidisminuida	capitidisminuir	VPF
capitidisminuidas	capitidisminuir	VPFP
capitidisminuyiendo	capitidisminuir	VG
capitidisminuyiéndome	capitidisminuir	VGSE
capitidisminuyiéndote	capitidisminuir	VGSE
capitidisminuyiéndole	capitidisminuir	VGSE
capitidisminuyiéndonos	capitidisminuir	VGPE
capitidisminuyiéndoos	capitidisminuir	VGPE
capitidisminuyiéndolo	capitidisminuir	VGMSE
capitidisminuyiéndola	capitidisminuir	VGFSE
capitidisminuyiéndolos	capitidisminuir	VGMPE
capitidisminuyiéndolas	capitidisminuir	VGFPE
capitidisminuyiéndomelo	capitidisminuir	VGMSE
capitidisminuyiéndotelo	capitidisminuir	VGMSE
capitidisminuyiéndoselo	capitidisminuir	VGMSE
capitidisminuyiéndonoslo	capitidisminuir	VGMSE
capitidisminuyiéndooslo	capitidisminuir	VGMSE
capitidisminuyiéndomelos	capitidisminuir	VGMPE
capitidisminuyiéndotelos	capitidisminuir	VGMPE
capitidisminuyiéndoselos	capitidisminuir	VGMPE
capitidisminuyiéndonoslos	capitidisminuir	VGMPE
capitidisminuyiéndooslos	capitidisminuir	VGMPE
capitidisminuyiéndomela	capitidisminuir	VGFSE
capitidisminuyiéndotela	capitidisminuir	VGFSE
capitidisminuyiéndosela	capitidisminuir	VGFSE
capitidisminuyiéndonosla	capitidisminuir	VGFSE
capitidisminuyiéndoosla	capitidisminuir	VGFSE
capitidisminuyiéndomelas	capitidisminuir	VGFPE
capitidisminuyiéndotelas	capitidisminuir	VGFPE
capitidisminuyiéndoselas	capitidisminuir	VGFPE
capitidisminuyiéndonoslas	capitidisminuir	VGFPE
capitidisminuyiéndooslas	capitidisminuir	VGFPE
captener	captener	O
capteno	captener	VIP1
captenes	captener	VIP2
captene	captener	VIP3
captenemos	captener	VIP4
captenéis	captener	VIP5
captenen	captener	VIP6
captenía	captener	VII1
captenías	captener	VII2
capteníamos	captener	VII4
capteníais	captener	VII5
captenían	captener	VII6
capteneré	captener	VIF1
captenerás	captener	VIF2
captenerá	captener	VIF3
capteneremos	captener	VIF4
capteneréis	captener	VIF5
captenerán	captener	VIF6
captenería	captener	VIC1
captenerías	captener	VIC2
captenería	captener	VIC3
capteneríamos	captener	VIC4
capteneríais	captener	VIC5
captenerían	captener	VIC6
captení	captener	VIX1
capteniste	captener	VIX2
captenió	captener	VIX3
captenisteis	captener	VIX5
captenieron	captener	VIX6
captena	captener	VSP1
captenas	captener	VSP2
captenamos	captener	VSP4
captenáis	captener	VSP5
captenan	captener	VSP6
capteniera	captener	VSX1
captenieras	captener	VSX2
capteniéramos	captener	VSX4
captenierais	captener	VSX5
captenieran	captener	VSX6
capteniere	captener	VSF1
captenieres	captener	VSF2
capteniéremos	captener	VSF4
capteniereis	captener	VSF5
captenieren	captener	VSF6
capteniese	captener	VSI1
captenieses	captener	VSI2
capteniésemos	captener	VSI4
captenieseis	captener	VSI5
capteniesen	captener	VSI6
captened	captener	VMP
captenedme	captener	VMSE
captenedle	captener	VMSE
captenednos	captener	VMPE
capteneos	captener	VMPE
captenedles	captener	VMPE
captenedlo	captener	VMMSE
captenedla	captener	VMFSE
captenedlos	captener	VMMPE
captenedlas	captener	VMFPE
captenédmelo	captener	VMMSE
captenédselo	captener	VMMSE
captenédnoslo	captener	VMMSE
captenéoslo	captener	VMMSE
captenédmelos	captener	VMMPE
captenédselos	captener	VMMPE
captenédnoslos	captener	VMMPE
captenéoslos	captener	VMMPE
captenédmela	captener	VMFSE
captenédsela	captener	VMFSE
captenédnosla	captener	VMFSE
captenéosla	captener	VMFSE
captenédmelas	captener	VMFPE
captenédselas	captener	VMFPE
captenédnoslas	captener	VMFPE
captenéoslas	captener	VMFPE
captenido	captener	VPM
captenidos	captener	VPMP
captenida	captener	VPF
captenidas	captener	VPFP
capteniendo	captener	VG
capteniéndome	captener	VGSE
capteniéndote	captener	VGSE
capteniéndole	captener	VGSE
capteniéndonos	captener	VGPE
capteniéndoos	captener	VGPE
capteniéndolo	captener	VGMSE
capteniéndola	captener	VGFSE
capteniéndolos	captener	VGMPE
capteniéndolas	captener	VGFPE
capteniéndomelo	captener	VGMSE
capteniéndotelo	captener	VGMSE
capteniéndoselo	captener	VGMSE
capteniéndonoslo	captener	VGMSE
capteniéndooslo	captener	VGMSE
capteniéndomelos	captener	VGMPE
capteniéndotelos	captener	VGMPE
capteniéndoselos	captener	VGMPE
capteniéndonoslos	captener	VGMPE
capteniéndooslos	captener	VGMPE
capteniéndomela	captener	VGFSE
capteniéndotela	captener	VGFSE
capteniéndosela	captener	VGFSE
capteniéndonosla	captener	VGFSE
capteniéndoosla	captener	VGFSE
capteniéndomelas	captener	VGFPE
capteniéndotelas	captener	VGFPE
capteniéndoselas	captener	VGFPE
capteniéndonoslas	captener	VGFPE
capteniéndooslas	captener	VGFPE
capacear	capacear	O
capaceo	capacear	VIP1
capaceas	capacear	VIP2
capacea	capacear	VIP3
capaceamos	capacear	VIP4
capaceáis	capacear	VIP5
capacean	capacear	VIP6
capaceaba	capacear	VII1
capaceabas	capacear	VII2
capaceábamos	capacear	VII4
capaceabais	capacear	VII5
capaceaban	capacear	VII6
capacearé	capacear	VIF1
capacearás	capacear	VIF2
capaceará	capacear	VIF3
capacearemos	capacear	VIF4
capacearéis	capacear	VIF5
capacearán	capacear	VIF6
capacearía	capacear	VIC1
capacearías	capacear	VIC2
capacearía	capacear	VIC3
capacearíamos	capacear	VIC4
capacearíais	capacear	VIC5
capacearían	capacear	VIC6
capaceé	capacear	VIX1
capaceaste	capacear	VIX2
capaceó	capacear	VIX3
capaceasteis	capacear	VIX5
capacearon	capacear	VIX6
capacee	capacear	VSP1
capacees	capacear	VSP2
capaceemos	capacear	VSP4
capaceéis	capacear	VSP5
capaceen	capacear	VSP6
capaceara	capacear	VSX1
capacearas	capacear	VSX2
capaceáramos	capacear	VSX4
capacearais	capacear	VSX5
capacearan	capacear	VSX6
capaceare	capacear	VSF1
capaceares	capacear	VSF2
capaceáremos	capacear	VSF4
capaceareis	capacear	VSF5
capacearen	capacear	VSF6
capacease	capacear	VSI1
capaceases	capacear	VSI2
capaceásemos	capacear	VSI4
capaceaseis	capacear	VSI5
capaceasen	capacear	VSI6
capacead	capacear	VMP
capaceadme	capacear	VMSE
capaceadle	capacear	VMSE
capaceadnos	capacear	VMPE
capaceaos	capacear	VMPE
capaceadles	capacear	VMPE
capaceado	capacear	VPM
capaceados	capacear	VPMP
capaceada	capacear	VPF
capaceadas	capacear	VPFP
capaceando	capacear	VG
capaceándome	capacear	VGSE
capaceándote	capacear	VGSE
capaceándole	capacear	VGSE
capaceándonos	capacear	VGPE
capaceándoos	capacear	VGPE
capacitar	capacitar	O
capacito	capacitar	VIP1
capacitas	capacitar	VIP2
capacita	capacitar	VIP3
capacitamos	capacitar	VIP4
capacitáis	capacitar	VIP5
capacitan	capacitar	VIP6
capacitaba	capacitar	VII1
capacitabas	capacitar	VII2
capacitábamos	capacitar	VII4
capacitabais	capacitar	VII5
capacitaban	capacitar	VII6
capacitaré	capacitar	VIF1
capacitarás	capacitar	VIF2
capacitará	capacitar	VIF3
capacitaremos	capacitar	VIF4
capacitaréis	capacitar	VIF5
capacitarán	capacitar	VIF6
capacitaría	capacitar	VIC1
capacitarías	capacitar	VIC2
capacitaría	capacitar	VIC3
capacitaríamos	capacitar	VIC4
capacitaríais	capacitar	VIC5
capacitarían	capacitar	VIC6
capacité	capacitar	VIX1
capacitaste	capacitar	VIX2
capacitó	capacitar	VIX3
capacitasteis	capacitar	VIX5
capacitaron	capacitar	VIX6
capacite	capacitar	VSP1
capacites	capacitar	VSP2
capacitemos	capacitar	VSP4
capacitéis	capacitar	VSP5
capaciten	capacitar	VSP6
capacitara	capacitar	VSX1
capacitaras	capacitar	VSX2
capacitáramos	capacitar	VSX4
capacitarais	capacitar	VSX5
capacitaran	capacitar	VSX6
capacitare	capacitar	VSF1
capacitares	capacitar	VSF2
capacitáremos	capacitar	VSF4
capacitareis	capacitar	VSF5
capacitaren	capacitar	VSF6
capacitase	capacitar	VSI1
capacitases	capacitar	VSI2
capacitásemos	capacitar	VSI4
capacitaseis	capacitar	VSI5
capacitasen	capacitar	VSI6
capacitad	capacitar	VMP
capacitadme	capacitar	VMSE
capacitadle	capacitar	VMSE
capacitadnos	capacitar	VMPE
capacitaos	capacitar	VMPE
capacitadles	capacitar	VMPE
capacitadlo	capacitar	VMMSE
capacitadla	capacitar	VMFSE
capacitadlos	capacitar	VMMPE
capacitadlas	capacitar	VMFPE
capacitádmelo	capacitar	VMMSE
capacitádselo	capacitar	VMMSE
capacitádnoslo	capacitar	VMMSE
capacitáoslo	capacitar	VMMSE
capacitádmelos	capacitar	VMMPE
capacitádselos	capacitar	VMMPE
capacitádnoslos	capacitar	VMMPE
capacitáoslos	capacitar	VMMPE
capacitádmela	capacitar	VMFSE
capacitádsela	capacitar	VMFSE
capacitádnosla	capacitar	VMFSE
capacitáosla	capacitar	VMFSE
capacitádmelas	capacitar	VMFPE
capacitádselas	capacitar	VMFPE
capacitádnoslas	capacitar	VMFPE
capacitáoslas	capacitar	VMFPE
capacitado	capacitar	VPM
capacitados	capacitar	VPMP
capacitada	capacitar	VPF
capacitadas	capacitar	VPFP
capacitando	capacitar	VG
capacitándome	capacitar	VGSE
capacitándote	capacitar	VGSE
capacitándole	capacitar	VGSE
capacitándonos	capacitar	VGPE
capacitándoos	capacitar	VGPE
capacitándolo	capacitar	VGMSE
capacitándola	capacitar	VGFSE
capacitándolos	capacitar	VGMPE
capacitándolas	capacitar	VGFPE
capacitándomelo	capacitar	VGMSE
capacitándotelo	capacitar	VGMSE
capacitándoselo	capacitar	VGMSE
capacitándonoslo	capacitar	VGMSE
capacitándooslo	capacitar	VGMSE
capacitándomelos	capacitar	VGMPE
capacitándotelos	capacitar	VGMPE
capacitándoselos	capacitar	VGMPE
capacitándonoslos	capacitar	VGMPE
capacitándooslos	capacitar	VGMPE
capacitándomela	capacitar	VGFSE
capacitándotela	capacitar	VGFSE
capacitándosela	capacitar	VGFSE
capacitándonosla	capacitar	VGFSE
capacitándoosla	capacitar	VGFSE
capacitándomelas	capacitar	VGFPE
capacitándotelas	capacitar	VGFPE
capacitándoselas	capacitar	VGFPE
capacitándonoslas	capacitar	VGFPE
capacitándooslas	capacitar	VGFPE
capar	capar	O
capo	capar	VIP1
capas	capar	VIP2
capa	capar	VIP3
capamos	capar	VIP4
capáis	capar	VIP5
capan	capar	VIP6
capaba	capar	VII1
capabas	capar	VII2
capábamos	capar	VII4
capabais	capar	VII5
capaban	capar	VII6
caparé	capar	VIF1
caparás	capar	VIF2
capará	capar	VIF3
caparemos	capar	VIF4
caparéis	capar	VIF5
caparán	capar	VIF6
caparía	capar	VIC1
caparías	capar	VIC2
caparía	capar	VIC3
caparíamos	capar	VIC4
caparíais	capar	VIC5
caparían	capar	VIC6
capé	capar	VIX1
capaste	capar	VIX2
capó	capar	VIX3
capasteis	capar	VIX5
caparon	capar	VIX6
cape	capar	VSP1
capes	capar	VSP2
capemos	capar	VSP4
capéis	capar	VSP5
capen	capar	VSP6
capara	capar	VSX1
caparas	capar	VSX2
capáramos	capar	VSX4
caparais	capar	VSX5
caparan	capar	VSX6
capare	capar	VSF1
capares	capar	VSF2
capáremos	capar	VSF4
capareis	capar	VSF5
caparen	capar	VSF6
capase	capar	VSI1
capases	capar	VSI2
capásemos	capar	VSI4
capaseis	capar	VSI5
capasen	capar	VSI6
capad	capar	VMP
capadme	capar	VMSE
capadle	capar	VMSE
capadnos	capar	VMPE
capaos	capar	VMPE
capadles	capar	VMPE
capadlo	capar	VMMSE
capadla	capar	VMFSE
capadlos	capar	VMMPE
capadlas	capar	VMFPE
capádmelo	capar	VMMSE
capádselo	capar	VMMSE
capádnoslo	capar	VMMSE
capáoslo	capar	VMMSE
capádmelos	capar	VMMPE
capádselos	capar	VMMPE
capádnoslos	capar	VMMPE
capáoslos	capar	VMMPE
capádmela	capar	VMFSE
capádsela	capar	VMFSE
capádnosla	capar	VMFSE
capáosla	capar	VMFSE
capádmelas	capar	VMFPE
capádselas	capar	VMFPE
capádnoslas	capar	VMFPE
capáoslas	capar	VMFPE
capado	capar	VPM
capados	capar	VPMP
capada	capar	VPF
capadas	capar	VPFP
capando	capar	VG
capándome	capar	VGSE
capándote	capar	VGSE
capándole	capar	VGSE
capándonos	capar	VGPE
capándoos	capar	VGPE
capándolo	capar	VGMSE
capándola	capar	VGFSE
capándolos	capar	VGMPE
capándolas	capar	VGFPE
capándomelo	capar	VGMSE
capándotelo	capar	VGMSE
capándoselo	capar	VGMSE
capándonoslo	capar	VGMSE
capándooslo	capar	VGMSE
capándomelos	capar	VGMPE
capándotelos	capar	VGMPE
capándoselos	capar	VGMPE
capándonoslos	capar	VGMPE
capándooslos	capar	VGMPE
capándomela	capar	VGFSE
capándotela	capar	VGFSE
capándosela	capar	VGFSE
capándonosla	capar	VGFSE
capándoosla	capar	VGFSE
capándomelas	capar	VGFPE
capándotelas	capar	VGFPE
capándoselas	capar	VGFPE
capándonoslas	capar	VGFPE
capándooslas	capar	VGFPE
capear	capear	O
capeo	capear	VIP1
capeas	capear	VIP2
capea	capear	VIP3
capeamos	capear	VIP4
capeáis	capear	VIP5
capean	capear	VIP6
capeaba	capear	VII1
capeabas	capear	VII2
capeábamos	capear	VII4
capeabais	capear	VII5
capeaban	capear	VII6
capearé	capear	VIF1
capearás	capear	VIF2
capeará	capear	VIF3
capearemos	capear	VIF4
capearéis	capear	VIF5
capearán	capear	VIF6
capearía	capear	VIC1
capearías	capear	VIC2
capearía	capear	VIC3
capearíamos	capear	VIC4
capearíais	capear	VIC5
capearían	capear	VIC6
capeé	capear	VIX1
capeaste	capear	VIX2
capeó	capear	VIX3
capeasteis	capear	VIX5
capearon	capear	VIX6
capee	capear	VSP1
capees	capear	VSP2
capeemos	capear	VSP4
capeéis	capear	VSP5
capeen	capear	VSP6
capeara	capear	VSX1
capearas	capear	VSX2
capeáramos	capear	VSX4
capearais	capear	VSX5
capearan	capear	VSX6
capeare	capear	VSF1
capeares	capear	VSF2
capeáremos	capear	VSF4
capeareis	capear	VSF5
capearen	capear	VSF6
capease	capear	VSI1
capeases	capear	VSI2
capeásemos	capear	VSI4
capeaseis	capear	VSI5
capeasen	capear	VSI6
capead	capear	VMP
capeadme	capear	VMSE
capeadle	capear	VMSE
capeadnos	capear	VMPE
capeaos	capear	VMPE
capeadles	capear	VMPE
capeadlo	capear	VMMSE
capeadla	capear	VMFSE
capeadlos	capear	VMMPE
capeadlas	capear	VMFPE
capeádmelo	capear	VMMSE
capeádselo	capear	VMMSE
capeádnoslo	capear	VMMSE
capeáoslo	capear	VMMSE
capeádmelos	capear	VMMPE
capeádselos	capear	VMMPE
capeádnoslos	capear	VMMPE
capeáoslos	capear	VMMPE
capeádmela	capear	VMFSE
capeádsela	capear	VMFSE
capeádnosla	capear	VMFSE
capeáosla	capear	VMFSE
capeádmelas	capear	VMFPE
capeádselas	capear	VMFPE
capeádnoslas	capear	VMFPE
capeáoslas	capear	VMFPE
capeado	capear	VPM
capeados	capear	VPMP
capeada	capear	VPF
capeadas	capear	VPFP
capeando	capear	VG
capeándome	capear	VGSE
capeándote	capear	VGSE
capeándole	capear	VGSE
capeándonos	capear	VGPE
capeándoos	capear	VGPE
capeándolo	capear	VGMSE
capeándola	capear	VGFSE
capeándolos	capear	VGMPE
capeándolas	capear	VGFPE
capeándomelo	capear	VGMSE
capeándotelo	capear	VGMSE
capeándoselo	capear	VGMSE
capeándonoslo	capear	VGMSE
capeándooslo	capear	VGMSE
capeándomelos	capear	VGMPE
capeándotelos	capear	VGMPE
capeándoselos	capear	VGMPE
capeándonoslos	capear	VGMPE
capeándooslos	capear	VGMPE
capeándomela	capear	VGFSE
capeándotela	capear	VGFSE
capeándosela	capear	VGFSE
capeándonosla	capear	VGFSE
capeándoosla	capear	VGFSE
capeándomelas	capear	VGFPE
capeándotelas	capear	VGFPE
capeándoselas	capear	VGFPE
capeándonoslas	capear	VGFPE
capeándooslas	capear	VGFPE
caperucear	caperucear	O
caperuceo	caperucear	VIP1
caperuceas	caperucear	VIP2
caperucea	caperucear	VIP3
caperuceamos	caperucear	VIP4
caperuceáis	caperucear	VIP5
caperucean	caperucear	VIP6
caperuceaba	caperucear	VII1
caperuceabas	caperucear	VII2
caperuceábamos	caperucear	VII4
caperuceabais	caperucear	VII5
caperuceaban	caperucear	VII6
caperucearé	caperucear	VIF1
caperucearás	caperucear	VIF2
caperuceará	caperucear	VIF3
caperucearemos	caperucear	VIF4
caperucearéis	caperucear	VIF5
caperucearán	caperucear	VIF6
caperucearía	caperucear	VIC1
caperucearías	caperucear	VIC2
caperucearía	caperucear	VIC3
caperucearíamos	caperucear	VIC4
caperucearíais	caperucear	VIC5
caperucearían	caperucear	VIC6
caperuceé	caperucear	VIX1
caperuceaste	caperucear	VIX2
caperuceó	caperucear	VIX3
caperuceasteis	caperucear	VIX5
caperucearon	caperucear	VIX6
caperucee	caperucear	VSP1
caperucees	caperucear	VSP2
caperuceemos	caperucear	VSP4
caperuceéis	caperucear	VSP5
caperuceen	caperucear	VSP6
caperuceara	caperucear	VSX1
caperucearas	caperucear	VSX2
caperuceáramos	caperucear	VSX4
caperucearais	caperucear	VSX5
caperucearan	caperucear	VSX6
caperuceare	caperucear	VSF1
caperuceares	caperucear	VSF2
caperuceáremos	caperucear	VSF4
caperuceareis	caperucear	VSF5
caperucearen	caperucear	VSF6
caperucease	caperucear	VSI1
caperuceases	caperucear	VSI2
caperuceásemos	caperucear	VSI4
caperuceaseis	caperucear	VSI5
caperuceasen	caperucear	VSI6
caperucead	caperucear	VMP
caperuceadme	caperucear	VMSE
caperuceadle	caperucear	VMSE
caperuceadnos	caperucear	VMPE
caperuceaos	caperucear	VMPE
caperuceadles	caperucear	VMPE
caperuceadlo	caperucear	VMMSE
caperuceadla	caperucear	VMFSE
caperuceadlos	caperucear	VMMPE
caperuceadlas	caperucear	VMFPE
caperuceádmelo	caperucear	VMMSE
caperuceádselo	caperucear	VMMSE
caperuceádnoslo	caperucear	VMMSE
caperuceáoslo	caperucear	VMMSE
caperuceádmelos	caperucear	VMMPE
caperuceádselos	caperucear	VMMPE
caperuceádnoslos	caperucear	VMMPE
caperuceáoslos	caperucear	VMMPE
caperuceádmela	caperucear	VMFSE
caperuceádsela	caperucear	VMFSE
caperuceádnosla	caperucear	VMFSE
caperuceáosla	caperucear	VMFSE
caperuceádmelas	caperucear	VMFPE
caperuceádselas	caperucear	VMFPE
caperuceádnoslas	caperucear	VMFPE
caperuceáoslas	caperucear	VMFPE
caperuceado	caperucear	VPM
caperuceados	caperucear	VPMP
caperuceada	caperucear	VPF
caperuceadas	caperucear	VPFP
caperuceando	caperucear	VG
caperuceándome	caperucear	VGSE
caperuceándote	caperucear	VGSE
caperuceándole	caperucear	VGSE
caperuceándonos	caperucear	VGPE
caperuceándoos	caperucear	VGPE
caperuceándolo	caperucear	VGMSE
caperuceándola	caperucear	VGFSE
caperuceándolos	caperucear	VGMPE
caperuceándolas	caperucear	VGFPE
caperuceándomelo	caperucear	VGMSE
caperuceándotelo	caperucear	VGMSE
caperuceándoselo	caperucear	VGMSE
caperuceándonoslo	caperucear	VGMSE
caperuceándooslo	caperucear	VGMSE
caperuceándomelos	caperucear	VGMPE
caperuceándotelos	caperucear	VGMPE
caperuceándoselos	caperucear	VGMPE
caperuceándonoslos	caperucear	VGMPE
caperuceándooslos	caperucear	VGMPE
caperuceándomela	caperucear	VGFSE
caperuceándotela	caperucear	VGFSE
caperuceándosela	caperucear	VGFSE
caperuceándonosla	caperucear	VGFSE
caperuceándoosla	caperucear	VGFSE
caperuceándomelas	caperucear	VGFPE
caperuceándotelas	caperucear	VGFPE
caperuceándoselas	caperucear	VGFPE
caperuceándonoslas	caperucear	VGFPE
caperuceándooslas	caperucear	VGFPE
capialzar	capialzar	O
capialzo	capialzar	VIP1
capialzas	capialzar	VIP2
capialza	capialzar	VIP3
capialzamos	capialzar	VIP4
capialzáis	capialzar	VIP5
capialzan	capialzar	VIP6
capialzaba	capialzar	VII1
capialzabas	capialzar	VII2
capialzábamos	capialzar	VII4
capialzabais	capialzar	VII5
capialzaban	capialzar	VII6
capialzaré	capialzar	VIF1
capialzarás	capialzar	VIF2
capialzará	capialzar	VIF3
capialzaremos	capialzar	VIF4
capialzaréis	capialzar	VIF5
capialzarán	capialzar	VIF6
capialzaría	capialzar	VIC1
capialzarías	capialzar	VIC2
capialzaría	capialzar	VIC3
capialzaríamos	capialzar	VIC4
capialzaríais	capialzar	VIC5
capialzarían	capialzar	VIC6
capialcé	capialzar	VIX1
capialzaste	capialzar	VIX2
capialzó	capialzar	VIX3
capialzasteis	capialzar	VIX5
capialzaron	capialzar	VIX6
capialce	capialzar	VSP1
capialces	capialzar	VSP2
capialcemos	capialzar	VSP4
capialcéis	capialzar	VSP5
capialcen	capialzar	VSP6
capialzara	capialzar	VSX1
capialzaras	capialzar	VSX2
capialzáramos	capialzar	VSX4
capialzarais	capialzar	VSX5
capialzaran	capialzar	VSX6
capialzare	capialzar	VSF1
capialzares	capialzar	VSF2
capialzáremos	capialzar	VSF4
capialzareis	capialzar	VSF5
capialzaren	capialzar	VSF6
capialzase	capialzar	VSI1
capialzases	capialzar	VSI2
capialzásemos	capialzar	VSI4
capialzaseis	capialzar	VSI5
capialzasen	capialzar	VSI6
capialzad	capialzar	VMP
capialzadme	capialzar	VMSE
capialzadle	capialzar	VMSE
capialzadnos	capialzar	VMPE
capialzaos	capialzar	VMPE
capialzadles	capialzar	VMPE
capialzadlo	capialzar	VMMSE
capialzadla	capialzar	VMFSE
capialzadlos	capialzar	VMMPE
capialzadlas	capialzar	VMFPE
capialzádmelo	capialzar	VMMSE
capialzádselo	capialzar	VMMSE
capialzádnoslo	capialzar	VMMSE
capialzáoslo	capialzar	VMMSE
capialzádmelos	capialzar	VMMPE
capialzádselos	capialzar	VMMPE
capialzádnoslos	capialzar	VMMPE
capialzáoslos	capialzar	VMMPE
capialzádmela	capialzar	VMFSE
capialzádsela	capialzar	VMFSE
capialzádnosla	capialzar	VMFSE
capialzáosla	capialzar	VMFSE
capialzádmelas	capialzar	VMFPE
capialzádselas	capialzar	VMFPE
capialzádnoslas	capialzar	VMFPE
capialzáoslas	capialzar	VMFPE
capialzado	capialzar	VPM
capialzados	capialzar	VPMP
capialzada	capialzar	VPF
capialzadas	capialzar	VPFP
capialzando	capialzar	VG
capialzándome	capialzar	VGSE
capialzándote	capialzar	VGSE
capialzándole	capialzar	VGSE
capialzándonos	capialzar	VGPE
capialzándoos	capialzar	VGPE
capialzándolo	capialzar	VGMSE
capialzándola	capialzar	VGFSE
capialzándolos	capialzar	VGMPE
capialzándolas	capialzar	VGFPE
capialzándomelo	capialzar	VGMSE
capialzándotelo	capialzar	VGMSE
capialzándoselo	capialzar	VGMSE
capialzándonoslo	capialzar	VGMSE
capialzándooslo	capialzar	VGMSE
capialzándomelos	capialzar	VGMPE
capialzándotelos	capialzar	VGMPE
capialzándoselos	capialzar	VGMPE
capialzándonoslos	capialzar	VGMPE
capialzándooslos	capialzar	VGMPE
capialzándomela	capialzar	VGFSE
capialzándotela	capialzar	VGFSE
capialzándosela	capialzar	VGFSE
capialzándonosla	capialzar	VGFSE
capialzándoosla	capialzar	VGFSE
capialzándomelas	capialzar	VGFPE
capialzándotelas	capialzar	VGFPE
capialzándoselas	capialzar	VGFPE
capialzándonoslas	capialzar	VGFPE
capialzándooslas	capialzar	VGFPE
capitalizar	capitalizar	O
capitalizo	capitalizar	VIP1
capitalizas	capitalizar	VIP2
capitaliza	capitalizar	VIP3
capitalizamos	capitalizar	VIP4
capitalizáis	capitalizar	VIP5
capitalizan	capitalizar	VIP6
capitalizaba	capitalizar	VII1
capitalizabas	capitalizar	VII2
capitalizábamos	capitalizar	VII4
capitalizabais	capitalizar	VII5
capitalizaban	capitalizar	VII6
capitalizaré	capitalizar	VIF1
capitalizarás	capitalizar	VIF2
capitalizará	capitalizar	VIF3
capitalizaremos	capitalizar	VIF4
capitalizaréis	capitalizar	VIF5
capitalizarán	capitalizar	VIF6
capitalizaría	capitalizar	VIC1
capitalizarías	capitalizar	VIC2
capitalizaría	capitalizar	VIC3
capitalizaríamos	capitalizar	VIC4
capitalizaríais	capitalizar	VIC5
capitalizarían	capitalizar	VIC6
capitalicé	capitalizar	VIX1
capitalizaste	capitalizar	VIX2
capitalizó	capitalizar	VIX3
capitalizasteis	capitalizar	VIX5
capitalizaron	capitalizar	VIX6
capitalice	capitalizar	VSP1
capitalices	capitalizar	VSP2
capitalicemos	capitalizar	VSP4
capitalicéis	capitalizar	VSP5
capitalicen	capitalizar	VSP6
capitalizara	capitalizar	VSX1
capitalizaras	capitalizar	VSX2
capitalizáramos	capitalizar	VSX4
capitalizarais	capitalizar	VSX5
capitalizaran	capitalizar	VSX6
capitalizare	capitalizar	VSF1
capitalizares	capitalizar	VSF2
capitalizáremos	capitalizar	VSF4
capitalizareis	capitalizar	VSF5
capitalizaren	capitalizar	VSF6
capitalizase	capitalizar	VSI1
capitalizases	capitalizar	VSI2
capitalizásemos	capitalizar	VSI4
capitalizaseis	capitalizar	VSI5
capitalizasen	capitalizar	VSI6
capitalizad	capitalizar	VMP
capitalizadme	capitalizar	VMSE
capitalizadle	capitalizar	VMSE
capitalizadnos	capitalizar	VMPE
capitalizaos	capitalizar	VMPE
capitalizadles	capitalizar	VMPE
capitalizadlo	capitalizar	VMMSE
capitalizadla	capitalizar	VMFSE
capitalizadlos	capitalizar	VMMPE
capitalizadlas	capitalizar	VMFPE
capitalizádmelo	capitalizar	VMMSE
capitalizádselo	capitalizar	VMMSE
capitalizádnoslo	capitalizar	VMMSE
capitalizáoslo	capitalizar	VMMSE
capitalizádmelos	capitalizar	VMMPE
capitalizádselos	capitalizar	VMMPE
capitalizádnoslos	capitalizar	VMMPE
capitalizáoslos	capitalizar	VMMPE
capitalizádmela	capitalizar	VMFSE
capitalizádsela	capitalizar	VMFSE
capitalizádnosla	capitalizar	VMFSE
capitalizáosla	capitalizar	VMFSE
capitalizádmelas	capitalizar	VMFPE
capitalizádselas	capitalizar	VMFPE
capitalizádnoslas	capitalizar	VMFPE
capitalizáoslas	capitalizar	VMFPE
capitalizado	capitalizar	VPM
capitalizados	capitalizar	VPMP
capitalizada	capitalizar	VPF
capitalizadas	capitalizar	VPFP
capitalizando	capitalizar	VG
capitalizándome	capitalizar	VGSE
capitalizándote	capitalizar	VGSE
capitalizándole	capitalizar	VGSE
capitalizándonos	capitalizar	VGPE
capitalizándoos	capitalizar	VGPE
capitalizándolo	capitalizar	VGMSE
capitalizándola	capitalizar	VGFSE
capitalizándolos	capitalizar	VGMPE
capitalizándolas	capitalizar	VGFPE
capitalizándomelo	capitalizar	VGMSE
capitalizándotelo	capitalizar	VGMSE
capitalizándoselo	capitalizar	VGMSE
capitalizándonoslo	capitalizar	VGMSE
capitalizándooslo	capitalizar	VGMSE
capitalizándomelos	capitalizar	VGMPE
capitalizándotelos	capitalizar	VGMPE
capitalizándoselos	capitalizar	VGMPE
capitalizándonoslos	capitalizar	VGMPE
capitalizándooslos	capitalizar	VGMPE
capitalizándomela	capitalizar	VGFSE
capitalizándotela	capitalizar	VGFSE
capitalizándosela	capitalizar	VGFSE
capitalizándonosla	capitalizar	VGFSE
capitalizándoosla	capitalizar	VGFSE
capitalizándomelas	capitalizar	VGFPE
capitalizándotelas	capitalizar	VGFPE
capitalizándoselas	capitalizar	VGFPE
capitalizándonoslas	capitalizar	VGFPE
capitalizándooslas	capitalizar	VGFPE
capitanear	capitanear	O
capitaneo	capitanear	VIP1
capitaneas	capitanear	VIP2
capitanea	capitanear	VIP3
capitaneamos	capitanear	VIP4
capitaneáis	capitanear	VIP5
capitanean	capitanear	VIP6
capitaneaba	capitanear	VII1
capitaneabas	capitanear	VII2
capitaneábamos	capitanear	VII4
capitaneabais	capitanear	VII5
capitaneaban	capitanear	VII6
capitanearé	capitanear	VIF1
capitanearás	capitanear	VIF2
capitaneará	capitanear	VIF3
capitanearemos	capitanear	VIF4
capitanearéis	capitanear	VIF5
capitanearán	capitanear	VIF6
capitanearía	capitanear	VIC1
capitanearías	capitanear	VIC2
capitanearía	capitanear	VIC3
capitanearíamos	capitanear	VIC4
capitanearíais	capitanear	VIC5
capitanearían	capitanear	VIC6
capitaneé	capitanear	VIX1
capitaneaste	capitanear	VIX2
capitaneó	capitanear	VIX3
capitaneasteis	capitanear	VIX5
capitanearon	capitanear	VIX6
capitanee	capitanear	VSP1
capitanees	capitanear	VSP2
capitaneemos	capitanear	VSP4
capitaneéis	capitanear	VSP5
capitaneen	capitanear	VSP6
capitaneara	capitanear	VSX1
capitanearas	capitanear	VSX2
capitaneáramos	capitanear	VSX4
capitanearais	capitanear	VSX5
capitanearan	capitanear	VSX6
capitaneare	capitanear	VSF1
capitaneares	capitanear	VSF2
capitaneáremos	capitanear	VSF4
capitaneareis	capitanear	VSF5
capitanearen	capitanear	VSF6
capitanease	capitanear	VSI1
capitaneases	capitanear	VSI2
capitaneásemos	capitanear	VSI4
capitaneaseis	capitanear	VSI5
capitaneasen	capitanear	VSI6
capitanead	capitanear	VMP
capitaneadme	capitanear	VMSE
capitaneadle	capitanear	VMSE
capitaneadnos	capitanear	VMPE
capitaneaos	capitanear	VMPE
capitaneadles	capitanear	VMPE
capitaneadlo	capitanear	VMMSE
capitaneadla	capitanear	VMFSE
capitaneadlos	capitanear	VMMPE
capitaneadlas	capitanear	VMFPE
capitaneádmelo	capitanear	VMMSE
capitaneádselo	capitanear	VMMSE
capitaneádnoslo	capitanear	VMMSE
capitaneáoslo	capitanear	VMMSE
capitaneádmelos	capitanear	VMMPE
capitaneádselos	capitanear	VMMPE
capitaneádnoslos	capitanear	VMMPE
capitaneáoslos	capitanear	VMMPE
capitaneádmela	capitanear	VMFSE
capitaneádsela	capitanear	VMFSE
capitaneádnosla	capitanear	VMFSE
capitaneáosla	capitanear	VMFSE
capitaneádmelas	capitanear	VMFPE
capitaneádselas	capitanear	VMFPE
capitaneádnoslas	capitanear	VMFPE
capitaneáoslas	capitanear	VMFPE
capitaneado	capitanear	VPM
capitaneados	capitanear	VPMP
capitaneada	capitanear	VPF
capitaneadas	capitanear	VPFP
capitaneando	capitanear	VG
capitaneándome	capitanear	VGSE
capitaneándote	capitanear	VGSE
capitaneándole	capitanear	VGSE
capitaneándonos	capitanear	VGPE
capitaneándoos	capitanear	VGPE
capitaneándolo	capitanear	VGMSE
capitaneándola	capitanear	VGFSE
capitaneándolos	capitanear	VGMPE
capitaneándolas	capitanear	VGFPE
capitaneándomelo	capitanear	VGMSE
capitaneándotelo	capitanear	VGMSE
capitaneándoselo	capitanear	VGMSE
capitaneándonoslo	capitanear	VGMSE
capitaneándooslo	capitanear	VGMSE
capitaneándomelos	capitanear	VGMPE
capitaneándotelos	capitanear	VGMPE
capitaneándoselos	capitanear	VGMPE
capitaneándonoslos	capitanear	VGMPE
capitaneándooslos	capitanear	VGMPE
capitaneándomela	capitanear	VGFSE
capitaneándotela	capitanear	VGFSE
capitaneándosela	capitanear	VGFSE
capitaneándonosla	capitanear	VGFSE
capitaneándoosla	capitanear	VGFSE
capitaneándomelas	capitanear	VGFPE
capitaneándotelas	capitanear	VGFPE
capitaneándoselas	capitanear	VGFPE
capitaneándonoslas	capitanear	VGFPE
capitaneándooslas	capitanear	VGFPE
capitular	capitular	O
capitulo	capitular	VIP1
capitulas	capitular	VIP2
capitula	capitular	VIP3
capitulamos	capitular	VIP4
capituláis	capitular	VIP5
capitulan	capitular	VIP6
capitulaba	capitular	VII1
capitulabas	capitular	VII2
capitulábamos	capitular	VII4
capitulabais	capitular	VII5
capitulaban	capitular	VII6
capitularé	capitular	VIF1
capitularás	capitular	VIF2
capitulará	capitular	VIF3
capitularemos	capitular	VIF4
capitularéis	capitular	VIF5
capitularán	capitular	VIF6
capitularía	capitular	VIC1
capitularías	capitular	VIC2
capitularía	capitular	VIC3
capitularíamos	capitular	VIC4
capitularíais	capitular	VIC5
capitularían	capitular	VIC6
capitulé	capitular	VIX1
capitulaste	capitular	VIX2
capituló	capitular	VIX3
capitulasteis	capitular	VIX5
capitularon	capitular	VIX6
capitule	capitular	VSP1
capitules	capitular	VSP2
capitulemos	capitular	VSP4
capituléis	capitular	VSP5
capitulen	capitular	VSP6
capitulara	capitular	VSX1
capitularas	capitular	VSX2
capituláramos	capitular	VSX4
capitularais	capitular	VSX5
capitularan	capitular	VSX6
capitulare	capitular	VSF1
capitulares	capitular	VSF2
capituláremos	capitular	VSF4
capitulareis	capitular	VSF5
capitularen	capitular	VSF6
capitulase	capitular	VSI1
capitulases	capitular	VSI2
capitulásemos	capitular	VSI4
capitulaseis	capitular	VSI5
capitulasen	capitular	VSI6
capitulad	capitular	VMP
capituladme	capitular	VMSE
capituladle	capitular	VMSE
capituladnos	capitular	VMPE
capitulaos	capitular	VMPE
capituladles	capitular	VMPE
capituladlo	capitular	VMMSE
capituladla	capitular	VMFSE
capituladlos	capitular	VMMPE
capituladlas	capitular	VMFPE
capituládmelo	capitular	VMMSE
capituládselo	capitular	VMMSE
capituládnoslo	capitular	VMMSE
capituláoslo	capitular	VMMSE
capituládmelos	capitular	VMMPE
capituládselos	capitular	VMMPE
capituládnoslos	capitular	VMMPE
capituláoslos	capitular	VMMPE
capituládmela	capitular	VMFSE
capituládsela	capitular	VMFSE
capituládnosla	capitular	VMFSE
capituláosla	capitular	VMFSE
capituládmelas	capitular	VMFPE
capituládselas	capitular	VMFPE
capituládnoslas	capitular	VMFPE
capituláoslas	capitular	VMFPE
capitulado	capitular	VPM
capitulados	capitular	VPMP
capitulada	capitular	VPF
capituladas	capitular	VPFP
capitulando	capitular	VG
capitulándome	capitular	VGSE
capitulándote	capitular	VGSE
capitulándole	capitular	VGSE
capitulándonos	capitular	VGPE
capitulándoos	capitular	VGPE
capitulándolo	capitular	VGMSE
capitulándola	capitular	VGFSE
capitulándolos	capitular	VGMPE
capitulándolas	capitular	VGFPE
capitulándomelo	capitular	VGMSE
capitulándotelo	capitular	VGMSE
capitulándoselo	capitular	VGMSE
capitulándonoslo	capitular	VGMSE
capitulándooslo	capitular	VGMSE
capitulándomelos	capitular	VGMPE
capitulándotelos	capitular	VGMPE
capitulándoselos	capitular	VGMPE
capitulándonoslos	capitular	VGMPE
capitulándooslos	capitular	VGMPE
capitulándomela	capitular	VGFSE
capitulándotela	capitular	VGFSE
capitulándosela	capitular	VGFSE
capitulándonosla	capitular	VGFSE
capitulándoosla	capitular	VGFSE
capitulándomelas	capitular	VGFPE
capitulándotelas	capitular	VGFPE
capitulándoselas	capitular	VGFPE
capitulándonoslas	capitular	VGFPE
capitulándooslas	capitular	VGFPE
capitulares	capitular	P
capolar	capolar	O
capolo	capolar	VIP1
capolas	capolar	VIP2
capola	capolar	VIP3
capolamos	capolar	VIP4
capoláis	capolar	VIP5
capolan	capolar	VIP6
capolaba	capolar	VII1
capolabas	capolar	VII2
capolábamos	capolar	VII4
capolabais	capolar	VII5
capolaban	capolar	VII6
capolaré	capolar	VIF1
capolarás	capolar	VIF2
capolará	capolar	VIF3
capolaremos	capolar	VIF4
capolaréis	capolar	VIF5
capolarán	capolar	VIF6
capolaría	capolar	VIC1
capolarías	capolar	VIC2
capolaría	capolar	VIC3
capolaríamos	capolar	VIC4
capolaríais	capolar	VIC5
capolarían	capolar	VIC6
capolé	capolar	VIX1
capolaste	capolar	VIX2
capoló	capolar	VIX3
capolasteis	capolar	VIX5
capolaron	capolar	VIX6
capole	capolar	VSP1
capoles	capolar	VSP2
capolemos	capolar	VSP4
capoléis	capolar	VSP5
capolen	capolar	VSP6
capolara	capolar	VSX1
capolaras	capolar	VSX2
capoláramos	capolar	VSX4
capolarais	capolar	VSX5
capolaran	capolar	VSX6
capolare	capolar	VSF1
capolares	capolar	VSF2
capoláremos	capolar	VSF4
capolareis	capolar	VSF5
capolaren	capolar	VSF6
capolase	capolar	VSI1
capolases	capolar	VSI2
capolásemos	capolar	VSI4
capolaseis	capolar	VSI5
capolasen	capolar	VSI6
capolad	capolar	VMP
capoladme	capolar	VMSE
capoladle	capolar	VMSE
capoladnos	capolar	VMPE
capolaos	capolar	VMPE
capoladles	capolar	VMPE
capoladlo	capolar	VMMSE
capoladla	capolar	VMFSE
capoladlos	capolar	VMMPE
capoladlas	capolar	VMFPE
capoládmelo	capolar	VMMSE
capoládselo	capolar	VMMSE
capoládnoslo	capolar	VMMSE
capoláoslo	capolar	VMMSE
capoládmelos	capolar	VMMPE
capoládselos	capolar	VMMPE
capoládnoslos	capolar	VMMPE
capoláoslos	capolar	VMMPE
capoládmela	capolar	VMFSE
capoládsela	capolar	VMFSE
capoládnosla	capolar	VMFSE
capoláosla	capolar	VMFSE
capoládmelas	capolar	VMFPE
capoládselas	capolar	VMFPE
capoládnoslas	capolar	VMFPE
capoláoslas	capolar	VMFPE
capolado	capolar	VPM
capolados	capolar	VPMP
capolada	capolar	VPF
capoladas	capolar	VPFP
capolando	capolar	VG
capolándome	capolar	VGSE
capolándote	capolar	VGSE
capolándole	capolar	VGSE
capolándonos	capolar	VGPE
capolándoos	capolar	VGPE
capolándolo	capolar	VGMSE
capolándola	capolar	VGFSE
capolándolos	capolar	VGMPE
capolándolas	capolar	VGFPE
capolándomelo	capolar	VGMSE
capolándotelo	capolar	VGMSE
capolándoselo	capolar	VGMSE
capolándonoslo	capolar	VGMSE
capolándooslo	capolar	VGMSE
capolándomelos	capolar	VGMPE
capolándotelos	capolar	VGMPE
capolándoselos	capolar	VGMPE
capolándonoslos	capolar	VGMPE
capolándooslos	capolar	VGMPE
capolándomela	capolar	VGFSE
capolándotela	capolar	VGFSE
capolándosela	capolar	VGFSE
capolándonosla	capolar	VGFSE
capolándoosla	capolar	VGFSE
capolándomelas	capolar	VGFPE
capolándotelas	capolar	VGFPE
capolándoselas	capolar	VGFPE
capolándonoslas	capolar	VGFPE
capolándooslas	capolar	VGFPE
caponar	caponar	O
capono	caponar	VIP1
caponas	caponar	VIP2
capona	caponar	VIP3
caponamos	caponar	VIP4
caponáis	caponar	VIP5
caponan	caponar	VIP6
caponaba	caponar	VII1
caponabas	caponar	VII2
caponábamos	caponar	VII4
caponabais	caponar	VII5
caponaban	caponar	VII6
caponaré	caponar	VIF1
caponarás	caponar	VIF2
caponará	caponar	VIF3
caponaremos	caponar	VIF4
caponaréis	caponar	VIF5
caponarán	caponar	VIF6
caponaría	caponar	VIC1
caponarías	caponar	VIC2
caponaría	caponar	VIC3
caponaríamos	caponar	VIC4
caponaríais	caponar	VIC5
caponarían	caponar	VIC6
caponé	caponar	VIX1
caponaste	caponar	VIX2
caponó	caponar	VIX3
caponasteis	caponar	VIX5
caponaron	caponar	VIX6
capone	caponar	VSP1
capones	caponar	VSP2
caponemos	caponar	VSP4
caponéis	caponar	VSP5
caponen	caponar	VSP6
caponara	caponar	VSX1
caponaras	caponar	VSX2
caponáramos	caponar	VSX4
caponarais	caponar	VSX5
caponaran	caponar	VSX6
caponare	caponar	VSF1
caponares	caponar	VSF2
caponáremos	caponar	VSF4
caponareis	caponar	VSF5
caponaren	caponar	VSF6
caponase	caponar	VSI1
caponases	caponar	VSI2
caponásemos	caponar	VSI4
caponaseis	caponar	VSI5
caponasen	caponar	VSI6
caponad	caponar	VMP
caponadme	caponar	VMSE
caponadle	caponar	VMSE
caponadnos	caponar	VMPE
caponaos	caponar	VMPE
caponadles	caponar	VMPE
caponadlo	caponar	VMMSE
caponadla	caponar	VMFSE
caponadlos	caponar	VMMPE
caponadlas	caponar	VMFPE
caponádmelo	caponar	VMMSE
caponádselo	caponar	VMMSE
caponádnoslo	caponar	VMMSE
caponáoslo	caponar	VMMSE
caponádmelos	caponar	VMMPE
caponádselos	caponar	VMMPE
caponádnoslos	caponar	VMMPE
caponáoslos	caponar	VMMPE
caponádmela	caponar	VMFSE
caponádsela	caponar	VMFSE
caponádnosla	caponar	VMFSE
caponáosla	caponar	VMFSE
caponádmelas	caponar	VMFPE
caponádselas	caponar	VMFPE
caponádnoslas	caponar	VMFPE
caponáoslas	caponar	VMFPE
caponado	caponar	VPM
caponados	caponar	VPMP
caponada	caponar	VPF
caponadas	caponar	VPFP
caponando	caponar	VG
caponándome	caponar	VGSE
caponándote	caponar	VGSE
caponándole	caponar	VGSE
caponándonos	caponar	VGPE
caponándoos	caponar	VGPE
caponándolo	caponar	VGMSE
caponándola	caponar	VGFSE
caponándolos	caponar	VGMPE
caponándolas	caponar	VGFPE
caponándomelo	caponar	VGMSE
caponándotelo	caponar	VGMSE
caponándoselo	caponar	VGMSE
caponándonoslo	caponar	VGMSE
caponándooslo	caponar	VGMSE
caponándomelos	caponar	VGMPE
caponándotelos	caponar	VGMPE
caponándoselos	caponar	VGMPE
caponándonoslos	caponar	VGMPE
caponándooslos	caponar	VGMPE
caponándomela	caponar	VGFSE
caponándotela	caponar	VGFSE
caponándosela	caponar	VGFSE
caponándonosla	caponar	VGFSE
caponándoosla	caponar	VGFSE
caponándomelas	caponar	VGFPE
caponándotelas	caponar	VGFPE
caponándoselas	caponar	VGFPE
caponándonoslas	caponar	VGFPE
caponándooslas	caponar	VGFPE
capotar	capotar	O
capoto	capotar	VIP1
capotas	capotar	VIP2
capota	capotar	VIP3
capotamos	capotar	VIP4
capotáis	capotar	VIP5
capotan	capotar	VIP6
capotaba	capotar	VII1
capotabas	capotar	VII2
capotábamos	capotar	VII4
capotabais	capotar	VII5
capotaban	capotar	VII6
capotaré	capotar	VIF1
capotarás	capotar	VIF2
capotará	capotar	VIF3
capotaremos	capotar	VIF4
capotaréis	capotar	VIF5
capotarán	capotar	VIF6
capotaría	capotar	VIC1
capotarías	capotar	VIC2
capotaría	capotar	VIC3
capotaríamos	capotar	VIC4
capotaríais	capotar	VIC5
capotarían	capotar	VIC6
capoté	capotar	VIX1
capotaste	capotar	VIX2
capotó	capotar	VIX3
capotasteis	capotar	VIX5
capotaron	capotar	VIX6
capote	capotar	VSP1
capotes	capotar	VSP2
capotemos	capotar	VSP4
capotéis	capotar	VSP5
capoten	capotar	VSP6
capotara	capotar	VSX1
capotaras	capotar	VSX2
capotáramos	capotar	VSX4
capotarais	capotar	VSX5
capotaran	capotar	VSX6
capotare	capotar	VSF1
capotares	capotar	VSF2
capotáremos	capotar	VSF4
capotareis	capotar	VSF5
capotaren	capotar	VSF6
capotase	capotar	VSI1
capotases	capotar	VSI2
capotásemos	capotar	VSI4
capotaseis	capotar	VSI5
capotasen	capotar	VSI6
capotad	capotar	VMP
capotadme	capotar	VMSE
capotadle	capotar	VMSE
capotadnos	capotar	VMPE
capotaos	capotar	VMPE
capotadles	capotar	VMPE
capotado	capotar	VPM
capotados	capotar	VPMP
capotada	capotar	VPF
capotadas	capotar	VPFP
capotando	capotar	VG
capotándome	capotar	VGSE
capotándote	capotar	VGSE
capotándole	capotar	VGSE
capotándonos	capotar	VGPE
capotándoos	capotar	VGPE
capotear	capotear	O
capoteo	capotear	VIP1
capoteas	capotear	VIP2
capotea	capotear	VIP3
capoteamos	capotear	VIP4
capoteáis	capotear	VIP5
capotean	capotear	VIP6
capoteaba	capotear	VII1
capoteabas	capotear	VII2
capoteábamos	capotear	VII4
capoteabais	capotear	VII5
capoteaban	capotear	VII6
capotearé	capotear	VIF1
capotearás	capotear	VIF2
capoteará	capotear	VIF3
capotearemos	capotear	VIF4
capotearéis	capotear	VIF5
capotearán	capotear	VIF6
capotearía	capotear	VIC1
capotearías	capotear	VIC2
capotearía	capotear	VIC3
capotearíamos	capotear	VIC4
capotearíais	capotear	VIC5
capotearían	capotear	VIC6
capoteé	capotear	VIX1
capoteaste	capotear	VIX2
capoteó	capotear	VIX3
capoteasteis	capotear	VIX5
capotearon	capotear	VIX6
capotee	capotear	VSP1
capotees	capotear	VSP2
capoteemos	capotear	VSP4
capoteéis	capotear	VSP5
capoteen	capotear	VSP6
capoteara	capotear	VSX1
capotearas	capotear	VSX2
capoteáramos	capotear	VSX4
capotearais	capotear	VSX5
capotearan	capotear	VSX6
capoteare	capotear	VSF1
capoteares	capotear	VSF2
capoteáremos	capotear	VSF4
capoteareis	capotear	VSF5
capotearen	capotear	VSF6
capotease	capotear	VSI1
capoteases	capotear	VSI2
capoteásemos	capotear	VSI4
capoteaseis	capotear	VSI5
capoteasen	capotear	VSI6
capotead	capotear	VMP
capoteadme	capotear	VMSE
capoteadle	capotear	VMSE
capoteadnos	capotear	VMPE
capoteaos	capotear	VMPE
capoteadles	capotear	VMPE
capoteadlo	capotear	VMMSE
capoteadla	capotear	VMFSE
capoteadlos	capotear	VMMPE
capoteadlas	capotear	VMFPE
capoteádmelo	capotear	VMMSE
capoteádselo	capotear	VMMSE
capoteádnoslo	capotear	VMMSE
capoteáoslo	capotear	VMMSE
capoteádmelos	capotear	VMMPE
capoteádselos	capotear	VMMPE
capoteádnoslos	capotear	VMMPE
capoteáoslos	capotear	VMMPE
capoteádmela	capotear	VMFSE
capoteádsela	capotear	VMFSE
capoteádnosla	capotear	VMFSE
capoteáosla	capotear	VMFSE
capoteádmelas	capotear	VMFPE
capoteádselas	capotear	VMFPE
capoteádnoslas	capotear	VMFPE
capoteáoslas	capotear	VMFPE
capoteado	capotear	VPM
capoteados	capotear	VPMP
capoteada	capotear	VPF
capoteadas	capotear	VPFP
capoteando	capotear	VG
capoteándome	capotear	VGSE
capoteándote	capotear	VGSE
capoteándole	capotear	VGSE
capoteándonos	capotear	VGPE
capoteándoos	capotear	VGPE
capoteándolo	capotear	VGMSE
capoteándola	capotear	VGFSE
capoteándolos	capotear	VGMPE
capoteándolas	capotear	VGFPE
capoteándomelo	capotear	VGMSE
capoteándotelo	capotear	VGMSE
capoteándoselo	capotear	VGMSE
capoteándonoslo	capotear	VGMSE
capoteándooslo	capotear	VGMSE
capoteándomelos	capotear	VGMPE
capoteándotelos	capotear	VGMPE
capoteándoselos	capotear	VGMPE
capoteándonoslos	capotear	VGMPE
capoteándooslos	capotear	VGMPE
capoteándomela	capotear	VGFSE
capoteándotela	capotear	VGFSE
capoteándosela	capotear	VGFSE
capoteándonosla	capotear	VGFSE
capoteándoosla	capotear	VGFSE
capoteándomelas	capotear	VGFPE
capoteándotelas	capotear	VGFPE
capoteándoselas	capotear	VGFPE
capoteándonoslas	capotear	VGFPE
capoteándooslas	capotear	VGFPE
capsular	capsular	O
capsulo	capsular	VIP1
capsulas	capsular	VIP2
capsula	capsular	VIP3
capsulamos	capsular	VIP4
capsuláis	capsular	VIP5
capsulan	capsular	VIP6
capsulaba	capsular	VII1
capsulabas	capsular	VII2
capsulábamos	capsular	VII4
capsulabais	capsular	VII5
capsulaban	capsular	VII6
capsularé	capsular	VIF1
capsularás	capsular	VIF2
capsulará	capsular	VIF3
capsularemos	capsular	VIF4
capsularéis	capsular	VIF5
capsularán	capsular	VIF6
capsularía	capsular	VIC1
capsularías	capsular	VIC2
capsularía	capsular	VIC3
capsularíamos	capsular	VIC4
capsularíais	capsular	VIC5
capsularían	capsular	VIC6
capsulé	capsular	VIX1
capsulaste	capsular	VIX2
capsuló	capsular	VIX3
capsulasteis	capsular	VIX5
capsularon	capsular	VIX6
capsule	capsular	VSP1
capsules	capsular	VSP2
capsulemos	capsular	VSP4
capsuléis	capsular	VSP5
capsulen	capsular	VSP6
capsulara	capsular	VSX1
capsularas	capsular	VSX2
capsuláramos	capsular	VSX4
capsularais	capsular	VSX5
capsularan	capsular	VSX6
capsulare	capsular	VSF1
capsulares	capsular	VSF2
capsuláremos	capsular	VSF4
capsulareis	capsular	VSF5
capsularen	capsular	VSF6
capsulase	capsular	VSI1
capsulases	capsular	VSI2
capsulásemos	capsular	VSI4
capsulaseis	capsular	VSI5
capsulasen	capsular	VSI6
capsulad	capsular	VMP
capsuladme	capsular	VMSE
capsuladle	capsular	VMSE
capsuladnos	capsular	VMPE
capsulaos	capsular	VMPE
capsuladles	capsular	VMPE
capsuladlo	capsular	VMMSE
capsuladla	capsular	VMFSE
capsuladlos	capsular	VMMPE
capsuladlas	capsular	VMFPE
capsuládmelo	capsular	VMMSE
capsuládselo	capsular	VMMSE
capsuládnoslo	capsular	VMMSE
capsuláoslo	capsular	VMMSE
capsuládmelos	capsular	VMMPE
capsuládselos	capsular	VMMPE
capsuládnoslos	capsular	VMMPE
capsuláoslos	capsular	VMMPE
capsuládmela	capsular	VMFSE
capsuládsela	capsular	VMFSE
capsuládnosla	capsular	VMFSE
capsuláosla	capsular	VMFSE
capsuládmelas	capsular	VMFPE
capsuládselas	capsular	VMFPE
capsuládnoslas	capsular	VMFPE
capsuláoslas	capsular	VMFPE
capsulado	capsular	VPM
capsulados	capsular	VPMP
capsulada	capsular	VPF
capsuladas	capsular	VPFP
capsulando	capsular	VG
capsulándome	capsular	VGSE
capsulándote	capsular	VGSE
capsulándole	capsular	VGSE
capsulándonos	capsular	VGPE
capsulándoos	capsular	VGPE
capsulándolo	capsular	VGMSE
capsulándola	capsular	VGFSE
capsulándolos	capsular	VGMPE
capsulándolas	capsular	VGFPE
capsulándomelo	capsular	VGMSE
capsulándotelo	capsular	VGMSE
capsulándoselo	capsular	VGMSE
capsulándonoslo	capsular	VGMSE
capsulándooslo	capsular	VGMSE
capsulándomelos	capsular	VGMPE
capsulándotelos	capsular	VGMPE
capsulándoselos	capsular	VGMPE
capsulándonoslos	capsular	VGMPE
capsulándooslos	capsular	VGMPE
capsulándomela	capsular	VGFSE
capsulándotela	capsular	VGFSE
capsulándosela	capsular	VGFSE
capsulándonosla	capsular	VGFSE
capsulándoosla	capsular	VGFSE
capsulándomelas	capsular	VGFPE
capsulándotelas	capsular	VGFPE
capsulándoselas	capsular	VGFPE
capsulándonoslas	capsular	VGFPE
capsulándooslas	capsular	VGFPE
capsulares	capsular	P
captar	captar	O
capto	captar	VIP1
captas	captar	VIP2
capta	captar	VIP3
captamos	captar	VIP4
captáis	captar	VIP5
captan	captar	VIP6
captaba	captar	VII1
captabas	captar	VII2
captábamos	captar	VII4
captabais	captar	VII5
captaban	captar	VII6
captaré	captar	VIF1
captarás	captar	VIF2
captará	captar	VIF3
captaremos	captar	VIF4
captaréis	captar	VIF5
captarán	captar	VIF6
captaría	captar	VIC1
captarías	captar	VIC2
captaría	captar	VIC3
captaríamos	captar	VIC4
captaríais	captar	VIC5
captarían	captar	VIC6
capté	captar	VIX1
captaste	captar	VIX2
captó	captar	VIX3
captasteis	captar	VIX5
captaron	captar	VIX6
capte	captar	VSP1
captes	captar	VSP2
captemos	captar	VSP4
captéis	captar	VSP5
capten	captar	VSP6
captara	captar	VSX1
captaras	captar	VSX2
captáramos	captar	VSX4
captarais	captar	VSX5
captaran	captar	VSX6
captare	captar	VSF1
captares	captar	VSF2
captáremos	captar	VSF4
captareis	captar	VSF5
captaren	captar	VSF6
captase	captar	VSI1
captases	captar	VSI2
captásemos	captar	VSI4
captaseis	captar	VSI5
captasen	captar	VSI6
captad	captar	VMP
captadme	captar	VMSE
captadle	captar	VMSE
captadnos	captar	VMPE
captaos	captar	VMPE
captadles	captar	VMPE
captadlo	captar	VMMSE
captadla	captar	VMFSE
captadlos	captar	VMMPE
captadlas	captar	VMFPE
captádmelo	captar	VMMSE
captádselo	captar	VMMSE
captádnoslo	captar	VMMSE
captáoslo	captar	VMMSE
captádmelos	captar	VMMPE
captádselos	captar	VMMPE
captádnoslos	captar	VMMPE
captáoslos	captar	VMMPE
captádmela	captar	VMFSE
captádsela	captar	VMFSE
captádnosla	captar	VMFSE
captáosla	captar	VMFSE
captádmelas	captar	VMFPE
captádselas	captar	VMFPE
captádnoslas	captar	VMFPE
captáoslas	captar	VMFPE
captado	captar	VPM
captados	captar	VPMP
captada	captar	VPF
captadas	captar	VPFP
captando	captar	VG
captándome	captar	VGSE
captándote	captar	VGSE
captándole	captar	VGSE
captándonos	captar	VGPE
captándoos	captar	VGPE
captándolo	captar	VGMSE
captándola	captar	VGFSE
captándolos	captar	VGMPE
captándolas	captar	VGFPE
captándomelo	captar	VGMSE
captándotelo	captar	VGMSE
captándoselo	captar	VGMSE
captándonoslo	captar	VGMSE
captándooslo	captar	VGMSE
captándomelos	captar	VGMPE
captándotelos	captar	VGMPE
captándoselos	captar	VGMPE
captándonoslos	captar	VGMPE
captándooslos	captar	VGMPE
captándomela	captar	VGFSE
captándotela	captar	VGFSE
captándosela	captar	VGFSE
captándonosla	captar	VGFSE
captándoosla	captar	VGFSE
captándomelas	captar	VGFPE
captándotelas	captar	VGFPE
captándoselas	captar	VGFPE
captándonoslas	captar	VGFPE
captándooslas	captar	VGFPE
captivar	captivar	O
captivo	captivar	VIP1
captivas	captivar	VIP2
captiva	captivar	VIP3
captivamos	captivar	VIP4
captiváis	captivar	VIP5
captivan	captivar	VIP6
captivaba	captivar	VII1
captivabas	captivar	VII2
captivábamos	captivar	VII4
captivabais	captivar	VII5
captivaban	captivar	VII6
captivaré	captivar	VIF1
captivarás	captivar	VIF2
captivará	captivar	VIF3
captivaremos	captivar	VIF4
captivaréis	captivar	VIF5
captivarán	captivar	VIF6
captivaría	captivar	VIC1
captivarías	captivar	VIC2
captivaría	captivar	VIC3
captivaríamos	captivar	VIC4
captivaríais	captivar	VIC5
captivarían	captivar	VIC6
captivé	captivar	VIX1
captivaste	captivar	VIX2
captivó	captivar	VIX3
captivasteis	captivar	VIX5
captivaron	captivar	VIX6
captive	captivar	VSP1
captives	captivar	VSP2
captivemos	captivar	VSP4
captivéis	captivar	VSP5
captiven	captivar	VSP6
captivara	captivar	VSX1
captivaras	captivar	VSX2
captiváramos	captivar	VSX4
captivarais	captivar	VSX5
captivaran	captivar	VSX6
captivare	captivar	VSF1
captivares	captivar	VSF2
captiváremos	captivar	VSF4
captivareis	captivar	VSF5
captivaren	captivar	VSF6
captivase	captivar	VSI1
captivases	captivar	VSI2
captivásemos	captivar	VSI4
captivaseis	captivar	VSI5
captivasen	captivar	VSI6
captivad	captivar	VMP
captivadme	captivar	VMSE
captivadle	captivar	VMSE
captivadnos	captivar	VMPE
captivaos	captivar	VMPE
captivadles	captivar	VMPE
captivadlo	captivar	VMMSE
captivadla	captivar	VMFSE
captivadlos	captivar	VMMPE
captivadlas	captivar	VMFPE
captivádmelo	captivar	VMMSE
captivádselo	captivar	VMMSE
captivádnoslo	captivar	VMMSE
captiváoslo	captivar	VMMSE
captivádmelos	captivar	VMMPE
captivádselos	captivar	VMMPE
captivádnoslos	captivar	VMMPE
captiváoslos	captivar	VMMPE
captivádmela	captivar	VMFSE
captivádsela	captivar	VMFSE
captivádnosla	captivar	VMFSE
captiváosla	captivar	VMFSE
captivádmelas	captivar	VMFPE
captivádselas	captivar	VMFPE
captivádnoslas	captivar	VMFPE
captiváoslas	captivar	VMFPE
captivado	captivar	VPM
captivados	captivar	VPMP
captivada	captivar	VPF
captivadas	captivar	VPFP
captivando	captivar	VG
captivándome	captivar	VGSE
captivándote	captivar	VGSE
captivándole	captivar	VGSE
captivándonos	captivar	VGPE
captivándoos	captivar	VGPE
captivándolo	captivar	VGMSE
captivándola	captivar	VGFSE
captivándolos	captivar	VGMPE
captivándolas	captivar	VGFPE
captivándomelo	captivar	VGMSE
captivándotelo	captivar	VGMSE
captivándoselo	captivar	VGMSE
captivándonoslo	captivar	VGMSE
captivándooslo	captivar	VGMSE
captivándomelos	captivar	VGMPE
captivándotelos	captivar	VGMPE
captivándoselos	captivar	VGMPE
captivándonoslos	captivar	VGMPE
captivándooslos	captivar	VGMPE
captivándomela	captivar	VGFSE
captivándotela	captivar	VGFSE
captivándosela	captivar	VGFSE
captivándonosla	captivar	VGFSE
captivándoosla	captivar	VGFSE
captivándomelas	captivar	VGFPE
captivándotelas	captivar	VGFPE
captivándoselas	captivar	VGFPE
captivándonoslas	captivar	VGFPE
captivándooslas	captivar	VGFPE
capturar	capturar	O
capturo	capturar	VIP1
capturas	capturar	VIP2
captura	capturar	VIP3
capturamos	capturar	VIP4
capturáis	capturar	VIP5
capturan	capturar	VIP6
capturaba	capturar	VII1
capturabas	capturar	VII2
capturábamos	capturar	VII4
capturabais	capturar	VII5
capturaban	capturar	VII6
capturaré	capturar	VIF1
capturarás	capturar	VIF2
capturará	capturar	VIF3
capturaremos	capturar	VIF4
capturaréis	capturar	VIF5
capturarán	capturar	VIF6
capturaría	capturar	VIC1
capturarías	capturar	VIC2
capturaría	capturar	VIC3
capturaríamos	capturar	VIC4
capturaríais	capturar	VIC5
capturarían	capturar	VIC6
capturé	capturar	VIX1
capturaste	capturar	VIX2
capturó	capturar	VIX3
capturasteis	capturar	VIX5
capturaron	capturar	VIX6
capture	capturar	VSP1
captures	capturar	VSP2
capturemos	capturar	VSP4
capturéis	capturar	VSP5
capturen	capturar	VSP6
capturara	capturar	VSX1
capturaras	capturar	VSX2
capturáramos	capturar	VSX4
capturarais	capturar	VSX5
capturaran	capturar	VSX6
capturare	capturar	VSF1
capturares	capturar	VSF2
capturáremos	capturar	VSF4
capturareis	capturar	VSF5
capturaren	capturar	VSF6
capturase	capturar	VSI1
capturases	capturar	VSI2
capturásemos	capturar	VSI4
capturaseis	capturar	VSI5
capturasen	capturar	VSI6
capturad	capturar	VMP
capturadme	capturar	VMSE
capturadle	capturar	VMSE
capturadnos	capturar	VMPE
capturaos	capturar	VMPE
capturadles	capturar	VMPE
capturadlo	capturar	VMMSE
capturadla	capturar	VMFSE
capturadlos	capturar	VMMPE
capturadlas	capturar	VMFPE
capturádmelo	capturar	VMMSE
capturádselo	capturar	VMMSE
capturádnoslo	capturar	VMMSE
capturáoslo	capturar	VMMSE
capturádmelos	capturar	VMMPE
capturádselos	capturar	VMMPE
capturádnoslos	capturar	VMMPE
capturáoslos	capturar	VMMPE
capturádmela	capturar	VMFSE
capturádsela	capturar	VMFSE
capturádnosla	capturar	VMFSE
capturáosla	capturar	VMFSE
capturádmelas	capturar	VMFPE
capturádselas	capturar	VMFPE
capturádnoslas	capturar	VMFPE
capturáoslas	capturar	VMFPE
capturado	capturar	VPM
capturados	capturar	VPMP
capturada	capturar	VPF
capturadas	capturar	VPFP
capturando	capturar	VG
capturándome	capturar	VGSE
capturándote	capturar	VGSE
capturándole	capturar	VGSE
capturándonos	capturar	VGPE
capturándoos	capturar	VGPE
capturándolo	capturar	VGMSE
capturándola	capturar	VGFSE
capturándolos	capturar	VGMPE
capturándolas	capturar	VGFPE
capturándomelo	capturar	VGMSE
capturándotelo	capturar	VGMSE
capturándoselo	capturar	VGMSE
capturándonoslo	capturar	VGMSE
capturándooslo	capturar	VGMSE
capturándomelos	capturar	VGMPE
capturándotelos	capturar	VGMPE
capturándoselos	capturar	VGMPE
capturándonoslos	capturar	VGMPE
capturándooslos	capturar	VGMPE
capturándomela	capturar	VGFSE
capturándotela	capturar	VGFSE
capturándosela	capturar	VGFSE
capturándonosla	capturar	VGFSE
capturándoosla	capturar	VGFSE
capturándomelas	capturar	VGFPE
capturándotelas	capturar	VGFPE
capturándoselas	capturar	VGFPE
capturándonoslas	capturar	VGFPE
capturándooslas	capturar	VGFPE
capuzar	capuzar	O
capuzo	capuzar	VIP1
capuzas	capuzar	VIP2
capuza	capuzar	VIP3
capuzamos	capuzar	VIP4
capuzáis	capuzar	VIP5
capuzan	capuzar	VIP6
capuzaba	capuzar	VII1
capuzabas	capuzar	VII2
capuzábamos	capuzar	VII4
capuzabais	capuzar	VII5
capuzaban	capuzar	VII6
capuzaré	capuzar	VIF1
capuzarás	capuzar	VIF2
capuzará	capuzar	VIF3
capuzaremos	capuzar	VIF4
capuzaréis	capuzar	VIF5
capuzarán	capuzar	VIF6
capuzaría	capuzar	VIC1
capuzarías	capuzar	VIC2
capuzaría	capuzar	VIC3
capuzaríamos	capuzar	VIC4
capuzaríais	capuzar	VIC5
capuzarían	capuzar	VIC6
capucé	capuzar	VIX1
capuzaste	capuzar	VIX2
capuzó	capuzar	VIX3
capuzasteis	capuzar	VIX5
capuzaron	capuzar	VIX6
capuce	capuzar	VSP1
capuces	capuzar	VSP2
capucemos	capuzar	VSP4
capucéis	capuzar	VSP5
capucen	capuzar	VSP6
capuzara	capuzar	VSX1
capuzaras	capuzar	VSX2
capuzáramos	capuzar	VSX4
capuzarais	capuzar	VSX5
capuzaran	capuzar	VSX6
capuzare	capuzar	VSF1
capuzares	capuzar	VSF2
capuzáremos	capuzar	VSF4
capuzareis	capuzar	VSF5
capuzaren	capuzar	VSF6
capuzase	capuzar	VSI1
capuzases	capuzar	VSI2
capuzásemos	capuzar	VSI4
capuzaseis	capuzar	VSI5
capuzasen	capuzar	VSI6
capuzad	capuzar	VMP
capuzadme	capuzar	VMSE
capuzadle	capuzar	VMSE
capuzadnos	capuzar	VMPE
capuzaos	capuzar	VMPE
capuzadles	capuzar	VMPE
capuzadlo	capuzar	VMMSE
capuzadla	capuzar	VMFSE
capuzadlos	capuzar	VMMPE
capuzadlas	capuzar	VMFPE
capuzádmelo	capuzar	VMMSE
capuzádselo	capuzar	VMMSE
capuzádnoslo	capuzar	VMMSE
capuzáoslo	capuzar	VMMSE
capuzádmelos	capuzar	VMMPE
capuzádselos	capuzar	VMMPE
capuzádnoslos	capuzar	VMMPE
capuzáoslos	capuzar	VMMPE
capuzádmela	capuzar	VMFSE
capuzádsela	capuzar	VMFSE
capuzádnosla	capuzar	VMFSE
capuzáosla	capuzar	VMFSE
capuzádmelas	capuzar	VMFPE
capuzádselas	capuzar	VMFPE
capuzádnoslas	capuzar	VMFPE
capuzáoslas	capuzar	VMFPE
capuzado	capuzar	VPM
capuzados	capuzar	VPMP
capuzada	capuzar	VPF
capuzadas	capuzar	VPFP
capuzando	capuzar	VG
capuzándome	capuzar	VGSE
capuzándote	capuzar	VGSE
capuzándole	capuzar	VGSE
capuzándonos	capuzar	VGPE
capuzándoos	capuzar	VGPE
capuzándolo	capuzar	VGMSE
capuzándola	capuzar	VGFSE
capuzándolos	capuzar	VGMPE
capuzándolas	capuzar	VGFPE
capuzándomelo	capuzar	VGMSE
capuzándotelo	capuzar	VGMSE
capuzándoselo	capuzar	VGMSE
capuzándonoslo	capuzar	VGMSE
capuzándooslo	capuzar	VGMSE
capuzándomelos	capuzar	VGMPE
capuzándotelos	capuzar	VGMPE
capuzándoselos	capuzar	VGMPE
capuzándonoslos	capuzar	VGMPE
capuzándooslos	capuzar	VGMPE
capuzándomela	capuzar	VGFSE
capuzándotela	capuzar	VGFSE
capuzándosela	capuzar	VGFSE
capuzándonosla	capuzar	VGFSE
capuzándoosla	capuzar	VGFSE
capuzándomelas	capuzar	VGFPE
capuzándotelas	capuzar	VGFPE
capuzándoselas	capuzar	VGFPE
capuzándonoslas	capuzar	VGFPE
capuzándooslas	capuzar	VGFPE
