cepa	cepa	O
cepas	cepa	P
cepadgo	cepadgo	O
cepadgos	cepadgo	P
cepazo	cepazo	O
cepazos	cepazo	P
cepeda	cepeda	O
cepedas	cepeda	P
cepejón	cepejón	O
cepejones	cepejón	P
cepellón	cepellón	O
cepellones	cepellón	P
cepera	cepera	O
ceperas	cepera	P
cepilladura	cepilladura	O
cepilladuras	cepilladura	P
cepillo	cepillo	O
cepillos	cepillo	P
cepita	cepita	O
cepitas	cepita	P
cepo	cepo	O
cepos	cepo	P
cepola	cepola	O
cepolas	cepola	P
ceporrez	ceporrez	O
ceporreces	ceporrez	P
ceporro	ceporro	O
ceporros	ceporro	P
cepote	cepote	O
cepotes	cepote	P
ceprén	ceprén	O
ceprenes	ceprén	P
ceptí	ceptí	O
ceptíes	ceptí	P
cepillar	cepillar	O
cepillo	cepillar	VIP1
cepillas	cepillar	VIP2
cepilla	cepillar	VIP3
cepillamos	cepillar	VIP4
cepilláis	cepillar	VIP5
cepillan	cepillar	VIP6
cepillaba	cepillar	VII1
cepillabas	cepillar	VII2
cepillábamos	cepillar	VII4
cepillabais	cepillar	VII5
cepillaban	cepillar	VII6
cepillaré	cepillar	VIF1
cepillarás	cepillar	VIF2
cepillará	cepillar	VIF3
cepillaremos	cepillar	VIF4
cepillaréis	cepillar	VIF5
cepillarán	cepillar	VIF6
cepillaría	cepillar	VIC1
cepillarías	cepillar	VIC2
cepillaría	cepillar	VIC3
cepillaríamos	cepillar	VIC4
cepillaríais	cepillar	VIC5
cepillarían	cepillar	VIC6
cepillé	cepillar	VIX1
cepillaste	cepillar	VIX2
cepilló	cepillar	VIX3
cepillasteis	cepillar	VIX5
cepillaron	cepillar	VIX6
cepille	cepillar	VSP1
cepilles	cepillar	VSP2
cepillemos	cepillar	VSP4
cepilléis	cepillar	VSP5
cepillen	cepillar	VSP6
cepillara	cepillar	VSX1
cepillaras	cepillar	VSX2
cepilláramos	cepillar	VSX4
cepillarais	cepillar	VSX5
cepillaran	cepillar	VSX6
cepillare	cepillar	VSF1
cepillares	cepillar	VSF2
cepilláremos	cepillar	VSF4
cepillareis	cepillar	VSF5
cepillaren	cepillar	VSF6
cepillase	cepillar	VSI1
cepillases	cepillar	VSI2
cepillásemos	cepillar	VSI4
cepillaseis	cepillar	VSI5
cepillasen	cepillar	VSI6
cepillad	cepillar	VMP
cepilladme	cepillar	VMSE
cepilladle	cepillar	VMSE
cepilladnos	cepillar	VMPE
cepillaos	cepillar	VMPE
cepilladles	cepillar	VMPE
cepilladlo	cepillar	VMMSE
cepilladla	cepillar	VMFSE
cepilladlos	cepillar	VMMPE
cepilladlas	cepillar	VMFPE
cepilládmelo	cepillar	VMMSE
cepilládselo	cepillar	VMMSE
cepilládnoslo	cepillar	VMMSE
cepilláoslo	cepillar	VMMSE
cepilládmelos	cepillar	VMMPE
cepilládselos	cepillar	VMMPE
cepilládnoslos	cepillar	VMMPE
cepilláoslos	cepillar	VMMPE
cepilládmela	cepillar	VMFSE
cepilládsela	cepillar	VMFSE
cepilládnosla	cepillar	VMFSE
cepilláosla	cepillar	VMFSE
cepilládmelas	cepillar	VMFPE
cepilládselas	cepillar	VMFPE
cepilládnoslas	cepillar	VMFPE
cepilláoslas	cepillar	VMFPE
cepillado	cepillar	VPM
cepillados	cepillar	VPMP
cepillada	cepillar	VPF
cepilladas	cepillar	VPFP
cepillando	cepillar	VG
cepillándome	cepillar	VGSE
cepillándote	cepillar	VGSE
cepillándole	cepillar	VGSE
cepillándonos	cepillar	VGPE
cepillándoos	cepillar	VGPE
cepillándolo	cepillar	VGMSE
cepillándola	cepillar	VGFSE
cepillándolos	cepillar	VGMPE
cepillándolas	cepillar	VGFPE
cepillándomelo	cepillar	VGMSE
cepillándotelo	cepillar	VGMSE
cepillándoselo	cepillar	VGMSE
cepillándonoslo	cepillar	VGMSE
cepillándooslo	cepillar	VGMSE
cepillándomelos	cepillar	VGMPE
cepillándotelos	cepillar	VGMPE
cepillándoselos	cepillar	VGMPE
cepillándonoslos	cepillar	VGMPE
cepillándooslos	cepillar	VGMPE
cepillándomela	cepillar	VGFSE
cepillándotela	cepillar	VGFSE
cepillándosela	cepillar	VGFSE
cepillándonosla	cepillar	VGFSE
cepillándoosla	cepillar	VGFSE
cepillándomelas	cepillar	VGFPE
cepillándotelas	cepillar	VGFPE
cepillándoselas	cepillar	VGFPE
cepillándonoslas	cepillar	VGFPE
cepillándooslas	cepillar	VGFPE
