cipariso	cipariso	O
ciparisos	cipariso	P
cipayo	cipayo	O
cipayos	cipayo	P
cipe	cipe	O
cipes	cipe	P
cipera	cipera	O
ciperas	cipera	P
ciperáceo	ciperáceo	O
ciperáceas	ciperáceo	FP
ciperácea	ciperáceo	F
ciperáceos	ciperáceo	P
cipión	cipión	O
cipiones	cipión	P
cipo	cipo	O
cipos	cipo	P
cipolino	cipolino	O
cipolinas	cipolino	FP
cipolina	cipolino	F
cipolinos	cipolino	P
cipotada	cipotada	O
cipotadas	cipotada	P
cipotazo	cipotazo	O
cipotazos	cipotazo	P
cipote	cipote	O
cipotes	cipote	P
cipotero	cipotero	O
cipoteros	cipotero	P
cipotón	cipotón	O
cipotones	cipotón	P
cipresal	cipresal	O
cipresales	cipresal	P
cipresillo	cipresillo	O
cipresillos	cipresillo	P
cipresino	cipresino	O
cipresinas	cipresino	FP
cipresina	cipresino	F
cipresinos	cipresino	P
ciprino	ciprino	O
ciprinas	ciprino	FP
ciprina	ciprino	F
ciprinos	ciprino	P
ciprio	ciprio	O
ciprias	ciprio	FP
cipria	ciprio	F
ciprios	ciprio	P
cipriota	cipriota	O
cipriotas	cipriota	P
ciprés	ciprés	O
cipreses	ciprés	P
cíprico	cíprico	O
cípricas	cíprico	FP
cíprica	cíprico	F
cípricos	cíprico	P
