coja	coja	O
cojas	coja	P
cojal	cojal	O
cojales	cojal	P
cojera	cojera	O
cojeras	cojera	P
cojijo	cojijo	O
cojijos	cojijo	P
cojijoso	cojijoso	O
cojijosas	cojijoso	FP
cojijosa	cojijoso	F
cojijosos	cojijoso	P
cojinete	cojinete	O
cojinetes	cojinete	P
cojinillo	cojinillo	O
cojinillos	cojinillo	P
cojinúa	cojinúa	O
cojinúas	cojinúa	P
cojitranco	cojitranco	O
cojitrancas	cojitranco	FP
cojitranca	cojitranco	F
cojitrancos	cojitranco	P
cojo	cojo	O
cojas	cojo	FP
coja	cojo	F
cojos	cojo	P
cojobo	cojobo	O
cojobos	cojobo	P
cojolite	cojolite	O
cojolites	cojolite	P
cojonudo	cojonudo	O
cojonudas	cojonudo	FP
cojonuda	cojonudo	F
cojonudos	cojonudo	P
cojudez	cojudez	O
cojudeces	cojudez	P
cojudo	cojudo	O
cojudas	cojudo	FP
cojuda	cojudo	F
cojudos	cojudo	P
cojuelo	cojuelo	O
cojuelos	cojuelo	P
cojutepequense	cojutepequense	O
cojutepequenses	cojutepequense	P
cojín	cojín	O
cojines	cojín	P
cojón	cojón	O
cojones	cojón	P
cojear	cojear	O
cojeo	cojear	VIP1
cojeas	cojear	VIP2
cojea	cojear	VIP3
cojeamos	cojear	VIP4
cojeáis	cojear	VIP5
cojean	cojear	VIP6
cojeaba	cojear	VII1
cojeabas	cojear	VII2
cojeábamos	cojear	VII4
cojeabais	cojear	VII5
cojeaban	cojear	VII6
cojearé	cojear	VIF1
cojearás	cojear	VIF2
cojeará	cojear	VIF3
cojearemos	cojear	VIF4
cojearéis	cojear	VIF5
cojearán	cojear	VIF6
cojearía	cojear	VIC1
cojearías	cojear	VIC2
cojearía	cojear	VIC3
cojearíamos	cojear	VIC4
cojearíais	cojear	VIC5
cojearían	cojear	VIC6
cojeé	cojear	VIX1
cojeaste	cojear	VIX2
cojeó	cojear	VIX3
cojeasteis	cojear	VIX5
cojearon	cojear	VIX6
cojee	cojear	VSP1
cojees	cojear	VSP2
cojeemos	cojear	VSP4
cojeéis	cojear	VSP5
cojeen	cojear	VSP6
cojeara	cojear	VSX1
cojearas	cojear	VSX2
cojeáramos	cojear	VSX4
cojearais	cojear	VSX5
cojearan	cojear	VSX6
cojeare	cojear	VSF1
cojeares	cojear	VSF2
cojeáremos	cojear	VSF4
cojeareis	cojear	VSF5
cojearen	cojear	VSF6
cojease	cojear	VSI1
cojeases	cojear	VSI2
cojeásemos	cojear	VSI4
cojeaseis	cojear	VSI5
cojeasen	cojear	VSI6
cojead	cojear	VMP
cojeadme	cojear	VMSE
cojeadle	cojear	VMSE
cojeadnos	cojear	VMPE
cojeaos	cojear	VMPE
cojeadles	cojear	VMPE
cojeado	cojear	VPM
cojeados	cojear	VPMP
cojeada	cojear	VPF
cojeadas	cojear	VPFP
cojeando	cojear	VG
cojeándome	cojear	VGSE
cojeándote	cojear	VGSE
cojeándole	cojear	VGSE
cojeándonos	cojear	VGPE
cojeándoos	cojear	VGPE
