cohabitación	cohabitación	O
cohabitaciones	cohabitación	P
cohecha	cohecha	O
cohechas	cohecha	P
cohechador	cohechador	O
cohechadoras	cohechador	FP
cohechadora	cohechador	F
cohechadores	cohechador	P
cohecho	cohecho	O
cohechos	cohecho	P
coheredero	coheredero	O
coherederas	coheredero	FP
coheredera	coheredero	F
coherederos	coheredero	P
coherencia	coherencia	O
coherencias	coherencia	P
coherente	coherente	O
coherentes	coherente	P
cohermano	cohermano	O
cohermanas	cohermano	FP
cohermana	cohermano	F
cohermanos	cohermano	P
cohesivo	cohesivo	O
cohesivas	cohesivo	FP
cohesiva	cohesivo	F
cohesivos	cohesivo	P
cohesión	cohesión	O
cohesiones	cohesión	P
cohesor	cohesor	O
cohesores	cohesor	P
cohetazo	cohetazo	O
cohetazos	cohetazo	P
cohete	cohete	O
cohetes	cohete	P
cohetera	cohetera	O
coheteras	cohetera	P
cohetero	cohetero	O
coheteros	cohetero	P
cohetería	cohetería	O
coheterías	cohetería	P
cohibición	cohibición	O
cohibiciones	cohibición	P
cohibido	cohibido	O
cohibidas	cohibido	FP
cohibida	cohibido	F
cohibidos	cohibido	P
cohobación	cohobación	O
cohobaciones	cohobación	P
cohobo	cohobo	O
cohobos	cohobo	P
cohollo	cohollo	O
cohollos	cohollo	P
cohombral	cohombral	O
cohombrales	cohombral	P
cohombrillo	cohombrillo	O
cohombrillos	cohombrillo	P
cohombro	cohombro	O
cohombros	cohombro	P
cohondimiento	cohondimiento	O
cohondimientos	cohondimiento	P
cohonestador	cohonestador	O
cohonestadoras	cohonestador	FP
cohonestadora	cohonestador	F
cohonestadores	cohonestador	P
cohorte	cohorte	O
cohortes	cohorte	P
cohíta	cohíta	O
cohítas	cohíta	P
cohibir	cohibir	O
cohíbo	cohibir	VIP1
cohibes	cohibir	VIP2
cohibe	cohibir	VIP3
cohibimos	cohibir	VIP4
cohibís	cohibir	VIP5
cohiben	cohibir	VIP6
cohibía	cohibir	VII1
cohibías	cohibir	VII2
cohibíamos	cohibir	VII4
cohibíais	cohibir	VII5
cohibían	cohibir	VII6
cohibiré	cohibir	VIF1
cohibirás	cohibir	VIF2
cohibirá	cohibir	VIF3
cohibiremos	cohibir	VIF4
cohibiréis	cohibir	VIF5
cohibirán	cohibir	VIF6
cohibiría	cohibir	VIC1
cohibirías	cohibir	VIC2
cohibiría	cohibir	VIC3
cohibiríamos	cohibir	VIC4
cohibiríais	cohibir	VIC5
cohibirían	cohibir	VIC6
cohibí	cohibir	VIX1
cohibiste	cohibir	VIX2
cohibió	cohibir	VIX3
cohibisteis	cohibir	VIX5
cohibieron	cohibir	VIX6
cohíba	cohibir	VSP1
cohíbas	cohibir	VSP2
cohibamos	cohibir	VSP4
cohibáis	cohibir	VSP5
cohíban	cohibir	VSP6
cohibiera	cohibir	VSX1
cohibieras	cohibir	VSX2
cohibiéramos	cohibir	VSX4
cohibierais	cohibir	VSX5
cohibieran	cohibir	VSX6
cohibiere	cohibir	VSF1
cohibieres	cohibir	VSF2
cohibiéremos	cohibir	VSF4
cohibiereis	cohibir	VSF5
cohibieren	cohibir	VSF6
cohibiese	cohibir	VSI1
cohibieses	cohibir	VSI2
cohibiésemos	cohibir	VSI4
cohibieseis	cohibir	VSI5
cohibiesen	cohibir	VSI6
cohibid	cohibir	VMP
cohibidme	cohibir	VMSE
cohibidle	cohibir	VMSE
cohibidnos	cohibir	VMPE
cohibios	cohibir	VMPE
cohibidles	cohibir	VMPE
cohibidlo	cohibir	VMMSE
cohibidla	cohibir	VMFSE
cohibidlos	cohibir	VMMPE
cohibidlas	cohibir	VMFPE
cohibídmelo	cohibir	VMMSE
cohibídselo	cohibir	VMMSE
cohibídnoslo	cohibir	VMMSE
cohibíoslo	cohibir	VMMSE
cohibídmelos	cohibir	VMMPE
cohibídselos	cohibir	VMMPE
cohibídnoslos	cohibir	VMMPE
cohibíoslos	cohibir	VMMPE
cohibídmela	cohibir	VMFSE
cohibídsela	cohibir	VMFSE
cohibídnosla	cohibir	VMFSE
cohibíosla	cohibir	VMFSE
cohibídmelas	cohibir	VMFPE
cohibídselas	cohibir	VMFPE
cohibídnoslas	cohibir	VMFPE
cohibíoslas	cohibir	VMFPE
cohibido	cohibir	VPM
cohibidos	cohibir	VPMP
cohibida	cohibir	VPF
cohibidas	cohibir	VPFP
cohibiendo	cohibir	VG
cohibiéndome	cohibir	VGSE
cohibiéndote	cohibir	VGSE
cohibiéndole	cohibir	VGSE
cohibiéndonos	cohibir	VGPE
cohibiéndoos	cohibir	VGPE
cohibiéndolo	cohibir	VGMSE
cohibiéndola	cohibir	VGFSE
cohibiéndolos	cohibir	VGMPE
cohibiéndolas	cohibir	VGFPE
cohibiéndomelo	cohibir	VGMSE
cohibiéndotelo	cohibir	VGMSE
cohibiéndoselo	cohibir	VGMSE
cohibiéndonoslo	cohibir	VGMSE
cohibiéndooslo	cohibir	VGMSE
cohibiéndomelos	cohibir	VGMPE
cohibiéndotelos	cohibir	VGMPE
cohibiéndoselos	cohibir	VGMPE
cohibiéndonoslos	cohibir	VGMPE
cohibiéndooslos	cohibir	VGMPE
cohibiéndomela	cohibir	VGFSE
cohibiéndotela	cohibir	VGFSE
cohibiéndosela	cohibir	VGFSE
cohibiéndonosla	cohibir	VGFSE
cohibiéndoosla	cohibir	VGFSE
cohibiéndomelas	cohibir	VGFPE
cohibiéndotelas	cohibir	VGFPE
cohibiéndoselas	cohibir	VGFPE
cohibiéndonoslas	cohibir	VGFPE
cohibiéndooslas	cohibir	VGFPE
cohonder	cohonder	O
cohondo	cohonder	VIP1
cohondes	cohonder	VIP2
cohonde	cohonder	VIP3
cohondemos	cohonder	VIP4
cohondéis	cohonder	VIP5
cohonden	cohonder	VIP6
cohondía	cohonder	VII1
cohondías	cohonder	VII2
cohondíamos	cohonder	VII4
cohondíais	cohonder	VII5
cohondían	cohonder	VII6
cohonderé	cohonder	VIF1
cohonderás	cohonder	VIF2
cohonderá	cohonder	VIF3
cohonderemos	cohonder	VIF4
cohonderéis	cohonder	VIF5
cohonderán	cohonder	VIF6
cohondería	cohonder	VIC1
cohonderías	cohonder	VIC2
cohondería	cohonder	VIC3
cohonderíamos	cohonder	VIC4
cohonderíais	cohonder	VIC5
cohonderían	cohonder	VIC6
cohondí	cohonder	VIX1
cohondiste	cohonder	VIX2
cohondió	cohonder	VIX3
cohondisteis	cohonder	VIX5
cohondieron	cohonder	VIX6
cohonda	cohonder	VSP1
cohondas	cohonder	VSP2
cohondamos	cohonder	VSP4
cohondáis	cohonder	VSP5
cohondan	cohonder	VSP6
cohondiera	cohonder	VSX1
cohondieras	cohonder	VSX2
cohondiéramos	cohonder	VSX4
cohondierais	cohonder	VSX5
cohondieran	cohonder	VSX6
cohondiere	cohonder	VSF1
cohondieres	cohonder	VSF2
cohondiéremos	cohonder	VSF4
cohondiereis	cohonder	VSF5
cohondieren	cohonder	VSF6
cohondiese	cohonder	VSI1
cohondieses	cohonder	VSI2
cohondiésemos	cohonder	VSI4
cohondieseis	cohonder	VSI5
cohondiesen	cohonder	VSI6
cohonded	cohonder	VMP
cohondedme	cohonder	VMSE
cohondedle	cohonder	VMSE
cohondednos	cohonder	VMPE
cohondeos	cohonder	VMPE
cohondedles	cohonder	VMPE
cohondedlo	cohonder	VMMSE
cohondedla	cohonder	VMFSE
cohondedlos	cohonder	VMMPE
cohondedlas	cohonder	VMFPE
cohondédmelo	cohonder	VMMSE
cohondédselo	cohonder	VMMSE
cohondédnoslo	cohonder	VMMSE
cohondéoslo	cohonder	VMMSE
cohondédmelos	cohonder	VMMPE
cohondédselos	cohonder	VMMPE
cohondédnoslos	cohonder	VMMPE
cohondéoslos	cohonder	VMMPE
cohondédmela	cohonder	VMFSE
cohondédsela	cohonder	VMFSE
cohondédnosla	cohonder	VMFSE
cohondéosla	cohonder	VMFSE
cohondédmelas	cohonder	VMFPE
cohondédselas	cohonder	VMFPE
cohondédnoslas	cohonder	VMFPE
cohondéoslas	cohonder	VMFPE
cohondido	cohonder	VPM
cohondidos	cohonder	VPMP
cohondida	cohonder	VPF
cohondidas	cohonder	VPFP
cohondiendo	cohonder	VG
cohondiéndome	cohonder	VGSE
cohondiéndote	cohonder	VGSE
cohondiéndole	cohonder	VGSE
cohondiéndonos	cohonder	VGPE
cohondiéndoos	cohonder	VGPE
cohondiéndolo	cohonder	VGMSE
cohondiéndola	cohonder	VGFSE
cohondiéndolos	cohonder	VGMPE
cohondiéndolas	cohonder	VGFPE
cohondiéndomelo	cohonder	VGMSE
cohondiéndotelo	cohonder	VGMSE
cohondiéndoselo	cohonder	VGMSE
cohondiéndonoslo	cohonder	VGMSE
cohondiéndooslo	cohonder	VGMSE
cohondiéndomelos	cohonder	VGMPE
cohondiéndotelos	cohonder	VGMPE
cohondiéndoselos	cohonder	VGMPE
cohondiéndonoslos	cohonder	VGMPE
cohondiéndooslos	cohonder	VGMPE
cohondiéndomela	cohonder	VGFSE
cohondiéndotela	cohonder	VGFSE
cohondiéndosela	cohonder	VGFSE
cohondiéndonosla	cohonder	VGFSE
cohondiéndoosla	cohonder	VGFSE
cohondiéndomelas	cohonder	VGFPE
cohondiéndotelas	cohonder	VGFPE
cohondiéndoselas	cohonder	VGFPE
cohondiéndonoslas	cohonder	VGFPE
cohondiéndooslas	cohonder	VGFPE
cohabitar	cohabitar	O
cohabito	cohabitar	VIP1
cohabitas	cohabitar	VIP2
cohabita	cohabitar	VIP3
cohabitamos	cohabitar	VIP4
cohabitáis	cohabitar	VIP5
cohabitan	cohabitar	VIP6
cohabitaba	cohabitar	VII1
cohabitabas	cohabitar	VII2
cohabitábamos	cohabitar	VII4
cohabitabais	cohabitar	VII5
cohabitaban	cohabitar	VII6
cohabitaré	cohabitar	VIF1
cohabitarás	cohabitar	VIF2
cohabitará	cohabitar	VIF3
cohabitaremos	cohabitar	VIF4
cohabitaréis	cohabitar	VIF5
cohabitarán	cohabitar	VIF6
cohabitaría	cohabitar	VIC1
cohabitarías	cohabitar	VIC2
cohabitaría	cohabitar	VIC3
cohabitaríamos	cohabitar	VIC4
cohabitaríais	cohabitar	VIC5
cohabitarían	cohabitar	VIC6
cohabité	cohabitar	VIX1
cohabitaste	cohabitar	VIX2
cohabitó	cohabitar	VIX3
cohabitasteis	cohabitar	VIX5
cohabitaron	cohabitar	VIX6
cohabite	cohabitar	VSP1
cohabites	cohabitar	VSP2
cohabitemos	cohabitar	VSP4
cohabitéis	cohabitar	VSP5
cohabiten	cohabitar	VSP6
cohabitara	cohabitar	VSX1
cohabitaras	cohabitar	VSX2
cohabitáramos	cohabitar	VSX4
cohabitarais	cohabitar	VSX5
cohabitaran	cohabitar	VSX6
cohabitare	cohabitar	VSF1
cohabitares	cohabitar	VSF2
cohabitáremos	cohabitar	VSF4
cohabitareis	cohabitar	VSF5
cohabitaren	cohabitar	VSF6
cohabitase	cohabitar	VSI1
cohabitases	cohabitar	VSI2
cohabitásemos	cohabitar	VSI4
cohabitaseis	cohabitar	VSI5
cohabitasen	cohabitar	VSI6
cohabitad	cohabitar	VMP
cohabitadme	cohabitar	VMSE
cohabitadle	cohabitar	VMSE
cohabitadnos	cohabitar	VMPE
cohabitaos	cohabitar	VMPE
cohabitadles	cohabitar	VMPE
cohabitado	cohabitar	VPM
cohabitados	cohabitar	VPMP
cohabitada	cohabitar	VPF
cohabitadas	cohabitar	VPFP
cohabitando	cohabitar	VG
cohabitándome	cohabitar	VGSE
cohabitándote	cohabitar	VGSE
cohabitándole	cohabitar	VGSE
cohabitándonos	cohabitar	VGPE
cohabitándoos	cohabitar	VGPE
cohechar	cohechar	O
cohecho	cohechar	VIP1
cohechas	cohechar	VIP2
cohecha	cohechar	VIP3
cohechamos	cohechar	VIP4
cohecháis	cohechar	VIP5
cohechan	cohechar	VIP6
cohechaba	cohechar	VII1
cohechabas	cohechar	VII2
cohechábamos	cohechar	VII4
cohechabais	cohechar	VII5
cohechaban	cohechar	VII6
cohecharé	cohechar	VIF1
cohecharás	cohechar	VIF2
cohechará	cohechar	VIF3
cohecharemos	cohechar	VIF4
cohecharéis	cohechar	VIF5
cohecharán	cohechar	VIF6
cohecharía	cohechar	VIC1
cohecharías	cohechar	VIC2
cohecharía	cohechar	VIC3
cohecharíamos	cohechar	VIC4
cohecharíais	cohechar	VIC5
cohecharían	cohechar	VIC6
coheché	cohechar	VIX1
cohechaste	cohechar	VIX2
cohechó	cohechar	VIX3
cohechasteis	cohechar	VIX5
cohecharon	cohechar	VIX6
coheche	cohechar	VSP1
coheches	cohechar	VSP2
cohechemos	cohechar	VSP4
cohechéis	cohechar	VSP5
cohechen	cohechar	VSP6
cohechara	cohechar	VSX1
cohecharas	cohechar	VSX2
cohecháramos	cohechar	VSX4
cohecharais	cohechar	VSX5
cohecharan	cohechar	VSX6
cohechare	cohechar	VSF1
cohechares	cohechar	VSF2
cohecháremos	cohechar	VSF4
cohechareis	cohechar	VSF5
cohecharen	cohechar	VSF6
cohechase	cohechar	VSI1
cohechases	cohechar	VSI2
cohechásemos	cohechar	VSI4
cohechaseis	cohechar	VSI5
cohechasen	cohechar	VSI6
cohechad	cohechar	VMP
cohechadme	cohechar	VMSE
cohechadle	cohechar	VMSE
cohechadnos	cohechar	VMPE
cohechaos	cohechar	VMPE
cohechadles	cohechar	VMPE
cohechadlo	cohechar	VMMSE
cohechadla	cohechar	VMFSE
cohechadlos	cohechar	VMMPE
cohechadlas	cohechar	VMFPE
cohechádmelo	cohechar	VMMSE
cohechádselo	cohechar	VMMSE
cohechádnoslo	cohechar	VMMSE
cohecháoslo	cohechar	VMMSE
cohechádmelos	cohechar	VMMPE
cohechádselos	cohechar	VMMPE
cohechádnoslos	cohechar	VMMPE
cohecháoslos	cohechar	VMMPE
cohechádmela	cohechar	VMFSE
cohechádsela	cohechar	VMFSE
cohechádnosla	cohechar	VMFSE
cohecháosla	cohechar	VMFSE
cohechádmelas	cohechar	VMFPE
cohechádselas	cohechar	VMFPE
cohechádnoslas	cohechar	VMFPE
cohecháoslas	cohechar	VMFPE
cohechado	cohechar	VPM
cohechados	cohechar	VPMP
cohechada	cohechar	VPF
cohechadas	cohechar	VPFP
cohechando	cohechar	VG
cohechándome	cohechar	VGSE
cohechándote	cohechar	VGSE
cohechándole	cohechar	VGSE
cohechándonos	cohechar	VGPE
cohechándoos	cohechar	VGPE
cohechándolo	cohechar	VGMSE
cohechándola	cohechar	VGFSE
cohechándolos	cohechar	VGMPE
cohechándolas	cohechar	VGFPE
cohechándomelo	cohechar	VGMSE
cohechándotelo	cohechar	VGMSE
cohechándoselo	cohechar	VGMSE
cohechándonoslo	cohechar	VGMSE
cohechándooslo	cohechar	VGMSE
cohechándomelos	cohechar	VGMPE
cohechándotelos	cohechar	VGMPE
cohechándoselos	cohechar	VGMPE
cohechándonoslos	cohechar	VGMPE
cohechándooslos	cohechar	VGMPE
cohechándomela	cohechar	VGFSE
cohechándotela	cohechar	VGFSE
cohechándosela	cohechar	VGFSE
cohechándonosla	cohechar	VGFSE
cohechándoosla	cohechar	VGFSE
cohechándomelas	cohechar	VGFPE
cohechándotelas	cohechar	VGFPE
cohechándoselas	cohechar	VGFPE
cohechándonoslas	cohechar	VGFPE
cohechándooslas	cohechar	VGFPE
coheredar	coheredar	O
coheredo	coheredar	VIP1
coheredas	coheredar	VIP2
cohereda	coheredar	VIP3
coheredamos	coheredar	VIP4
coheredáis	coheredar	VIP5
coheredan	coheredar	VIP6
coheredaba	coheredar	VII1
coheredabas	coheredar	VII2
coheredábamos	coheredar	VII4
coheredabais	coheredar	VII5
coheredaban	coheredar	VII6
coheredaré	coheredar	VIF1
coheredarás	coheredar	VIF2
coheredará	coheredar	VIF3
coheredaremos	coheredar	VIF4
coheredaréis	coheredar	VIF5
coheredarán	coheredar	VIF6
coheredaría	coheredar	VIC1
coheredarías	coheredar	VIC2
coheredaría	coheredar	VIC3
coheredaríamos	coheredar	VIC4
coheredaríais	coheredar	VIC5
coheredarían	coheredar	VIC6
coheredé	coheredar	VIX1
coheredaste	coheredar	VIX2
coheredó	coheredar	VIX3
coheredasteis	coheredar	VIX5
coheredaron	coheredar	VIX6
coherede	coheredar	VSP1
coheredes	coheredar	VSP2
coheredemos	coheredar	VSP4
coheredéis	coheredar	VSP5
cohereden	coheredar	VSP6
coheredara	coheredar	VSX1
coheredaras	coheredar	VSX2
coheredáramos	coheredar	VSX4
coheredarais	coheredar	VSX5
coheredaran	coheredar	VSX6
coheredare	coheredar	VSF1
coheredares	coheredar	VSF2
coheredáremos	coheredar	VSF4
coheredareis	coheredar	VSF5
coheredaren	coheredar	VSF6
coheredase	coheredar	VSI1
coheredases	coheredar	VSI2
coheredásemos	coheredar	VSI4
coheredaseis	coheredar	VSI5
coheredasen	coheredar	VSI6
coheredad	coheredar	VMP
coheredadme	coheredar	VMSE
coheredadle	coheredar	VMSE
coheredadnos	coheredar	VMPE
coheredaos	coheredar	VMPE
coheredadles	coheredar	VMPE
coheredadlo	coheredar	VMMSE
coheredadla	coheredar	VMFSE
coheredadlos	coheredar	VMMPE
coheredadlas	coheredar	VMFPE
coheredádmelo	coheredar	VMMSE
coheredádselo	coheredar	VMMSE
coheredádnoslo	coheredar	VMMSE
coheredáoslo	coheredar	VMMSE
coheredádmelos	coheredar	VMMPE
coheredádselos	coheredar	VMMPE
coheredádnoslos	coheredar	VMMPE
coheredáoslos	coheredar	VMMPE
coheredádmela	coheredar	VMFSE
coheredádsela	coheredar	VMFSE
coheredádnosla	coheredar	VMFSE
coheredáosla	coheredar	VMFSE
coheredádmelas	coheredar	VMFPE
coheredádselas	coheredar	VMFPE
coheredádnoslas	coheredar	VMFPE
coheredáoslas	coheredar	VMFPE
coheredado	coheredar	VPM
coheredados	coheredar	VPMP
coheredada	coheredar	VPF
coheredadas	coheredar	VPFP
coheredando	coheredar	VG
coheredándome	coheredar	VGSE
coheredándote	coheredar	VGSE
coheredándole	coheredar	VGSE
coheredándonos	coheredar	VGPE
coheredándoos	coheredar	VGPE
coheredándolo	coheredar	VGMSE
coheredándola	coheredar	VGFSE
coheredándolos	coheredar	VGMPE
coheredándolas	coheredar	VGFPE
coheredándomelo	coheredar	VGMSE
coheredándotelo	coheredar	VGMSE
coheredándoselo	coheredar	VGMSE
coheredándonoslo	coheredar	VGMSE
coheredándooslo	coheredar	VGMSE
coheredándomelos	coheredar	VGMPE
coheredándotelos	coheredar	VGMPE
coheredándoselos	coheredar	VGMPE
coheredándonoslos	coheredar	VGMPE
coheredándooslos	coheredar	VGMPE
coheredándomela	coheredar	VGFSE
coheredándotela	coheredar	VGFSE
coheredándosela	coheredar	VGFSE
coheredándonosla	coheredar	VGFSE
coheredándoosla	coheredar	VGFSE
coheredándomelas	coheredar	VGFPE
coheredándotelas	coheredar	VGFPE
coheredándoselas	coheredar	VGFPE
coheredándonoslas	coheredar	VGFPE
coheredándooslas	coheredar	VGFPE
cohobar	cohobar	O
cohobo	cohobar	VIP1
cohobas	cohobar	VIP2
cohoba	cohobar	VIP3
cohobamos	cohobar	VIP4
cohobáis	cohobar	VIP5
cohoban	cohobar	VIP6
cohobaba	cohobar	VII1
cohobabas	cohobar	VII2
cohobábamos	cohobar	VII4
cohobabais	cohobar	VII5
cohobaban	cohobar	VII6
cohobaré	cohobar	VIF1
cohobarás	cohobar	VIF2
cohobará	cohobar	VIF3
cohobaremos	cohobar	VIF4
cohobaréis	cohobar	VIF5
cohobarán	cohobar	VIF6
cohobaría	cohobar	VIC1
cohobarías	cohobar	VIC2
cohobaría	cohobar	VIC3
cohobaríamos	cohobar	VIC4
cohobaríais	cohobar	VIC5
cohobarían	cohobar	VIC6
cohobé	cohobar	VIX1
cohobaste	cohobar	VIX2
cohobó	cohobar	VIX3
cohobasteis	cohobar	VIX5
cohobaron	cohobar	VIX6
cohobe	cohobar	VSP1
cohobes	cohobar	VSP2
cohobemos	cohobar	VSP4
cohobéis	cohobar	VSP5
cohoben	cohobar	VSP6
cohobara	cohobar	VSX1
cohobaras	cohobar	VSX2
cohobáramos	cohobar	VSX4
cohobarais	cohobar	VSX5
cohobaran	cohobar	VSX6
cohobare	cohobar	VSF1
cohobares	cohobar	VSF2
cohobáremos	cohobar	VSF4
cohobareis	cohobar	VSF5
cohobaren	cohobar	VSF6
cohobase	cohobar	VSI1
cohobases	cohobar	VSI2
cohobásemos	cohobar	VSI4
cohobaseis	cohobar	VSI5
cohobasen	cohobar	VSI6
cohobad	cohobar	VMP
cohobadme	cohobar	VMSE
cohobadle	cohobar	VMSE
cohobadnos	cohobar	VMPE
cohobaos	cohobar	VMPE
cohobadles	cohobar	VMPE
cohobadlo	cohobar	VMMSE
cohobadla	cohobar	VMFSE
cohobadlos	cohobar	VMMPE
cohobadlas	cohobar	VMFPE
cohobádmelo	cohobar	VMMSE
cohobádselo	cohobar	VMMSE
cohobádnoslo	cohobar	VMMSE
cohobáoslo	cohobar	VMMSE
cohobádmelos	cohobar	VMMPE
cohobádselos	cohobar	VMMPE
cohobádnoslos	cohobar	VMMPE
cohobáoslos	cohobar	VMMPE
cohobádmela	cohobar	VMFSE
cohobádsela	cohobar	VMFSE
cohobádnosla	cohobar	VMFSE
cohobáosla	cohobar	VMFSE
cohobádmelas	cohobar	VMFPE
cohobádselas	cohobar	VMFPE
cohobádnoslas	cohobar	VMFPE
cohobáoslas	cohobar	VMFPE
cohobado	cohobar	VPM
cohobados	cohobar	VPMP
cohobada	cohobar	VPF
cohobadas	cohobar	VPFP
cohobando	cohobar	VG
cohobándome	cohobar	VGSE
cohobándote	cohobar	VGSE
cohobándole	cohobar	VGSE
cohobándonos	cohobar	VGPE
cohobándoos	cohobar	VGPE
cohobándolo	cohobar	VGMSE
cohobándola	cohobar	VGFSE
cohobándolos	cohobar	VGMPE
cohobándolas	cohobar	VGFPE
cohobándomelo	cohobar	VGMSE
cohobándotelo	cohobar	VGMSE
cohobándoselo	cohobar	VGMSE
cohobándonoslo	cohobar	VGMSE
cohobándooslo	cohobar	VGMSE
cohobándomelos	cohobar	VGMPE
cohobándotelos	cohobar	VGMPE
cohobándoselos	cohobar	VGMPE
cohobándonoslos	cohobar	VGMPE
cohobándooslos	cohobar	VGMPE
cohobándomela	cohobar	VGFSE
cohobándotela	cohobar	VGFSE
cohobándosela	cohobar	VGFSE
cohobándonosla	cohobar	VGFSE
cohobándoosla	cohobar	VGFSE
cohobándomelas	cohobar	VGFPE
cohobándotelas	cohobar	VGFPE
cohobándoselas	cohobar	VGFPE
cohobándonoslas	cohobar	VGFPE
cohobándooslas	cohobar	VGFPE
cohonestar	cohonestar	O
cohonesto	cohonestar	VIP1
cohonestas	cohonestar	VIP2
cohonesta	cohonestar	VIP3
cohonestamos	cohonestar	VIP4
cohonestáis	cohonestar	VIP5
cohonestan	cohonestar	VIP6
cohonestaba	cohonestar	VII1
cohonestabas	cohonestar	VII2
cohonestábamos	cohonestar	VII4
cohonestabais	cohonestar	VII5
cohonestaban	cohonestar	VII6
cohonestaré	cohonestar	VIF1
cohonestarás	cohonestar	VIF2
cohonestará	cohonestar	VIF3
cohonestaremos	cohonestar	VIF4
cohonestaréis	cohonestar	VIF5
cohonestarán	cohonestar	VIF6
cohonestaría	cohonestar	VIC1
cohonestarías	cohonestar	VIC2
cohonestaría	cohonestar	VIC3
cohonestaríamos	cohonestar	VIC4
cohonestaríais	cohonestar	VIC5
cohonestarían	cohonestar	VIC6
cohonesté	cohonestar	VIX1
cohonestaste	cohonestar	VIX2
cohonestó	cohonestar	VIX3
cohonestasteis	cohonestar	VIX5
cohonestaron	cohonestar	VIX6
cohoneste	cohonestar	VSP1
cohonestes	cohonestar	VSP2
cohonestemos	cohonestar	VSP4
cohonestéis	cohonestar	VSP5
cohonesten	cohonestar	VSP6
cohonestara	cohonestar	VSX1
cohonestaras	cohonestar	VSX2
cohonestáramos	cohonestar	VSX4
cohonestarais	cohonestar	VSX5
cohonestaran	cohonestar	VSX6
cohonestare	cohonestar	VSF1
cohonestares	cohonestar	VSF2
cohonestáremos	cohonestar	VSF4
cohonestareis	cohonestar	VSF5
cohonestaren	cohonestar	VSF6
cohonestase	cohonestar	VSI1
cohonestases	cohonestar	VSI2
cohonestásemos	cohonestar	VSI4
cohonestaseis	cohonestar	VSI5
cohonestasen	cohonestar	VSI6
cohonestad	cohonestar	VMP
cohonestadme	cohonestar	VMSE
cohonestadle	cohonestar	VMSE
cohonestadnos	cohonestar	VMPE
cohonestaos	cohonestar	VMPE
cohonestadles	cohonestar	VMPE
cohonestadlo	cohonestar	VMMSE
cohonestadla	cohonestar	VMFSE
cohonestadlos	cohonestar	VMMPE
cohonestadlas	cohonestar	VMFPE
cohonestádmelo	cohonestar	VMMSE
cohonestádselo	cohonestar	VMMSE
cohonestádnoslo	cohonestar	VMMSE
cohonestáoslo	cohonestar	VMMSE
cohonestádmelos	cohonestar	VMMPE
cohonestádselos	cohonestar	VMMPE
cohonestádnoslos	cohonestar	VMMPE
cohonestáoslos	cohonestar	VMMPE
cohonestádmela	cohonestar	VMFSE
cohonestádsela	cohonestar	VMFSE
cohonestádnosla	cohonestar	VMFSE
cohonestáosla	cohonestar	VMFSE
cohonestádmelas	cohonestar	VMFPE
cohonestádselas	cohonestar	VMFPE
cohonestádnoslas	cohonestar	VMFPE
cohonestáoslas	cohonestar	VMFPE
cohonestado	cohonestar	VPM
cohonestados	cohonestar	VPMP
cohonestada	cohonestar	VPF
cohonestadas	cohonestar	VPFP
cohonestando	cohonestar	VG
cohonestándome	cohonestar	VGSE
cohonestándote	cohonestar	VGSE
cohonestándole	cohonestar	VGSE
cohonestándonos	cohonestar	VGPE
cohonestándoos	cohonestar	VGPE
cohonestándolo	cohonestar	VGMSE
cohonestándola	cohonestar	VGFSE
cohonestándolos	cohonestar	VGMPE
cohonestándolas	cohonestar	VGFPE
cohonestándomelo	cohonestar	VGMSE
cohonestándotelo	cohonestar	VGMSE
cohonestándoselo	cohonestar	VGMSE
cohonestándonoslo	cohonestar	VGMSE
cohonestándooslo	cohonestar	VGMSE
cohonestándomelos	cohonestar	VGMPE
cohonestándotelos	cohonestar	VGMPE
cohonestándoselos	cohonestar	VGMPE
cohonestándonoslos	cohonestar	VGMPE
cohonestándooslos	cohonestar	VGMPE
cohonestándomela	cohonestar	VGFSE
cohonestándotela	cohonestar	VGFSE
cohonestándosela	cohonestar	VGFSE
cohonestándonosla	cohonestar	VGFSE
cohonestándoosla	cohonestar	VGFSE
cohonestándomelas	cohonestar	VGFPE
cohonestándotelas	cohonestar	VGFPE
cohonestándoselas	cohonestar	VGFPE
cohonestándonoslas	cohonestar	VGFPE
cohonestándooslas	cohonestar	VGFPE
