cueca	cueca	O
cuecas	cueca	P
cueco	cueco	O
cuecos	cueco	P
cuelga	cuelga	O
cuelgas	cuelga	P
cuelgacapas	cuelgacapas	O
cuelgaplatos	cuelgaplatos	O
cuelgue	cuelgue	O
cuelgues	cuelgue	P
cuellicorto	cuellicorto	O
cuellicortas	cuellicorto	FP
cuellicorta	cuellicorto	F
cuellicortos	cuellicorto	P
cuellidegollado	cuellidegollado	O
cuellidegolladas	cuellidegollado	FP
cuellidegollada	cuellidegollado	F
cuellidegollados	cuellidegollado	P
cuellierguido	cuellierguido	O
cuellierguidas	cuellierguido	FP
cuellierguida	cuellierguido	F
cuellierguidos	cuellierguido	P
cuellilargo	cuellilargo	O
cuellilargas	cuellilargo	FP
cuellilarga	cuellilargo	F
cuellilargos	cuellilargo	P
cuello	cuello	O
cuellos	cuello	P
cuelmo	cuelmo	O
cuelmos	cuelmo	P
cuenca	cuenca	O
cuencas	cuenca	P
cuencano	cuencano	O
cuencanas	cuencano	FP
cuencana	cuencano	F
cuencanos	cuencano	P
cuenco	cuenco	O
cuencos	cuenco	P
cuenda	cuenda	O
cuendas	cuenda	P
cuenta	cuenta	O
cuentas	cuenta	P
cuentacacao	cuentacacao	O
cuentacacaos	cuentacacao	P
cuentachiles	cuentachiles	O
cuentacorrentista	cuentacorrentista	O
cuentacorrentistas	cuentacorrentista	P
cuentadante	cuentadante	O
cuentadantes	cuentadante	P
cuentagotas	cuentagotas	O
cuentahílos	cuentahílos	O
cuentakilómetros	cuentakilómetros	O
cuentapasos	cuentapasos	O
cuentero	cuentero	O
cuenteras	cuentero	FP
cuentera	cuentero	F
cuenteros	cuentero	P
cuentista	cuentista	O
cuentistas	cuentista	P
cuento	cuento	O
cuentos	cuento	P
cuentístico	cuentístico	O
cuentísticas	cuentístico	FP
cuentística	cuentístico	F
cuentísticos	cuentístico	P
cuentón	cuentón	O
cuentonas	cuentón	FP
cuentona	cuentón	F
cuentones	cuentón	P
cuera	cuera	O
cueras	cuera	P
cuerazo	cuerazo	O
cuerazos	cuerazo	P
cuerda	cuerda	O
cuerdas	cuerda	P
cuerdamente	cuerdamente	O
cuerdo	cuerdo	O
cuerdas	cuerdo	FP
cuerda	cuerdo	F
cuerdos	cuerdo	P
cuereada	cuereada	O
cuereadas	cuereada	P
cuerezuelo	cuerezuelo	O
cuerezuelos	cuerezuelo	P
cueriza	cueriza	O
cuerizas	cueriza	P
cuerna	cuerna	O
cuernas	cuerna	P
cuernavaquense	cuernavaquense	O
cuernavaquenses	cuernavaquense	P
cuernezuelo	cuernezuelo	O
cuernezuelos	cuernezuelo	P
cuerno	cuerno	O
cuernos	cuerno	P
cuero	cuero	O
cueros	cuero	P
cuerpo	cuerpo	O
cuerpos	cuerpo	P
cuerria	cuerria	O
cuerrias	cuerria	P
cuerudo	cuerudo	O
cuerudas	cuerudo	FP
cueruda	cuerudo	F
cuerudos	cuerudo	P
cuerva	cuerva	O
cuervas	cuerva	P
cuervera	cuervera	O
cuerveras	cuervera	P
cuervo	cuervo	O
cuervos	cuervo	P
cuesco	cuesco	O
cuescos	cuesco	P
cuesta	cuesta	O
cuestas	cuesta	P
cuestación	cuestación	O
cuestaciones	cuestación	P
cuestionable	cuestionable	O
cuestionables	cuestionable	P
cuestionamiento	cuestionamiento	O
cuestionamientos	cuestionamiento	P
cuestionario	cuestionario	O
cuestionarios	cuestionario	P
cuestión	cuestión	O
cuestiones	cuestión	P
cuesto	cuesto	O
cuestos	cuesto	P
cuestor	cuestor	O
cuestores	cuestor	P
cuestuario	cuestuario	O
cuestuarias	cuestuario	FP
cuestuaria	cuestuario	F
cuestuarios	cuestuario	P
cuestuoso	cuestuoso	O
cuestuosas	cuestuoso	FP
cuestuosa	cuestuoso	F
cuestuosos	cuestuoso	P
cuestura	cuestura	O
cuesturas	cuestura	P
cuete	cuete	O
cuetes	cuete	P
cueto	cueto	O
cuetos	cueto	P
cueva	cueva	O
cuevas	cueva	P
cuevero	cuevero	O
cueveros	cuevero	P
cuexca	cuexca	O
cuexcas	cuexca	P
cueza	cueza	O
cuezas	cueza	P
cuezo	cuezo	O
cuezos	cuezo	P
cuélebre	cuélebre	O
cuélebres	cuélebre	P
cuérnago	cuérnago	O
cuérnagos	cuérnago	P
cuérrago	cuérrago	O
cuérragos	cuérrago	P
cuétano	cuétano	O
cuétanos	cuétano	P
cuévano	cuévano	O
cuévanos	cuévano	P
cueco	cocer	VIP1
cueces	cocer	VIP2
cuece	cocer	VIP3
cuecen	cocer	VIP6
cueca	cocer	VSP1
cuecas	cocer	VSP2
cuecan	cocer	VSP6
cuelo	colar	VIP1
cuelas	colar	VIP2
cuela	colar	VIP3
cuelan	colar	VIP6
cuele	colar	VSP1
cueles	colar	VSP2
cuelen	colar	VSP6
cuelgo	colgar	VIP1
cuelgas	colgar	VIP2
cuelga	colgar	VIP3
cuelgan	colgar	VIP6
cuelgue	colgar	VSP1
cuelgues	colgar	VSP2
cuelguen	colgar	VSP6
cuento	contar	VIP1
cuentas	contar	VIP2
cuenta	contar	VIP3
cuentan	contar	VIP6
cuente	contar	VSP1
cuentes	contar	VSP2
cuenten	contar	VSP6
cuesto	costar	VIP1
cuestas	costar	VIP2
cuesta	costar	VIP3
cuestan	costar	VIP6
cueste	costar	VSP1
cuestes	costar	VSP2
cuesten	costar	VSP6
cuentear	cuentear	O
cuenteo	cuentear	VIP1
cuenteas	cuentear	VIP2
cuentea	cuentear	VIP3
cuenteamos	cuentear	VIP4
cuenteáis	cuentear	VIP5
cuentean	cuentear	VIP6
cuenteaba	cuentear	VII1
cuenteabas	cuentear	VII2
cuenteábamos	cuentear	VII4
cuenteabais	cuentear	VII5
cuenteaban	cuentear	VII6
cuentearé	cuentear	VIF1
cuentearás	cuentear	VIF2
cuenteará	cuentear	VIF3
cuentearemos	cuentear	VIF4
cuentearéis	cuentear	VIF5
cuentearán	cuentear	VIF6
cuentearía	cuentear	VIC1
cuentearías	cuentear	VIC2
cuentearía	cuentear	VIC3
cuentearíamos	cuentear	VIC4
cuentearíais	cuentear	VIC5
cuentearían	cuentear	VIC6
cuenteé	cuentear	VIX1
cuenteaste	cuentear	VIX2
cuenteó	cuentear	VIX3
cuenteasteis	cuentear	VIX5
cuentearon	cuentear	VIX6
cuentee	cuentear	VSP1
cuentees	cuentear	VSP2
cuenteemos	cuentear	VSP4
cuenteéis	cuentear	VSP5
cuenteen	cuentear	VSP6
cuenteara	cuentear	VSX1
cuentearas	cuentear	VSX2
cuenteáramos	cuentear	VSX4
cuentearais	cuentear	VSX5
cuentearan	cuentear	VSX6
cuenteare	cuentear	VSF1
cuenteares	cuentear	VSF2
cuenteáremos	cuentear	VSF4
cuenteareis	cuentear	VSF5
cuentearen	cuentear	VSF6
cuentease	cuentear	VSI1
cuenteases	cuentear	VSI2
cuenteásemos	cuentear	VSI4
cuenteaseis	cuentear	VSI5
cuenteasen	cuentear	VSI6
cuentead	cuentear	VMP
cuenteadme	cuentear	VMSE
cuenteadle	cuentear	VMSE
cuenteadnos	cuentear	VMPE
cuenteaos	cuentear	VMPE
cuenteadles	cuentear	VMPE
cuenteadlo	cuentear	VMMSE
cuenteadla	cuentear	VMFSE
cuenteadlos	cuentear	VMMPE
cuenteadlas	cuentear	VMFPE
cuenteádmelo	cuentear	VMMSE
cuenteádselo	cuentear	VMMSE
cuenteádnoslo	cuentear	VMMSE
cuenteáoslo	cuentear	VMMSE
cuenteádmelos	cuentear	VMMPE
cuenteádselos	cuentear	VMMPE
cuenteádnoslos	cuentear	VMMPE
cuenteáoslos	cuentear	VMMPE
cuenteádmela	cuentear	VMFSE
cuenteádsela	cuentear	VMFSE
cuenteádnosla	cuentear	VMFSE
cuenteáosla	cuentear	VMFSE
cuenteádmelas	cuentear	VMFPE
cuenteádselas	cuentear	VMFPE
cuenteádnoslas	cuentear	VMFPE
cuenteáoslas	cuentear	VMFPE
cuenteado	cuentear	VPM
cuenteados	cuentear	VPMP
cuenteada	cuentear	VPF
cuenteadas	cuentear	VPFP
cuenteando	cuentear	VG
cuenteándome	cuentear	VGSE
cuenteándote	cuentear	VGSE
cuenteándole	cuentear	VGSE
cuenteándonos	cuentear	VGPE
cuenteándoos	cuentear	VGPE
cuenteándolo	cuentear	VGMSE
cuenteándola	cuentear	VGFSE
cuenteándolos	cuentear	VGMPE
cuenteándolas	cuentear	VGFPE
cuenteándomelo	cuentear	VGMSE
cuenteándotelo	cuentear	VGMSE
cuenteándoselo	cuentear	VGMSE
cuenteándonoslo	cuentear	VGMSE
cuenteándooslo	cuentear	VGMSE
cuenteándomelos	cuentear	VGMPE
cuenteándotelos	cuentear	VGMPE
cuenteándoselos	cuentear	VGMPE
cuenteándonoslos	cuentear	VGMPE
cuenteándooslos	cuentear	VGMPE
cuenteándomela	cuentear	VGFSE
cuenteándotela	cuentear	VGFSE
cuenteándosela	cuentear	VGFSE
cuenteándonosla	cuentear	VGFSE
cuenteándoosla	cuentear	VGFSE
cuenteándomelas	cuentear	VGFPE
cuenteándotelas	cuentear	VGFPE
cuenteándoselas	cuentear	VGFPE
cuenteándonoslas	cuentear	VGFPE
cuenteándooslas	cuentear	VGFPE
cuerear	cuerear	O
cuereo	cuerear	VIP1
cuereas	cuerear	VIP2
cuerea	cuerear	VIP3
cuereamos	cuerear	VIP4
cuereáis	cuerear	VIP5
cuerean	cuerear	VIP6
cuereaba	cuerear	VII1
cuereabas	cuerear	VII2
cuereábamos	cuerear	VII4
cuereabais	cuerear	VII5
cuereaban	cuerear	VII6
cuerearé	cuerear	VIF1
cuerearás	cuerear	VIF2
cuereará	cuerear	VIF3
cuerearemos	cuerear	VIF4
cuerearéis	cuerear	VIF5
cuerearán	cuerear	VIF6
cuerearía	cuerear	VIC1
cuerearías	cuerear	VIC2
cuerearía	cuerear	VIC3
cuerearíamos	cuerear	VIC4
cuerearíais	cuerear	VIC5
cuerearían	cuerear	VIC6
cuereé	cuerear	VIX1
cuereaste	cuerear	VIX2
cuereó	cuerear	VIX3
cuereasteis	cuerear	VIX5
cuerearon	cuerear	VIX6
cueree	cuerear	VSP1
cuerees	cuerear	VSP2
cuereemos	cuerear	VSP4
cuereéis	cuerear	VSP5
cuereen	cuerear	VSP6
cuereara	cuerear	VSX1
cuerearas	cuerear	VSX2
cuereáramos	cuerear	VSX4
cuerearais	cuerear	VSX5
cuerearan	cuerear	VSX6
cuereare	cuerear	VSF1
cuereares	cuerear	VSF2
cuereáremos	cuerear	VSF4
cuereareis	cuerear	VSF5
cuerearen	cuerear	VSF6
cuerease	cuerear	VSI1
cuereases	cuerear	VSI2
cuereásemos	cuerear	VSI4
cuereaseis	cuerear	VSI5
cuereasen	cuerear	VSI6
cueread	cuerear	VMP
cuereadme	cuerear	VMSE
cuereadle	cuerear	VMSE
cuereadnos	cuerear	VMPE
cuereaos	cuerear	VMPE
cuereadles	cuerear	VMPE
cuereadlo	cuerear	VMMSE
cuereadla	cuerear	VMFSE
cuereadlos	cuerear	VMMPE
cuereadlas	cuerear	VMFPE
cuereádmelo	cuerear	VMMSE
cuereádselo	cuerear	VMMSE
cuereádnoslo	cuerear	VMMSE
cuereáoslo	cuerear	VMMSE
cuereádmelos	cuerear	VMMPE
cuereádselos	cuerear	VMMPE
cuereádnoslos	cuerear	VMMPE
cuereáoslos	cuerear	VMMPE
cuereádmela	cuerear	VMFSE
cuereádsela	cuerear	VMFSE
cuereádnosla	cuerear	VMFSE
cuereáosla	cuerear	VMFSE
cuereádmelas	cuerear	VMFPE
cuereádselas	cuerear	VMFPE
cuereádnoslas	cuerear	VMFPE
cuereáoslas	cuerear	VMFPE
cuereado	cuerear	VPM
cuereados	cuerear	VPMP
cuereada	cuerear	VPF
cuereadas	cuerear	VPFP
cuereando	cuerear	VG
cuereándome	cuerear	VGSE
cuereándote	cuerear	VGSE
cuereándole	cuerear	VGSE
cuereándonos	cuerear	VGPE
cuereándoos	cuerear	VGPE
cuereándolo	cuerear	VGMSE
cuereándola	cuerear	VGFSE
cuereándolos	cuerear	VGMPE
cuereándolas	cuerear	VGFPE
cuereándomelo	cuerear	VGMSE
cuereándotelo	cuerear	VGMSE
cuereándoselo	cuerear	VGMSE
cuereándonoslo	cuerear	VGMSE
cuereándooslo	cuerear	VGMSE
cuereándomelos	cuerear	VGMPE
cuereándotelos	cuerear	VGMPE
cuereándoselos	cuerear	VGMPE
cuereándonoslos	cuerear	VGMPE
cuereándooslos	cuerear	VGMPE
cuereándomela	cuerear	VGFSE
cuereándotela	cuerear	VGFSE
cuereándosela	cuerear	VGFSE
cuereándonosla	cuerear	VGFSE
cuereándoosla	cuerear	VGFSE
cuereándomelas	cuerear	VGFPE
cuereándotelas	cuerear	VGFPE
cuereándoselas	cuerear	VGFPE
cuereándonoslas	cuerear	VGFPE
cuereándooslas	cuerear	VGFPE
cuerpear	cuerpear	O
cuerpeo	cuerpear	VIP1
cuerpeas	cuerpear	VIP2
cuerpea	cuerpear	VIP3
cuerpeamos	cuerpear	VIP4
cuerpeáis	cuerpear	VIP5
cuerpean	cuerpear	VIP6
cuerpeaba	cuerpear	VII1
cuerpeabas	cuerpear	VII2
cuerpeábamos	cuerpear	VII4
cuerpeabais	cuerpear	VII5
cuerpeaban	cuerpear	VII6
cuerpearé	cuerpear	VIF1
cuerpearás	cuerpear	VIF2
cuerpeará	cuerpear	VIF3
cuerpearemos	cuerpear	VIF4
cuerpearéis	cuerpear	VIF5
cuerpearán	cuerpear	VIF6
cuerpearía	cuerpear	VIC1
cuerpearías	cuerpear	VIC2
cuerpearía	cuerpear	VIC3
cuerpearíamos	cuerpear	VIC4
cuerpearíais	cuerpear	VIC5
cuerpearían	cuerpear	VIC6
cuerpeé	cuerpear	VIX1
cuerpeaste	cuerpear	VIX2
cuerpeó	cuerpear	VIX3
cuerpeasteis	cuerpear	VIX5
cuerpearon	cuerpear	VIX6
cuerpee	cuerpear	VSP1
cuerpees	cuerpear	VSP2
cuerpeemos	cuerpear	VSP4
cuerpeéis	cuerpear	VSP5
cuerpeen	cuerpear	VSP6
cuerpeara	cuerpear	VSX1
cuerpearas	cuerpear	VSX2
cuerpeáramos	cuerpear	VSX4
cuerpearais	cuerpear	VSX5
cuerpearan	cuerpear	VSX6
cuerpeare	cuerpear	VSF1
cuerpeares	cuerpear	VSF2
cuerpeáremos	cuerpear	VSF4
cuerpeareis	cuerpear	VSF5
cuerpearen	cuerpear	VSF6
cuerpease	cuerpear	VSI1
cuerpeases	cuerpear	VSI2
cuerpeásemos	cuerpear	VSI4
cuerpeaseis	cuerpear	VSI5
cuerpeasen	cuerpear	VSI6
cuerpead	cuerpear	VMP
cuerpeadme	cuerpear	VMSE
cuerpeadle	cuerpear	VMSE
cuerpeadnos	cuerpear	VMPE
cuerpeaos	cuerpear	VMPE
cuerpeadles	cuerpear	VMPE
cuerpeadlo	cuerpear	VMMSE
cuerpeadla	cuerpear	VMFSE
cuerpeadlos	cuerpear	VMMPE
cuerpeadlas	cuerpear	VMFPE
cuerpeádmelo	cuerpear	VMMSE
cuerpeádselo	cuerpear	VMMSE
cuerpeádnoslo	cuerpear	VMMSE
cuerpeáoslo	cuerpear	VMMSE
cuerpeádmelos	cuerpear	VMMPE
cuerpeádselos	cuerpear	VMMPE
cuerpeádnoslos	cuerpear	VMMPE
cuerpeáoslos	cuerpear	VMMPE
cuerpeádmela	cuerpear	VMFSE
cuerpeádsela	cuerpear	VMFSE
cuerpeádnosla	cuerpear	VMFSE
cuerpeáosla	cuerpear	VMFSE
cuerpeádmelas	cuerpear	VMFPE
cuerpeádselas	cuerpear	VMFPE
cuerpeádnoslas	cuerpear	VMFPE
cuerpeáoslas	cuerpear	VMFPE
cuerpeado	cuerpear	VPM
cuerpeados	cuerpear	VPMP
cuerpeada	cuerpear	VPF
cuerpeadas	cuerpear	VPFP
cuerpeando	cuerpear	VG
cuerpeándome	cuerpear	VGSE
cuerpeándote	cuerpear	VGSE
cuerpeándole	cuerpear	VGSE
cuerpeándonos	cuerpear	VGPE
cuerpeándoos	cuerpear	VGPE
cuerpeándolo	cuerpear	VGMSE
cuerpeándola	cuerpear	VGFSE
cuerpeándolos	cuerpear	VGMPE
cuerpeándolas	cuerpear	VGFPE
cuerpeándomelo	cuerpear	VGMSE
cuerpeándotelo	cuerpear	VGMSE
cuerpeándoselo	cuerpear	VGMSE
cuerpeándonoslo	cuerpear	VGMSE
cuerpeándooslo	cuerpear	VGMSE
cuerpeándomelos	cuerpear	VGMPE
cuerpeándotelos	cuerpear	VGMPE
cuerpeándoselos	cuerpear	VGMPE
cuerpeándonoslos	cuerpear	VGMPE
cuerpeándooslos	cuerpear	VGMPE
cuerpeándomela	cuerpear	VGFSE
cuerpeándotela	cuerpear	VGFSE
cuerpeándosela	cuerpear	VGFSE
cuerpeándonosla	cuerpear	VGFSE
cuerpeándoosla	cuerpear	VGFSE
cuerpeándomelas	cuerpear	VGFPE
cuerpeándotelas	cuerpear	VGFPE
cuerpeándoselas	cuerpear	VGFPE
cuerpeándonoslas	cuerpear	VGFPE
cuerpeándooslas	cuerpear	VGFPE
cuestionar	cuestionar	O
cuestiono	cuestionar	VIP1
cuestionas	cuestionar	VIP2
cuestiona	cuestionar	VIP3
cuestionamos	cuestionar	VIP4
cuestionáis	cuestionar	VIP5
cuestionan	cuestionar	VIP6
cuestionaba	cuestionar	VII1
cuestionabas	cuestionar	VII2
cuestionábamos	cuestionar	VII4
cuestionabais	cuestionar	VII5
cuestionaban	cuestionar	VII6
cuestionaré	cuestionar	VIF1
cuestionarás	cuestionar	VIF2
cuestionará	cuestionar	VIF3
cuestionaremos	cuestionar	VIF4
cuestionaréis	cuestionar	VIF5
cuestionarán	cuestionar	VIF6
cuestionaría	cuestionar	VIC1
cuestionarías	cuestionar	VIC2
cuestionaría	cuestionar	VIC3
cuestionaríamos	cuestionar	VIC4
cuestionaríais	cuestionar	VIC5
cuestionarían	cuestionar	VIC6
cuestioné	cuestionar	VIX1
cuestionaste	cuestionar	VIX2
cuestionó	cuestionar	VIX3
cuestionasteis	cuestionar	VIX5
cuestionaron	cuestionar	VIX6
cuestione	cuestionar	VSP1
cuestiones	cuestionar	VSP2
cuestionemos	cuestionar	VSP4
cuestionéis	cuestionar	VSP5
cuestionen	cuestionar	VSP6
cuestionara	cuestionar	VSX1
cuestionaras	cuestionar	VSX2
cuestionáramos	cuestionar	VSX4
cuestionarais	cuestionar	VSX5
cuestionaran	cuestionar	VSX6
cuestionare	cuestionar	VSF1
cuestionares	cuestionar	VSF2
cuestionáremos	cuestionar	VSF4
cuestionareis	cuestionar	VSF5
cuestionaren	cuestionar	VSF6
cuestionase	cuestionar	VSI1
cuestionases	cuestionar	VSI2
cuestionásemos	cuestionar	VSI4
cuestionaseis	cuestionar	VSI5
cuestionasen	cuestionar	VSI6
cuestionad	cuestionar	VMP
cuestionadme	cuestionar	VMSE
cuestionadle	cuestionar	VMSE
cuestionadnos	cuestionar	VMPE
cuestionaos	cuestionar	VMPE
cuestionadles	cuestionar	VMPE
cuestionadlo	cuestionar	VMMSE
cuestionadla	cuestionar	VMFSE
cuestionadlos	cuestionar	VMMPE
cuestionadlas	cuestionar	VMFPE
cuestionádmelo	cuestionar	VMMSE
cuestionádselo	cuestionar	VMMSE
cuestionádnoslo	cuestionar	VMMSE
cuestionáoslo	cuestionar	VMMSE
cuestionádmelos	cuestionar	VMMPE
cuestionádselos	cuestionar	VMMPE
cuestionádnoslos	cuestionar	VMMPE
cuestionáoslos	cuestionar	VMMPE
cuestionádmela	cuestionar	VMFSE
cuestionádsela	cuestionar	VMFSE
cuestionádnosla	cuestionar	VMFSE
cuestionáosla	cuestionar	VMFSE
cuestionádmelas	cuestionar	VMFPE
cuestionádselas	cuestionar	VMFPE
cuestionádnoslas	cuestionar	VMFPE
cuestionáoslas	cuestionar	VMFPE
cuestionado	cuestionar	VPM
cuestionados	cuestionar	VPMP
cuestionada	cuestionar	VPF
cuestionadas	cuestionar	VPFP
cuestionando	cuestionar	VG
cuestionándome	cuestionar	VGSE
cuestionándote	cuestionar	VGSE
cuestionándole	cuestionar	VGSE
cuestionándonos	cuestionar	VGPE
cuestionándoos	cuestionar	VGPE
cuestionándolo	cuestionar	VGMSE
cuestionándola	cuestionar	VGFSE
cuestionándolos	cuestionar	VGMPE
cuestionándolas	cuestionar	VGFPE
cuestionándomelo	cuestionar	VGMSE
cuestionándotelo	cuestionar	VGMSE
cuestionándoselo	cuestionar	VGMSE
cuestionándonoslo	cuestionar	VGMSE
cuestionándooslo	cuestionar	VGMSE
cuestionándomelos	cuestionar	VGMPE
cuestionándotelos	cuestionar	VGMPE
cuestionándoselos	cuestionar	VGMPE
cuestionándonoslos	cuestionar	VGMPE
cuestionándooslos	cuestionar	VGMPE
cuestionándomela	cuestionar	VGFSE
cuestionándotela	cuestionar	VGFSE
cuestionándosela	cuestionar	VGFSE
cuestionándonosla	cuestionar	VGFSE
cuestionándoosla	cuestionar	VGFSE
cuestionándomelas	cuestionar	VGFPE
cuestionándotelas	cuestionar	VGFPE
cuestionándoselas	cuestionar	VGFPE
cuestionándonoslas	cuestionar	VGFPE
cuestionándooslas	cuestionar	VGFPE
