dea	dea	O
deas	dea	P
deal	deal	O
deales	deal	P
deambulación	deambulación	O
deambulaciones	deambulación	P
deambulatorio	deambulatorio	O
deambulatorios	deambulatorio	P
deanato	deanato	O
deanatos	deanato	P
deanazgo	deanazgo	O
deanazgos	deanazgo	P
deán	deán	O
deanes	deán	P
deambular	deambular	O
deambulo	deambular	VIP1
deambulas	deambular	VIP2
deambula	deambular	VIP3
deambulamos	deambular	VIP4
deambuláis	deambular	VIP5
deambulan	deambular	VIP6
deambulaba	deambular	VII1
deambulabas	deambular	VII2
deambulábamos	deambular	VII4
deambulabais	deambular	VII5
deambulaban	deambular	VII6
deambularé	deambular	VIF1
deambularás	deambular	VIF2
deambulará	deambular	VIF3
deambularemos	deambular	VIF4
deambularéis	deambular	VIF5
deambularán	deambular	VIF6
deambularía	deambular	VIC1
deambularías	deambular	VIC2
deambularía	deambular	VIC3
deambularíamos	deambular	VIC4
deambularíais	deambular	VIC5
deambularían	deambular	VIC6
deambulé	deambular	VIX1
deambulaste	deambular	VIX2
deambuló	deambular	VIX3
deambulasteis	deambular	VIX5
deambularon	deambular	VIX6
deambule	deambular	VSP1
deambules	deambular	VSP2
deambulemos	deambular	VSP4
deambuléis	deambular	VSP5
deambulen	deambular	VSP6
deambulara	deambular	VSX1
deambularas	deambular	VSX2
deambuláramos	deambular	VSX4
deambularais	deambular	VSX5
deambularan	deambular	VSX6
deambulare	deambular	VSF1
deambulares	deambular	VSF2
deambuláremos	deambular	VSF4
deambulareis	deambular	VSF5
deambularen	deambular	VSF6
deambulase	deambular	VSI1
deambulases	deambular	VSI2
deambulásemos	deambular	VSI4
deambulaseis	deambular	VSI5
deambulasen	deambular	VSI6
deambulad	deambular	VMP
deambuladme	deambular	VMSE
deambuladle	deambular	VMSE
deambuladnos	deambular	VMPE
deambulaos	deambular	VMPE
deambuladles	deambular	VMPE
deambulado	deambular	VPM
deambulados	deambular	VPMP
deambulada	deambular	VPF
deambuladas	deambular	VPFP
deambulando	deambular	VG
deambulándome	deambular	VGSE
deambulándote	deambular	VGSE
deambulándole	deambular	VGSE
deambulándonos	deambular	VGPE
deambulándoos	deambular	VGPE
