diocesano	diocesano	O
diocesanas	diocesano	FP
diocesana	diocesano	F
diocesanos	diocesano	P
diodo	diodo	O
diodos	diodo	P
dioico	dioico	O
dioicas	dioico	FP
dioica	dioico	F
dioicos	dioico	P
dionea	dionea	O
dioneas	dionea	P
dionisia	dionisia	O
dionisias	dionisia	P
dionisiaco	dionisiaco	O
dionisiacas	dionisiaco	FP
dionisiaca	dionisiaco	F
dionisiacos	dionisiaco	P
dionisíaco	dionisíaco	O
dionisíacas	dionisíaco	FP
dionisíaca	dionisíaco	F
dionisíacos	dionisíaco	P
dioptra	dioptra	O
dioptras	dioptra	P
dioptría	dioptría	O
dioptrías	dioptría	P
diorama	diorama	O
dioramas	diorama	P
diorita	diorita	O
dioritas	diorita	P
dios	dios	O
diosa	diosa	O
diosas	diosa	P
dioscoreáceo	dioscoreáceo	O
dioscoreáceas	dioscoreáceo	FP
dioscoreácea	dioscoreáceo	F
dioscoreáceos	dioscoreáceo	P
dioscóreo	dioscóreo	O
dioscóreas	dioscóreo	FP
dioscórea	dioscóreo	F
dioscóreos	dioscóreo	P
diosma	diosma	O
diosmas	diosma	P
dioso	dioso	O
diosas	dioso	FP
diosa	dioso	F
diosos	dioso	P
diostedé	diostedé	O
diostedés	diostedé	P
diócesi	diócesi	O
diócesis	diócesi	P
diócesis	diócesis	O
dióptrico	dióptrico	O
dióptricas	dióptrico	FP
dióptrica	dióptrico	F
dióptricos	dióptrico	P
dióxido	dióxido	O
dióxidos	dióxido	P
