difamación	difamación	O
difamaciones	difamación	P
difamado	difamado	O
difamadas	difamado	FP
difamada	difamado	F
difamados	difamado	P
difamador	difamador	O
difamadoras	difamador	FP
difamadora	difamador	F
difamadores	difamador	P
difamatorio	difamatorio	O
difamatorias	difamatorio	FP
difamatoria	difamatorio	F
difamatorios	difamatorio	P
difamia	difamia	O
difamias	difamia	P
difarreación	difarreación	O
difarreaciones	difarreación	P
diferencia	diferencia	O
diferencias	diferencia	P
diferenciación	diferenciación	O
diferenciaciones	diferenciación	P
diferencial	diferencial	O
diferenciales	diferencial	P
diferendo	diferendo	O
diferendos	diferendo	P
diferente	diferente	O
diferentes	diferente	P
diferentemente	diferentemente	O
diferido	diferido	O
diferidos	diferido	P
dificultad	dificultad	O
dificultades	dificultad	P
dificultador	dificultador	O
dificultadoras	dificultador	FP
dificultadora	dificultador	F
dificultadores	dificultador	P
dificultosamente	dificultosamente	O
dificultoso	dificultoso	O
dificultosas	dificultoso	FP
dificultosa	dificultoso	F
dificultosos	dificultoso	P
difidencia	difidencia	O
difidencias	difidencia	P
difidente	difidente	O
difidentes	difidente	P
difilo	difilo	O
difilas	difilo	FP
difila	difilo	F
difilos	difilo	P
difinición	difinición	O
difiniciones	difinición	P
difinidura	difinidura	O
difiniduras	difinidura	P
difinitorio	difinitorio	O
difinitorios	difinitorio	P
difluencia	difluencia	O
difluencias	difluencia	P
difluente	difluente	O
difluentes	difluente	P
difracción	difracción	O
difracciones	difracción	P
difrangente	difrangente	O
difrangentes	difrangente	P
difteria	difteria	O
difterias	difteria	P
difteritis	difteritis	O
diftérico	diftérico	O
diftéricas	diftérico	FP
diftérica	diftérico	F
diftéricos	diftérico	P
difugio	difugio	O
difugios	difugio	P
difumino	difumino	O
difuminos	difumino	P
difundidor	difundidor	O
difundidoras	difundidor	FP
difundidora	difundidor	F
difundidores	difundidor	P
difunto	difunto	O
difuntas	difunto	FP
difunta	difunto	F
difuntos	difunto	P
difusamente	difusamente	O
difusivo	difusivo	O
difusivas	difusivo	FP
difusiva	difusivo	F
difusivos	difusivo	P
difusión	difusión	O
difusiones	difusión	P
difuso	difuso	O
difusas	difuso	FP
difusa	difuso	F
difusos	difuso	P
difusor	difusor	O
difusoras	difusor	FP
difusora	difusor	F
difusores	difusor	P
difícil	difícil	O
difíciles	difícil	P
difícilmente	difícilmente	O
dífilo	dífilo	O
dífilos	dífilo	P
diferir	diferir	O
difiero	diferir	VIP1
difieres	diferir	VIP2
difiere	diferir	VIP3
diferimos	diferir	VIP4
diferís	diferir	VIP5
difieren	diferir	VIP6
difería	diferir	VII1
diferías	diferir	VII2
diferíamos	diferir	VII4
diferíais	diferir	VII5
diferían	diferir	VII6
diferiré	diferir	VIF1
diferirás	diferir	VIF2
diferirá	diferir	VIF3
diferiremos	diferir	VIF4
diferiréis	diferir	VIF5
diferirán	diferir	VIF6
diferiría	diferir	VIC1
diferirías	diferir	VIC2
diferiría	diferir	VIC3
diferiríamos	diferir	VIC4
diferiríais	diferir	VIC5
diferirían	diferir	VIC6
diferí	diferir	VIX1
diferiste	diferir	VIX2
difirió	diferir	VIX3
diferisteis	diferir	VIX5
difirieron	diferir	VIX6
difiera	diferir	VSP1
difieras	diferir	VSP2
difiramos	diferir	VSP4
difiráis	diferir	VSP5
difieran	diferir	VSP6
difiriera	diferir	VSX1
difirieras	diferir	VSX2
difiriéramos	diferir	VSX4
difirierais	diferir	VSX5
difirieran	diferir	VSX6
difiriere	diferir	VSF1
difirieres	diferir	VSF2
difiriéremos	diferir	VSF4
difiriereis	diferir	VSF5
difirieren	diferir	VSF6
difiriese	diferir	VSI1
difirieses	diferir	VSI2
difiriésemos	diferir	VSI4
difirieseis	diferir	VSI5
difiriesen	diferir	VSI6
diferid	diferir	VMP
diferidme	diferir	VMSE
diferidle	diferir	VMSE
diferidnos	diferir	VMPE
diferios	diferir	VMPE
diferidles	diferir	VMPE
diferidlo	diferir	VMMSE
diferidla	diferir	VMFSE
diferidlos	diferir	VMMPE
diferidlas	diferir	VMFPE
diferídmelo	diferir	VMMSE
diferídselo	diferir	VMMSE
diferídnoslo	diferir	VMMSE
diferíoslo	diferir	VMMSE
diferídmelos	diferir	VMMPE
diferídselos	diferir	VMMPE
diferídnoslos	diferir	VMMPE
diferíoslos	diferir	VMMPE
diferídmela	diferir	VMFSE
diferídsela	diferir	VMFSE
diferídnosla	diferir	VMFSE
diferíosla	diferir	VMFSE
diferídmelas	diferir	VMFPE
diferídselas	diferir	VMFPE
diferídnoslas	diferir	VMFPE
diferíoslas	diferir	VMFPE
diferido	diferir	VPM
diferidos	diferir	VPMP
diferida	diferir	VPF
diferidas	diferir	VPFP
difiriendo	diferir	VG
difiriéndome	diferir	VGSE
difiriéndote	diferir	VGSE
difiriéndole	diferir	VGSE
difiriéndonos	diferir	VGPE
difiriéndoos	diferir	VGPE
difiriéndolo	diferir	VGMSE
difiriéndola	diferir	VGFSE
difiriéndolos	diferir	VGMPE
difiriéndolas	diferir	VGFPE
difiriéndomelo	diferir	VGMSE
difiriéndotelo	diferir	VGMSE
difiriéndoselo	diferir	VGMSE
difiriéndonoslo	diferir	VGMSE
difiriéndooslo	diferir	VGMSE
difiriéndomelos	diferir	VGMPE
difiriéndotelos	diferir	VGMPE
difiriéndoselos	diferir	VGMPE
difiriéndonoslos	diferir	VGMPE
difiriéndooslos	diferir	VGMPE
difiriéndomela	diferir	VGFSE
difiriéndotela	diferir	VGFSE
difiriéndosela	diferir	VGFSE
difiriéndonosla	diferir	VGFSE
difiriéndoosla	diferir	VGFSE
difiriéndomelas	diferir	VGFPE
difiriéndotelas	diferir	VGFPE
difiriéndoselas	diferir	VGFPE
difiriéndonoslas	diferir	VGFPE
difiriéndooslas	diferir	VGFPE
difinir	difinir	O
difino	difinir	VIP1
difines	difinir	VIP2
difine	difinir	VIP3
difinimos	difinir	VIP4
difinís	difinir	VIP5
difinen	difinir	VIP6
difinía	difinir	VII1
difinías	difinir	VII2
difiníamos	difinir	VII4
difiníais	difinir	VII5
difinían	difinir	VII6
difiniré	difinir	VIF1
difinirás	difinir	VIF2
difinirá	difinir	VIF3
difiniremos	difinir	VIF4
difiniréis	difinir	VIF5
difinirán	difinir	VIF6
difiniría	difinir	VIC1
difinirías	difinir	VIC2
difiniría	difinir	VIC3
difiniríamos	difinir	VIC4
difiniríais	difinir	VIC5
difinirían	difinir	VIC6
difiní	difinir	VIX1
difiniste	difinir	VIX2
difinió	difinir	VIX3
difinisteis	difinir	VIX5
difinieron	difinir	VIX6
difina	difinir	VSP1
difinas	difinir	VSP2
difinamos	difinir	VSP4
difináis	difinir	VSP5
difinan	difinir	VSP6
difiniera	difinir	VSX1
difinieras	difinir	VSX2
difiniéramos	difinir	VSX4
difinierais	difinir	VSX5
difinieran	difinir	VSX6
difiniere	difinir	VSF1
difinieres	difinir	VSF2
difiniéremos	difinir	VSF4
difiniereis	difinir	VSF5
difinieren	difinir	VSF6
difiniese	difinir	VSI1
difinieses	difinir	VSI2
difiniésemos	difinir	VSI4
difinieseis	difinir	VSI5
difiniesen	difinir	VSI6
difinid	difinir	VMP
difinidme	difinir	VMSE
difinidle	difinir	VMSE
difinidnos	difinir	VMPE
difinios	difinir	VMPE
difinidles	difinir	VMPE
difinidlo	difinir	VMMSE
difinidla	difinir	VMFSE
difinidlos	difinir	VMMPE
difinidlas	difinir	VMFPE
difinídmelo	difinir	VMMSE
difinídselo	difinir	VMMSE
difinídnoslo	difinir	VMMSE
difiníoslo	difinir	VMMSE
difinídmelos	difinir	VMMPE
difinídselos	difinir	VMMPE
difinídnoslos	difinir	VMMPE
difiníoslos	difinir	VMMPE
difinídmela	difinir	VMFSE
difinídsela	difinir	VMFSE
difinídnosla	difinir	VMFSE
difiníosla	difinir	VMFSE
difinídmelas	difinir	VMFPE
difinídselas	difinir	VMFPE
difinídnoslas	difinir	VMFPE
difiníoslas	difinir	VMFPE
difinido	difinir	VPM
difinidos	difinir	VPMP
difinida	difinir	VPF
difinidas	difinir	VPFP
difiniendo	difinir	VG
difiniéndome	difinir	VGSE
difiniéndote	difinir	VGSE
difiniéndole	difinir	VGSE
difiniéndonos	difinir	VGPE
difiniéndoos	difinir	VGPE
difiniéndolo	difinir	VGMSE
difiniéndola	difinir	VGFSE
difiniéndolos	difinir	VGMPE
difiniéndolas	difinir	VGFPE
difiniéndomelo	difinir	VGMSE
difiniéndotelo	difinir	VGMSE
difiniéndoselo	difinir	VGMSE
difiniéndonoslo	difinir	VGMSE
difiniéndooslo	difinir	VGMSE
difiniéndomelos	difinir	VGMPE
difiniéndotelos	difinir	VGMPE
difiniéndoselos	difinir	VGMPE
difiniéndonoslos	difinir	VGMPE
difiniéndooslos	difinir	VGMPE
difiniéndomela	difinir	VGFSE
difiniéndotela	difinir	VGFSE
difiniéndosela	difinir	VGFSE
difiniéndonosla	difinir	VGFSE
difiniéndoosla	difinir	VGFSE
difiniéndomelas	difinir	VGFPE
difiniéndotelas	difinir	VGFPE
difiniéndoselas	difinir	VGFPE
difiniéndonoslas	difinir	VGFPE
difiniéndooslas	difinir	VGFPE
difluir	difluir	O
difluyo	difluir	VIP1
difluyes	difluir	VIP2
difluye	difluir	VIP3
difluimos	difluir	VIP4
difluís	difluir	VIP5
difluyen	difluir	VIP6
difluía	difluir	VII1
difluías	difluir	VII2
difluíamos	difluir	VII4
difluíais	difluir	VII5
difluían	difluir	VII6
difluiré	difluir	VIF1
difluirás	difluir	VIF2
difluirá	difluir	VIF3
difluiremos	difluir	VIF4
difluiréis	difluir	VIF5
difluirán	difluir	VIF6
difluiría	difluir	VIC1
difluirías	difluir	VIC2
difluiría	difluir	VIC3
difluiríamos	difluir	VIC4
difluiríais	difluir	VIC5
difluirían	difluir	VIC6
difluí	difluir	VIX1
difluiste	difluir	VIX2
difluyó	difluir	VIX3
difluisteis	difluir	VIX5
difluyeron	difluir	VIX6
difluya	difluir	VSP1
difluyas	difluir	VSP2
difluyamos	difluir	VSP4
difluyáis	difluir	VSP5
difluyan	difluir	VSP6
difluyera	difluir	VSX1
difluyeras	difluir	VSX2
difluyéramos	difluir	VSX4
difluyerais	difluir	VSX5
difluyeran	difluir	VSX6
difluyere	difluir	VSF1
difluyeres	difluir	VSF2
difluyéremos	difluir	VSF4
difluyereis	difluir	VSF5
difluyeren	difluir	VSF6
difluyese	difluir	VSI1
difluyeses	difluir	VSI2
difluyésemos	difluir	VSI4
difluyeseis	difluir	VSI5
difluyesen	difluir	VSI6
difluid	difluir	VMP
difluidme	difluir	VMSE
difluidle	difluir	VMSE
difluidnos	difluir	VMPE
difluios	difluir	VMPE
difluidles	difluir	VMPE
difluido	difluir	VPM
difluidos	difluir	VPMP
difluida	difluir	VPF
difluidas	difluir	VPFP
difluyiendo	difluir	VG
difluyiéndome	difluir	VGSE
difluyiéndote	difluir	VGSE
difluyiéndole	difluir	VGSE
difluyiéndonos	difluir	VGPE
difluyiéndoos	difluir	VGPE
difundir	difundir	O
difundo	difundir	VIP1
difundes	difundir	VIP2
difunde	difundir	VIP3
difundimos	difundir	VIP4
difundís	difundir	VIP5
difunden	difundir	VIP6
difundía	difundir	VII1
difundías	difundir	VII2
difundíamos	difundir	VII4
difundíais	difundir	VII5
difundían	difundir	VII6
difundiré	difundir	VIF1
difundirás	difundir	VIF2
difundirá	difundir	VIF3
difundiremos	difundir	VIF4
difundiréis	difundir	VIF5
difundirán	difundir	VIF6
difundiría	difundir	VIC1
difundirías	difundir	VIC2
difundiría	difundir	VIC3
difundiríamos	difundir	VIC4
difundiríais	difundir	VIC5
difundirían	difundir	VIC6
difundí	difundir	VIX1
difundiste	difundir	VIX2
difundió	difundir	VIX3
difundisteis	difundir	VIX5
difundieron	difundir	VIX6
difunda	difundir	VSP1
difundas	difundir	VSP2
difundamos	difundir	VSP4
difundáis	difundir	VSP5
difundan	difundir	VSP6
difundiera	difundir	VSX1
difundieras	difundir	VSX2
difundiéramos	difundir	VSX4
difundierais	difundir	VSX5
difundieran	difundir	VSX6
difundiere	difundir	VSF1
difundieres	difundir	VSF2
difundiéremos	difundir	VSF4
difundiereis	difundir	VSF5
difundieren	difundir	VSF6
difundiese	difundir	VSI1
difundieses	difundir	VSI2
difundiésemos	difundir	VSI4
difundieseis	difundir	VSI5
difundiesen	difundir	VSI6
difundid	difundir	VMP
difundidme	difundir	VMSE
difundidle	difundir	VMSE
difundidnos	difundir	VMPE
difundios	difundir	VMPE
difundidles	difundir	VMPE
difundidlo	difundir	VMMSE
difundidla	difundir	VMFSE
difundidlos	difundir	VMMPE
difundidlas	difundir	VMFPE
difundídmelo	difundir	VMMSE
difundídselo	difundir	VMMSE
difundídnoslo	difundir	VMMSE
difundíoslo	difundir	VMMSE
difundídmelos	difundir	VMMPE
difundídselos	difundir	VMMPE
difundídnoslos	difundir	VMMPE
difundíoslos	difundir	VMMPE
difundídmela	difundir	VMFSE
difundídsela	difundir	VMFSE
difundídnosla	difundir	VMFSE
difundíosla	difundir	VMFSE
difundídmelas	difundir	VMFPE
difundídselas	difundir	VMFPE
difundídnoslas	difundir	VMFPE
difundíoslas	difundir	VMFPE
difundido	difundir	VPM
difundidos	difundir	VPMP
difundida	difundir	VPF
difundidas	difundir	VPFP
difundiendo	difundir	VG
difundiéndome	difundir	VGSE
difundiéndote	difundir	VGSE
difundiéndole	difundir	VGSE
difundiéndonos	difundir	VGPE
difundiéndoos	difundir	VGPE
difundiéndolo	difundir	VGMSE
difundiéndola	difundir	VGFSE
difundiéndolos	difundir	VGMPE
difundiéndolas	difundir	VGFPE
difundiéndomelo	difundir	VGMSE
difundiéndotelo	difundir	VGMSE
difundiéndoselo	difundir	VGMSE
difundiéndonoslo	difundir	VGMSE
difundiéndooslo	difundir	VGMSE
difundiéndomelos	difundir	VGMPE
difundiéndotelos	difundir	VGMPE
difundiéndoselos	difundir	VGMPE
difundiéndonoslos	difundir	VGMPE
difundiéndooslos	difundir	VGMPE
difundiéndomela	difundir	VGFSE
difundiéndotela	difundir	VGFSE
difundiéndosela	difundir	VGFSE
difundiéndonosla	difundir	VGFSE
difundiéndoosla	difundir	VGFSE
difundiéndomelas	difundir	VGFPE
difundiéndotelas	difundir	VGFPE
difundiéndoselas	difundir	VGFPE
difundiéndonoslas	difundir	VGFPE
difundiéndooslas	difundir	VGFPE
diferecer	diferecer	O
difereco	diferecer	VIP1
difereces	diferecer	VIP2
diferece	diferecer	VIP3
diferecemos	diferecer	VIP4
diferecéis	diferecer	VIP5
diferecen	diferecer	VIP6
diferecía	diferecer	VII1
diferecías	diferecer	VII2
diferecíamos	diferecer	VII4
diferecíais	diferecer	VII5
diferecían	diferecer	VII6
difereceré	diferecer	VIF1
diferecerás	diferecer	VIF2
diferecerá	diferecer	VIF3
difereceremos	diferecer	VIF4
difereceréis	diferecer	VIF5
diferecerán	diferecer	VIF6
diferecería	diferecer	VIC1
diferecerías	diferecer	VIC2
diferecería	diferecer	VIC3
difereceríamos	diferecer	VIC4
difereceríais	diferecer	VIC5
diferecerían	diferecer	VIC6
diferecí	diferecer	VIX1
diferecíste	diferecer	VIX2
difereció	diferecer	VIX3
diferecisteis	diferecer	VIX5
diferecieron	diferecer	VIX6
difereca	diferecer	VSP1
diferecas	diferecer	VSP2
diferecamos	diferecer	VSP4
diferecáis	diferecer	VSP5
diferecan	diferecer	VSP6
difereciera	diferecer	VSX1
diferecieras	diferecer	VSX2
difereciéramos	diferecer	VSX4
diferecierais	diferecer	VSX5
diferecieran	diferecer	VSX6
difereciere	diferecer	VSF1
diferecieres	diferecer	VSF2
difereciéremos	diferecer	VSF4
difereciereis	diferecer	VSF5
diferecieren	diferecer	VSF6
difereciese	diferecer	VSI1
diferecieses	diferecer	VSI2
difereciésemos	diferecer	VSI4
diferecieseis	diferecer	VSI5
difereciesen	diferecer	VSI6
difereced	diferecer	VMP
diferecedme	diferecer	VMSE
diferecedle	diferecer	VMSE
diferecednos	diferecer	VMPE
difereceos	diferecer	VMPE
diferecedles	diferecer	VMPE
diferecido	diferecer	VPM
diferecidos	diferecer	VPMP
diferecida	diferecer	VPF
diferecidas	diferecer	VPFP
difereciendo	diferecer	VG
difereciéndome	diferecer	VGSE
difereciéndote	diferecer	VGSE
difereciéndole	diferecer	VGSE
difereciéndonos	diferecer	VGPE
difereciéndoos	diferecer	VGPE
difinecer	difinecer	O
difineco	difinecer	VIP1
difineces	difinecer	VIP2
difinece	difinecer	VIP3
difinecemos	difinecer	VIP4
difinecéis	difinecer	VIP5
difinecen	difinecer	VIP6
difinecía	difinecer	VII1
difinecías	difinecer	VII2
difinecíamos	difinecer	VII4
difinecíais	difinecer	VII5
difinecían	difinecer	VII6
difineceré	difinecer	VIF1
difinecerás	difinecer	VIF2
difinecerá	difinecer	VIF3
difineceremos	difinecer	VIF4
difineceréis	difinecer	VIF5
difinecerán	difinecer	VIF6
difinecería	difinecer	VIC1
difinecerías	difinecer	VIC2
difinecería	difinecer	VIC3
difineceríamos	difinecer	VIC4
difineceríais	difinecer	VIC5
difinecerían	difinecer	VIC6
difinecí	difinecer	VIX1
difineciste	difinecer	VIX2
difineció	difinecer	VIX3
difinecisteis	difinecer	VIX5
difinecieron	difinecer	VIX6
difineca	difinecer	VSP1
difinecas	difinecer	VSP2
difinecamos	difinecer	VSP4
difinecáis	difinecer	VSP5
difinecan	difinecer	VSP6
difineciera	difinecer	VSX1
difinecieras	difinecer	VSX2
difineciéramos	difinecer	VSX4
difinecierais	difinecer	VSX5
difinecieran	difinecer	VSX6
difineciere	difinecer	VSF1
difinecieres	difinecer	VSF2
difineciéremos	difinecer	VSF4
difineciereis	difinecer	VSF5
difinecieren	difinecer	VSF6
difineciese	difinecer	VSI1
difinecieses	difinecer	VSI2
difineciésemos	difinecer	VSI4
difinecieseis	difinecer	VSI5
difineciesen	difinecer	VSI6
difineced	difinecer	VMP
difinecedme	difinecer	VMSE
difinecedle	difinecer	VMSE
difinecednos	difinecer	VMPE
difineceos	difinecer	VMPE
difinecedles	difinecer	VMPE
difinecedlo	difinecer	VMMSE
difinecedla	difinecer	VMFSE
difinecedlos	difinecer	VMMPE
difinecedlas	difinecer	VMFPE
difinecédmelo	difinecer	VMMSE
difinecédselo	difinecer	VMMSE
difinecédnoslo	difinecer	VMMSE
difinecéoslo	difinecer	VMMSE
difinecédmelos	difinecer	VMMPE
difinecédselos	difinecer	VMMPE
difinecédnoslos	difinecer	VMMPE
difinecéoslos	difinecer	VMMPE
difinecédmela	difinecer	VMFSE
difinecédsela	difinecer	VMFSE
difinecédnosla	difinecer	VMFSE
difinecéosla	difinecer	VMFSE
difinecédmelas	difinecer	VMFPE
difinecédselas	difinecer	VMFPE
difinecédnoslas	difinecer	VMFPE
difinecéoslas	difinecer	VMFPE
difinecido	difinecer	VPM
difinecidos	difinecer	VPMP
difinecida	difinecer	VPF
difinecidas	difinecer	VPFP
difineciendo	difinecer	VG
difineciéndome	difinecer	VGSE
difineciéndote	difinecer	VGSE
difineciéndole	difinecer	VGSE
difineciéndonos	difinecer	VGPE
difineciéndoos	difinecer	VGPE
difineciéndolo	difinecer	VGMSE
difineciéndola	difinecer	VGFSE
difineciéndolos	difinecer	VGMPE
difineciéndolas	difinecer	VGFPE
difineciéndomelo	difinecer	VGMSE
difineciéndotelo	difinecer	VGMSE
difineciéndoselo	difinecer	VGMSE
difineciéndonoslo	difinecer	VGMSE
difineciéndooslo	difinecer	VGMSE
difineciéndomelos	difinecer	VGMPE
difineciéndotelos	difinecer	VGMPE
difineciéndoselos	difinecer	VGMPE
difineciéndonoslos	difinecer	VGMPE
difineciéndooslos	difinecer	VGMPE
difineciéndomela	difinecer	VGFSE
difineciéndotela	difinecer	VGFSE
difineciéndosela	difinecer	VGFSE
difineciéndonosla	difinecer	VGFSE
difineciéndoosla	difinecer	VGFSE
difineciéndomelas	difinecer	VGFPE
difineciéndotelas	difinecer	VGFPE
difineciéndoselas	difinecer	VGFPE
difineciéndonoslas	difinecer	VGFPE
difineciéndooslas	difinecer	VGFPE
difamar	difamar	O
difamo	difamar	VIP1
difamas	difamar	VIP2
difama	difamar	VIP3
difamamos	difamar	VIP4
difamáis	difamar	VIP5
difaman	difamar	VIP6
difamaba	difamar	VII1
difamabas	difamar	VII2
difamábamos	difamar	VII4
difamabais	difamar	VII5
difamaban	difamar	VII6
difamaré	difamar	VIF1
difamarás	difamar	VIF2
difamará	difamar	VIF3
difamaremos	difamar	VIF4
difamaréis	difamar	VIF5
difamarán	difamar	VIF6
difamaría	difamar	VIC1
difamarías	difamar	VIC2
difamaría	difamar	VIC3
difamaríamos	difamar	VIC4
difamaríais	difamar	VIC5
difamarían	difamar	VIC6
difamé	difamar	VIX1
difamaste	difamar	VIX2
difamó	difamar	VIX3
difamasteis	difamar	VIX5
difamaron	difamar	VIX6
difame	difamar	VSP1
difames	difamar	VSP2
difamemos	difamar	VSP4
difaméis	difamar	VSP5
difamen	difamar	VSP6
difamara	difamar	VSX1
difamaras	difamar	VSX2
difamáramos	difamar	VSX4
difamarais	difamar	VSX5
difamaran	difamar	VSX6
difamare	difamar	VSF1
difamares	difamar	VSF2
difamáremos	difamar	VSF4
difamareis	difamar	VSF5
difamaren	difamar	VSF6
difamase	difamar	VSI1
difamases	difamar	VSI2
difamásemos	difamar	VSI4
difamaseis	difamar	VSI5
difamasen	difamar	VSI6
difamad	difamar	VMP
difamadme	difamar	VMSE
difamadle	difamar	VMSE
difamadnos	difamar	VMPE
difamaos	difamar	VMPE
difamadles	difamar	VMPE
difamadlo	difamar	VMMSE
difamadla	difamar	VMFSE
difamadlos	difamar	VMMPE
difamadlas	difamar	VMFPE
difamádmelo	difamar	VMMSE
difamádselo	difamar	VMMSE
difamádnoslo	difamar	VMMSE
difamáoslo	difamar	VMMSE
difamádmelos	difamar	VMMPE
difamádselos	difamar	VMMPE
difamádnoslos	difamar	VMMPE
difamáoslos	difamar	VMMPE
difamádmela	difamar	VMFSE
difamádsela	difamar	VMFSE
difamádnosla	difamar	VMFSE
difamáosla	difamar	VMFSE
difamádmelas	difamar	VMFPE
difamádselas	difamar	VMFPE
difamádnoslas	difamar	VMFPE
difamáoslas	difamar	VMFPE
difamado	difamar	VPM
difamados	difamar	VPMP
difamada	difamar	VPF
difamadas	difamar	VPFP
difamando	difamar	VG
difamándome	difamar	VGSE
difamándote	difamar	VGSE
difamándole	difamar	VGSE
difamándonos	difamar	VGPE
difamándoos	difamar	VGPE
difamándolo	difamar	VGMSE
difamándola	difamar	VGFSE
difamándolos	difamar	VGMPE
difamándolas	difamar	VGFPE
difamándomelo	difamar	VGMSE
difamándotelo	difamar	VGMSE
difamándoselo	difamar	VGMSE
difamándonoslo	difamar	VGMSE
difamándooslo	difamar	VGMSE
difamándomelos	difamar	VGMPE
difamándotelos	difamar	VGMPE
difamándoselos	difamar	VGMPE
difamándonoslos	difamar	VGMPE
difamándooslos	difamar	VGMPE
difamándomela	difamar	VGFSE
difamándotela	difamar	VGFSE
difamándosela	difamar	VGFSE
difamándonosla	difamar	VGFSE
difamándoosla	difamar	VGFSE
difamándomelas	difamar	VGFPE
difamándotelas	difamar	VGFPE
difamándoselas	difamar	VGFPE
difamándonoslas	difamar	VGFPE
difamándooslas	difamar	VGFPE
diferenciar	diferenciar	O
diferencio	diferenciar	VIP1
diferencias	diferenciar	VIP2
diferencia	diferenciar	VIP3
diferenciamos	diferenciar	VIP4
diferenciáis	diferenciar	VIP5
diferencian	diferenciar	VIP6
diferenciaba	diferenciar	VII1
diferenciabas	diferenciar	VII2
diferenciábamos	diferenciar	VII4
diferenciabais	diferenciar	VII5
diferenciaban	diferenciar	VII6
diferenciaré	diferenciar	VIF1
diferenciarás	diferenciar	VIF2
diferenciará	diferenciar	VIF3
diferenciaremos	diferenciar	VIF4
diferenciaréis	diferenciar	VIF5
diferenciarán	diferenciar	VIF6
diferenciaría	diferenciar	VIC1
diferenciarías	diferenciar	VIC2
diferenciaría	diferenciar	VIC3
diferenciaríamos	diferenciar	VIC4
diferenciaríais	diferenciar	VIC5
diferenciarían	diferenciar	VIC6
diferencié	diferenciar	VIX1
diferenciaste	diferenciar	VIX2
diferenció	diferenciar	VIX3
diferenciasteis	diferenciar	VIX5
diferenciaron	diferenciar	VIX6
diferencie	diferenciar	VSP1
diferencies	diferenciar	VSP2
diferenciemos	diferenciar	VSP4
diferenciéis	diferenciar	VSP5
diferencien	diferenciar	VSP6
diferenciara	diferenciar	VSX1
diferenciaras	diferenciar	VSX2
diferenciáramos	diferenciar	VSX4
diferenciarais	diferenciar	VSX5
diferenciaran	diferenciar	VSX6
diferenciare	diferenciar	VSF1
diferenciares	diferenciar	VSF2
diferenciáremos	diferenciar	VSF4
diferenciareis	diferenciar	VSF5
diferenciaren	diferenciar	VSF6
diferenciase	diferenciar	VSI1
diferenciases	diferenciar	VSI2
diferenciásemos	diferenciar	VSI4
diferenciaseis	diferenciar	VSI5
diferenciasen	diferenciar	VSI6
diferenciad	diferenciar	VMP
diferenciadme	diferenciar	VMSE
diferenciadle	diferenciar	VMSE
diferenciadnos	diferenciar	VMPE
diferenciaos	diferenciar	VMPE
diferenciadles	diferenciar	VMPE
diferenciadlo	diferenciar	VMMSE
diferenciadla	diferenciar	VMFSE
diferenciadlos	diferenciar	VMMPE
diferenciadlas	diferenciar	VMFPE
diferenciádmelo	diferenciar	VMMSE
diferenciádselo	diferenciar	VMMSE
diferenciádnoslo	diferenciar	VMMSE
diferenciáoslo	diferenciar	VMMSE
diferenciádmelos	diferenciar	VMMPE
diferenciádselos	diferenciar	VMMPE
diferenciádnoslos	diferenciar	VMMPE
diferenciáoslos	diferenciar	VMMPE
diferenciádmela	diferenciar	VMFSE
diferenciádsela	diferenciar	VMFSE
diferenciádnosla	diferenciar	VMFSE
diferenciáosla	diferenciar	VMFSE
diferenciádmelas	diferenciar	VMFPE
diferenciádselas	diferenciar	VMFPE
diferenciádnoslas	diferenciar	VMFPE
diferenciáoslas	diferenciar	VMFPE
diferenciado	diferenciar	VPM
diferenciados	diferenciar	VPMP
diferenciada	diferenciar	VPF
diferenciadas	diferenciar	VPFP
diferenciando	diferenciar	VG
diferenciándome	diferenciar	VGSE
diferenciándote	diferenciar	VGSE
diferenciándole	diferenciar	VGSE
diferenciándonos	diferenciar	VGPE
diferenciándoos	diferenciar	VGPE
diferenciándolo	diferenciar	VGMSE
diferenciándola	diferenciar	VGFSE
diferenciándolos	diferenciar	VGMPE
diferenciándolas	diferenciar	VGFPE
diferenciándomelo	diferenciar	VGMSE
diferenciándotelo	diferenciar	VGMSE
diferenciándoselo	diferenciar	VGMSE
diferenciándonoslo	diferenciar	VGMSE
diferenciándooslo	diferenciar	VGMSE
diferenciándomelos	diferenciar	VGMPE
diferenciándotelos	diferenciar	VGMPE
diferenciándoselos	diferenciar	VGMPE
diferenciándonoslos	diferenciar	VGMPE
diferenciándooslos	diferenciar	VGMPE
diferenciándomela	diferenciar	VGFSE
diferenciándotela	diferenciar	VGFSE
diferenciándosela	diferenciar	VGFSE
diferenciándonosla	diferenciar	VGFSE
diferenciándoosla	diferenciar	VGFSE
diferenciándomelas	diferenciar	VGFPE
diferenciándotelas	diferenciar	VGFPE
diferenciándoselas	diferenciar	VGFPE
diferenciándonoslas	diferenciar	VGFPE
diferenciándooslas	diferenciar	VGFPE
dificultar	dificultar	O
dificulto	dificultar	VIP1
dificultas	dificultar	VIP2
dificulta	dificultar	VIP3
dificultamos	dificultar	VIP4
dificultáis	dificultar	VIP5
dificultan	dificultar	VIP6
dificultaba	dificultar	VII1
dificultabas	dificultar	VII2
dificultábamos	dificultar	VII4
dificultabais	dificultar	VII5
dificultaban	dificultar	VII6
dificultaré	dificultar	VIF1
dificultarás	dificultar	VIF2
dificultará	dificultar	VIF3
dificultaremos	dificultar	VIF4
dificultaréis	dificultar	VIF5
dificultarán	dificultar	VIF6
dificultaría	dificultar	VIC1
dificultarías	dificultar	VIC2
dificultaría	dificultar	VIC3
dificultaríamos	dificultar	VIC4
dificultaríais	dificultar	VIC5
dificultarían	dificultar	VIC6
dificulté	dificultar	VIX1
dificultaste	dificultar	VIX2
dificultó	dificultar	VIX3
dificultasteis	dificultar	VIX5
dificultaron	dificultar	VIX6
dificulte	dificultar	VSP1
dificultes	dificultar	VSP2
dificultemos	dificultar	VSP4
dificultéis	dificultar	VSP5
dificulten	dificultar	VSP6
dificultara	dificultar	VSX1
dificultaras	dificultar	VSX2
dificultáramos	dificultar	VSX4
dificultarais	dificultar	VSX5
dificultaran	dificultar	VSX6
dificultare	dificultar	VSF1
dificultares	dificultar	VSF2
dificultáremos	dificultar	VSF4
dificultareis	dificultar	VSF5
dificultaren	dificultar	VSF6
dificultase	dificultar	VSI1
dificultases	dificultar	VSI2
dificultásemos	dificultar	VSI4
dificultaseis	dificultar	VSI5
dificultasen	dificultar	VSI6
dificultad	dificultar	VMP
dificultadme	dificultar	VMSE
dificultadle	dificultar	VMSE
dificultadnos	dificultar	VMPE
dificultaos	dificultar	VMPE
dificultadles	dificultar	VMPE
dificultadlo	dificultar	VMMSE
dificultadla	dificultar	VMFSE
dificultadlos	dificultar	VMMPE
dificultadlas	dificultar	VMFPE
dificultádmelo	dificultar	VMMSE
dificultádselo	dificultar	VMMSE
dificultádnoslo	dificultar	VMMSE
dificultáoslo	dificultar	VMMSE
dificultádmelos	dificultar	VMMPE
dificultádselos	dificultar	VMMPE
dificultádnoslos	dificultar	VMMPE
dificultáoslos	dificultar	VMMPE
dificultádmela	dificultar	VMFSE
dificultádsela	dificultar	VMFSE
dificultádnosla	dificultar	VMFSE
dificultáosla	dificultar	VMFSE
dificultádmelas	dificultar	VMFPE
dificultádselas	dificultar	VMFPE
dificultádnoslas	dificultar	VMFPE
dificultáoslas	dificultar	VMFPE
dificultado	dificultar	VPM
dificultados	dificultar	VPMP
dificultada	dificultar	VPF
dificultadas	dificultar	VPFP
dificultando	dificultar	VG
dificultándome	dificultar	VGSE
dificultándote	dificultar	VGSE
dificultándole	dificultar	VGSE
dificultándonos	dificultar	VGPE
dificultándoos	dificultar	VGPE
dificultándolo	dificultar	VGMSE
dificultándola	dificultar	VGFSE
dificultándolos	dificultar	VGMPE
dificultándolas	dificultar	VGFPE
dificultándomelo	dificultar	VGMSE
dificultándotelo	dificultar	VGMSE
dificultándoselo	dificultar	VGMSE
dificultándonoslo	dificultar	VGMSE
dificultándooslo	dificultar	VGMSE
dificultándomelos	dificultar	VGMPE
dificultándotelos	dificultar	VGMPE
dificultándoselos	dificultar	VGMPE
dificultándonoslos	dificultar	VGMPE
dificultándooslos	dificultar	VGMPE
dificultándomela	dificultar	VGFSE
dificultándotela	dificultar	VGFSE
dificultándosela	dificultar	VGFSE
dificultándonosla	dificultar	VGFSE
dificultándoosla	dificultar	VGFSE
dificultándomelas	dificultar	VGFPE
dificultándotelas	dificultar	VGFPE
dificultándoselas	dificultar	VGFPE
dificultándonoslas	dificultar	VGFPE
dificultándooslas	dificultar	VGFPE
dificultares	dificultar	P
difiuciar	difiuciar	O
difiucio	difiuciar	VIP1
difiucias	difiuciar	VIP2
difiucia	difiuciar	VIP3
difiuciamos	difiuciar	VIP4
difiuciáis	difiuciar	VIP5
difiucian	difiuciar	VIP6
difiuciaba	difiuciar	VII1
difiuciabas	difiuciar	VII2
difiuciábamos	difiuciar	VII4
difiuciabais	difiuciar	VII5
difiuciaban	difiuciar	VII6
difiuciaré	difiuciar	VIF1
difiuciarás	difiuciar	VIF2
difiuciará	difiuciar	VIF3
difiuciaremos	difiuciar	VIF4
difiuciaréis	difiuciar	VIF5
difiuciarán	difiuciar	VIF6
difiuciaría	difiuciar	VIC1
difiuciarías	difiuciar	VIC2
difiuciaría	difiuciar	VIC3
difiuciaríamos	difiuciar	VIC4
difiuciaríais	difiuciar	VIC5
difiuciarían	difiuciar	VIC6
difiucié	difiuciar	VIX1
difiuciaste	difiuciar	VIX2
difiució	difiuciar	VIX3
difiuciasteis	difiuciar	VIX5
difiuciaron	difiuciar	VIX6
difiucie	difiuciar	VSP1
difiucies	difiuciar	VSP2
difiuciemos	difiuciar	VSP4
difiuciéis	difiuciar	VSP5
difiucien	difiuciar	VSP6
difiuciara	difiuciar	VSX1
difiuciaras	difiuciar	VSX2
difiuciáramos	difiuciar	VSX4
difiuciarais	difiuciar	VSX5
difiuciaran	difiuciar	VSX6
difiuciare	difiuciar	VSF1
difiuciares	difiuciar	VSF2
difiuciáremos	difiuciar	VSF4
difiuciareis	difiuciar	VSF5
difiuciaren	difiuciar	VSF6
difiuciase	difiuciar	VSI1
difiuciases	difiuciar	VSI2
difiuciásemos	difiuciar	VSI4
difiuciaseis	difiuciar	VSI5
difiuciasen	difiuciar	VSI6
difiuciad	difiuciar	VMP
difiuciadme	difiuciar	VMSE
difiuciadle	difiuciar	VMSE
difiuciadnos	difiuciar	VMPE
difiuciaos	difiuciar	VMPE
difiuciadles	difiuciar	VMPE
difiuciadlo	difiuciar	VMMSE
difiuciadla	difiuciar	VMFSE
difiuciadlos	difiuciar	VMMPE
difiuciadlas	difiuciar	VMFPE
difiuciádmelo	difiuciar	VMMSE
difiuciádselo	difiuciar	VMMSE
difiuciádnoslo	difiuciar	VMMSE
difiuciáoslo	difiuciar	VMMSE
difiuciádmelos	difiuciar	VMMPE
difiuciádselos	difiuciar	VMMPE
difiuciádnoslos	difiuciar	VMMPE
difiuciáoslos	difiuciar	VMMPE
difiuciádmela	difiuciar	VMFSE
difiuciádsela	difiuciar	VMFSE
difiuciádnosla	difiuciar	VMFSE
difiuciáosla	difiuciar	VMFSE
difiuciádmelas	difiuciar	VMFPE
difiuciádselas	difiuciar	VMFPE
difiuciádnoslas	difiuciar	VMFPE
difiuciáoslas	difiuciar	VMFPE
difiuciado	difiuciar	VPM
difiuciados	difiuciar	VPMP
difiuciada	difiuciar	VPF
difiuciadas	difiuciar	VPFP
difiuciando	difiuciar	VG
difiuciándome	difiuciar	VGSE
difiuciándote	difiuciar	VGSE
difiuciándole	difiuciar	VGSE
difiuciándonos	difiuciar	VGPE
difiuciándoos	difiuciar	VGPE
difiuciándolo	difiuciar	VGMSE
difiuciándola	difiuciar	VGFSE
difiuciándolos	difiuciar	VGMPE
difiuciándolas	difiuciar	VGFPE
difiuciándomelo	difiuciar	VGMSE
difiuciándotelo	difiuciar	VGMSE
difiuciándoselo	difiuciar	VGMSE
difiuciándonoslo	difiuciar	VGMSE
difiuciándooslo	difiuciar	VGMSE
difiuciándomelos	difiuciar	VGMPE
difiuciándotelos	difiuciar	VGMPE
difiuciándoselos	difiuciar	VGMPE
difiuciándonoslos	difiuciar	VGMPE
difiuciándooslos	difiuciar	VGMPE
difiuciándomela	difiuciar	VGFSE
difiuciándotela	difiuciar	VGFSE
difiuciándosela	difiuciar	VGFSE
difiuciándonosla	difiuciar	VGFSE
difiuciándoosla	difiuciar	VGFSE
difiuciándomelas	difiuciar	VGFPE
difiuciándotelas	difiuciar	VGFPE
difiuciándoselas	difiuciar	VGFPE
difiuciándonoslas	difiuciar	VGFPE
difiuciándooslas	difiuciar	VGFPE
difractar	difractar	O
difracto	difractar	VIP1
difractas	difractar	VIP2
difracta	difractar	VIP3
difractamos	difractar	VIP4
difractáis	difractar	VIP5
difractan	difractar	VIP6
difractaba	difractar	VII1
difractabas	difractar	VII2
difractábamos	difractar	VII4
difractabais	difractar	VII5
difractaban	difractar	VII6
difractaré	difractar	VIF1
difractarás	difractar	VIF2
difractará	difractar	VIF3
difractaremos	difractar	VIF4
difractaréis	difractar	VIF5
difractarán	difractar	VIF6
difractaría	difractar	VIC1
difractarías	difractar	VIC2
difractaría	difractar	VIC3
difractaríamos	difractar	VIC4
difractaríais	difractar	VIC5
difractarían	difractar	VIC6
difracté	difractar	VIX1
difractaste	difractar	VIX2
difractó	difractar	VIX3
difractasteis	difractar	VIX5
difractaron	difractar	VIX6
difracte	difractar	VSP1
difractes	difractar	VSP2
difractemos	difractar	VSP4
difractéis	difractar	VSP5
difracten	difractar	VSP6
difractara	difractar	VSX1
difractaras	difractar	VSX2
difractáramos	difractar	VSX4
difractarais	difractar	VSX5
difractaran	difractar	VSX6
difractare	difractar	VSF1
difractares	difractar	VSF2
difractáremos	difractar	VSF4
difractareis	difractar	VSF5
difractaren	difractar	VSF6
difractase	difractar	VSI1
difractases	difractar	VSI2
difractásemos	difractar	VSI4
difractaseis	difractar	VSI5
difractasen	difractar	VSI6
difractad	difractar	VMP
difractadme	difractar	VMSE
difractadle	difractar	VMSE
difractadnos	difractar	VMPE
difractaos	difractar	VMPE
difractadles	difractar	VMPE
difractadlo	difractar	VMMSE
difractadla	difractar	VMFSE
difractadlos	difractar	VMMPE
difractadlas	difractar	VMFPE
difractádmelo	difractar	VMMSE
difractádselo	difractar	VMMSE
difractádnoslo	difractar	VMMSE
difractáoslo	difractar	VMMSE
difractádmelos	difractar	VMMPE
difractádselos	difractar	VMMPE
difractádnoslos	difractar	VMMPE
difractáoslos	difractar	VMMPE
difractádmela	difractar	VMFSE
difractádsela	difractar	VMFSE
difractádnosla	difractar	VMFSE
difractáosla	difractar	VMFSE
difractádmelas	difractar	VMFPE
difractádselas	difractar	VMFPE
difractádnoslas	difractar	VMFPE
difractáoslas	difractar	VMFPE
difractado	difractar	VPM
difractados	difractar	VPMP
difractada	difractar	VPF
difractadas	difractar	VPFP
difractando	difractar	VG
difractándome	difractar	VGSE
difractándote	difractar	VGSE
difractándole	difractar	VGSE
difractándonos	difractar	VGPE
difractándoos	difractar	VGPE
difractándolo	difractar	VGMSE
difractándola	difractar	VGFSE
difractándolos	difractar	VGMPE
difractándolas	difractar	VGFPE
difractándomelo	difractar	VGMSE
difractándotelo	difractar	VGMSE
difractándoselo	difractar	VGMSE
difractándonoslo	difractar	VGMSE
difractándooslo	difractar	VGMSE
difractándomelos	difractar	VGMPE
difractándotelos	difractar	VGMPE
difractándoselos	difractar	VGMPE
difractándonoslos	difractar	VGMPE
difractándooslos	difractar	VGMPE
difractándomela	difractar	VGFSE
difractándotela	difractar	VGFSE
difractándosela	difractar	VGFSE
difractándonosla	difractar	VGFSE
difractándoosla	difractar	VGFSE
difractándomelas	difractar	VGFPE
difractándotelas	difractar	VGFPE
difractándoselas	difractar	VGFPE
difractándonoslas	difractar	VGFPE
difractándooslas	difractar	VGFPE
difumar	difumar	O
difumo	difumar	VIP1
difumas	difumar	VIP2
difuma	difumar	VIP3
difumamos	difumar	VIP4
difumáis	difumar	VIP5
difuman	difumar	VIP6
difumaba	difumar	VII1
difumabas	difumar	VII2
difumábamos	difumar	VII4
difumabais	difumar	VII5
difumaban	difumar	VII6
difumaré	difumar	VIF1
difumarás	difumar	VIF2
difumará	difumar	VIF3
difumaremos	difumar	VIF4
difumaréis	difumar	VIF5
difumarán	difumar	VIF6
difumaría	difumar	VIC1
difumarías	difumar	VIC2
difumaría	difumar	VIC3
difumaríamos	difumar	VIC4
difumaríais	difumar	VIC5
difumarían	difumar	VIC6
difumé	difumar	VIX1
difumaste	difumar	VIX2
difumó	difumar	VIX3
difumasteis	difumar	VIX5
difumaron	difumar	VIX6
difume	difumar	VSP1
difumes	difumar	VSP2
difumemos	difumar	VSP4
difuméis	difumar	VSP5
difumen	difumar	VSP6
difumara	difumar	VSX1
difumaras	difumar	VSX2
difumáramos	difumar	VSX4
difumarais	difumar	VSX5
difumaran	difumar	VSX6
difumare	difumar	VSF1
difumares	difumar	VSF2
difumáremos	difumar	VSF4
difumareis	difumar	VSF5
difumaren	difumar	VSF6
difumase	difumar	VSI1
difumases	difumar	VSI2
difumásemos	difumar	VSI4
difumaseis	difumar	VSI5
difumasen	difumar	VSI6
difumad	difumar	VMP
difumadme	difumar	VMSE
difumadle	difumar	VMSE
difumadnos	difumar	VMPE
difumaos	difumar	VMPE
difumadles	difumar	VMPE
difumadlo	difumar	VMMSE
difumadla	difumar	VMFSE
difumadlos	difumar	VMMPE
difumadlas	difumar	VMFPE
difumádmelo	difumar	VMMSE
difumádselo	difumar	VMMSE
difumádnoslo	difumar	VMMSE
difumáoslo	difumar	VMMSE
difumádmelos	difumar	VMMPE
difumádselos	difumar	VMMPE
difumádnoslos	difumar	VMMPE
difumáoslos	difumar	VMMPE
difumádmela	difumar	VMFSE
difumádsela	difumar	VMFSE
difumádnosla	difumar	VMFSE
difumáosla	difumar	VMFSE
difumádmelas	difumar	VMFPE
difumádselas	difumar	VMFPE
difumádnoslas	difumar	VMFPE
difumáoslas	difumar	VMFPE
difumado	difumar	VPM
difumados	difumar	VPMP
difumada	difumar	VPF
difumadas	difumar	VPFP
difumando	difumar	VG
difumándome	difumar	VGSE
difumándote	difumar	VGSE
difumándole	difumar	VGSE
difumándonos	difumar	VGPE
difumándoos	difumar	VGPE
difumándolo	difumar	VGMSE
difumándola	difumar	VGFSE
difumándolos	difumar	VGMPE
difumándolas	difumar	VGFPE
difumándomelo	difumar	VGMSE
difumándotelo	difumar	VGMSE
difumándoselo	difumar	VGMSE
difumándonoslo	difumar	VGMSE
difumándooslo	difumar	VGMSE
difumándomelos	difumar	VGMPE
difumándotelos	difumar	VGMPE
difumándoselos	difumar	VGMPE
difumándonoslos	difumar	VGMPE
difumándooslos	difumar	VGMPE
difumándomela	difumar	VGFSE
difumándotela	difumar	VGFSE
difumándosela	difumar	VGFSE
difumándonosla	difumar	VGFSE
difumándoosla	difumar	VGFSE
difumándomelas	difumar	VGFPE
difumándotelas	difumar	VGFPE
difumándoselas	difumar	VGFPE
difumándonoslas	difumar	VGFPE
difumándooslas	difumar	VGFPE
difuminar	difuminar	O
difumino	difuminar	VIP1
difuminas	difuminar	VIP2
difumina	difuminar	VIP3
difuminamos	difuminar	VIP4
difumináis	difuminar	VIP5
difuminan	difuminar	VIP6
difuminaba	difuminar	VII1
difuminabas	difuminar	VII2
difuminábamos	difuminar	VII4
difuminabais	difuminar	VII5
difuminaban	difuminar	VII6
difuminaré	difuminar	VIF1
difuminarás	difuminar	VIF2
difuminará	difuminar	VIF3
difuminaremos	difuminar	VIF4
difuminaréis	difuminar	VIF5
difuminarán	difuminar	VIF6
difuminaría	difuminar	VIC1
difuminarías	difuminar	VIC2
difuminaría	difuminar	VIC3
difuminaríamos	difuminar	VIC4
difuminaríais	difuminar	VIC5
difuminarían	difuminar	VIC6
difuminé	difuminar	VIX1
difuminaste	difuminar	VIX2
difuminó	difuminar	VIX3
difuminasteis	difuminar	VIX5
difuminaron	difuminar	VIX6
difumine	difuminar	VSP1
difumines	difuminar	VSP2
difuminemos	difuminar	VSP4
difuminéis	difuminar	VSP5
difuminen	difuminar	VSP6
difuminara	difuminar	VSX1
difuminaras	difuminar	VSX2
difumináramos	difuminar	VSX4
difuminarais	difuminar	VSX5
difuminaran	difuminar	VSX6
difuminare	difuminar	VSF1
difuminares	difuminar	VSF2
difumináremos	difuminar	VSF4
difuminareis	difuminar	VSF5
difuminaren	difuminar	VSF6
difuminase	difuminar	VSI1
difuminases	difuminar	VSI2
difuminásemos	difuminar	VSI4
difuminaseis	difuminar	VSI5
difuminasen	difuminar	VSI6
difuminad	difuminar	VMP
difuminadme	difuminar	VMSE
difuminadle	difuminar	VMSE
difuminadnos	difuminar	VMPE
difuminaos	difuminar	VMPE
difuminadles	difuminar	VMPE
difuminadlo	difuminar	VMMSE
difuminadla	difuminar	VMFSE
difuminadlos	difuminar	VMMPE
difuminadlas	difuminar	VMFPE
difuminádmelo	difuminar	VMMSE
difuminádselo	difuminar	VMMSE
difuminádnoslo	difuminar	VMMSE
difumináoslo	difuminar	VMMSE
difuminádmelos	difuminar	VMMPE
difuminádselos	difuminar	VMMPE
difuminádnoslos	difuminar	VMMPE
difumináoslos	difuminar	VMMPE
difuminádmela	difuminar	VMFSE
difuminádsela	difuminar	VMFSE
difuminádnosla	difuminar	VMFSE
difumináosla	difuminar	VMFSE
difuminádmelas	difuminar	VMFPE
difuminádselas	difuminar	VMFPE
difuminádnoslas	difuminar	VMFPE
difumináoslas	difuminar	VMFPE
difuminado	difuminar	VPM
difuminados	difuminar	VPMP
difuminada	difuminar	VPF
difuminadas	difuminar	VPFP
difuminando	difuminar	VG
difuminándome	difuminar	VGSE
difuminándote	difuminar	VGSE
difuminándole	difuminar	VGSE
difuminándonos	difuminar	VGPE
difuminándoos	difuminar	VGPE
difuminándolo	difuminar	VGMSE
difuminándola	difuminar	VGFSE
difuminándolos	difuminar	VGMPE
difuminándolas	difuminar	VGFPE
difuminándomelo	difuminar	VGMSE
difuminándotelo	difuminar	VGMSE
difuminándoselo	difuminar	VGMSE
difuminándonoslo	difuminar	VGMSE
difuminándooslo	difuminar	VGMSE
difuminándomelos	difuminar	VGMPE
difuminándotelos	difuminar	VGMPE
difuminándoselos	difuminar	VGMPE
difuminándonoslos	difuminar	VGMPE
difuminándooslos	difuminar	VGMPE
difuminándomela	difuminar	VGFSE
difuminándotela	difuminar	VGFSE
difuminándosela	difuminar	VGFSE
difuminándonosla	difuminar	VGFSE
difuminándoosla	difuminar	VGFSE
difuminándomelas	difuminar	VGFPE
difuminándotelas	difuminar	VGFPE
difuminándoselas	difuminar	VGFPE
difuminándonoslas	difuminar	VGFPE
difuminándooslas	difuminar	VGFPE
difuminares	difuminar	P
difuntear	difuntear	O
difunteo	difuntear	VIP1
difunteas	difuntear	VIP2
difuntea	difuntear	VIP3
difunteamos	difuntear	VIP4
difunteáis	difuntear	VIP5
difuntean	difuntear	VIP6
difunteaba	difuntear	VII1
difunteabas	difuntear	VII2
difunteábamos	difuntear	VII4
difunteabais	difuntear	VII5
difunteaban	difuntear	VII6
difuntearé	difuntear	VIF1
difuntearás	difuntear	VIF2
difunteará	difuntear	VIF3
difuntearemos	difuntear	VIF4
difuntearéis	difuntear	VIF5
difuntearán	difuntear	VIF6
difuntearía	difuntear	VIC1
difuntearías	difuntear	VIC2
difuntearía	difuntear	VIC3
difuntearíamos	difuntear	VIC4
difuntearíais	difuntear	VIC5
difuntearían	difuntear	VIC6
difunteé	difuntear	VIX1
difunteaste	difuntear	VIX2
difunteó	difuntear	VIX3
difunteasteis	difuntear	VIX5
difuntearon	difuntear	VIX6
difuntee	difuntear	VSP1
difuntees	difuntear	VSP2
difunteemos	difuntear	VSP4
difunteéis	difuntear	VSP5
difunteen	difuntear	VSP6
difunteara	difuntear	VSX1
difuntearas	difuntear	VSX2
difunteáramos	difuntear	VSX4
difuntearais	difuntear	VSX5
difuntearan	difuntear	VSX6
difunteare	difuntear	VSF1
difunteares	difuntear	VSF2
difunteáremos	difuntear	VSF4
difunteareis	difuntear	VSF5
difuntearen	difuntear	VSF6
difuntease	difuntear	VSI1
difunteases	difuntear	VSI2
difunteásemos	difuntear	VSI4
difunteaseis	difuntear	VSI5
difunteasen	difuntear	VSI6
difuntead	difuntear	VMP
difunteadme	difuntear	VMSE
difunteadle	difuntear	VMSE
difunteadnos	difuntear	VMPE
difunteaos	difuntear	VMPE
difunteadles	difuntear	VMPE
difunteadlo	difuntear	VMMSE
difunteadla	difuntear	VMFSE
difunteadlos	difuntear	VMMPE
difunteadlas	difuntear	VMFPE
difunteádmelo	difuntear	VMMSE
difunteádselo	difuntear	VMMSE
difunteádnoslo	difuntear	VMMSE
difunteáoslo	difuntear	VMMSE
difunteádmelos	difuntear	VMMPE
difunteádselos	difuntear	VMMPE
difunteádnoslos	difuntear	VMMPE
difunteáoslos	difuntear	VMMPE
difunteádmela	difuntear	VMFSE
difunteádsela	difuntear	VMFSE
difunteádnosla	difuntear	VMFSE
difunteáosla	difuntear	VMFSE
difunteádmelas	difuntear	VMFPE
difunteádselas	difuntear	VMFPE
difunteádnoslas	difuntear	VMFPE
difunteáoslas	difuntear	VMFPE
difunteado	difuntear	VPM
difunteados	difuntear	VPMP
difunteada	difuntear	VPF
difunteadas	difuntear	VPFP
difunteando	difuntear	VG
difunteándome	difuntear	VGSE
difunteándote	difuntear	VGSE
difunteándole	difuntear	VGSE
difunteándonos	difuntear	VGPE
difunteándoos	difuntear	VGPE
difunteándolo	difuntear	VGMSE
difunteándola	difuntear	VGFSE
difunteándolos	difuntear	VGMPE
difunteándolas	difuntear	VGFPE
difunteándomelo	difuntear	VGMSE
difunteándotelo	difuntear	VGMSE
difunteándoselo	difuntear	VGMSE
difunteándonoslo	difuntear	VGMSE
difunteándooslo	difuntear	VGMSE
difunteándomelos	difuntear	VGMPE
difunteándotelos	difuntear	VGMPE
difunteándoselos	difuntear	VGMPE
difunteándonoslos	difuntear	VGMPE
difunteándooslos	difuntear	VGMPE
difunteándomela	difuntear	VGFSE
difunteándotela	difuntear	VGFSE
difunteándosela	difuntear	VGFSE
difunteándonosla	difuntear	VGFSE
difunteándoosla	difuntear	VGFSE
difunteándomelas	difuntear	VGFPE
difunteándotelas	difuntear	VGFPE
difunteándoselas	difuntear	VGFPE
difunteándonoslas	difuntear	VGFPE
difunteándooslas	difuntear	VGFPE
