dotación	dotación	O
dotaciones	dotación	P
dotado	dotado	O
dotadas	dotado	FP
dotada	dotado	F
dotados	dotado	P
dotador	dotador	O
dotadoras	dotador	FP
dotadora	dotador	F
dotadores	dotador	P
dotal	dotal	O
dotales	dotal	P
dote	dote	O
dotes	dote	P
dotor	dotor	O
dotores	dotor	P
dotrina	dotrina	O
dotrinas	dotrina	P
dotrinero	dotrinero	O
dotrineros	dotrinero	P
dotar	dotar	O
doto	dotar	VIP1
dotas	dotar	VIP2
dota	dotar	VIP3
dotamos	dotar	VIP4
dotáis	dotar	VIP5
dotan	dotar	VIP6
dotaba	dotar	VII1
dotabas	dotar	VII2
dotábamos	dotar	VII4
dotabais	dotar	VII5
dotaban	dotar	VII6
dotaré	dotar	VIF1
dotarás	dotar	VIF2
dotará	dotar	VIF3
dotaremos	dotar	VIF4
dotaréis	dotar	VIF5
dotarán	dotar	VIF6
dotaría	dotar	VIC1
dotarías	dotar	VIC2
dotaría	dotar	VIC3
dotaríamos	dotar	VIC4
dotaríais	dotar	VIC5
dotarían	dotar	VIC6
doté	dotar	VIX1
dotaste	dotar	VIX2
dotó	dotar	VIX3
dotasteis	dotar	VIX5
dotaron	dotar	VIX6
dote	dotar	VSP1
dotes	dotar	VSP2
dotemos	dotar	VSP4
dotéis	dotar	VSP5
doten	dotar	VSP6
dotara	dotar	VSX1
dotaras	dotar	VSX2
dotáramos	dotar	VSX4
dotarais	dotar	VSX5
dotaran	dotar	VSX6
dotare	dotar	VSF1
dotares	dotar	VSF2
dotáremos	dotar	VSF4
dotareis	dotar	VSF5
dotaren	dotar	VSF6
dotase	dotar	VSI1
dotases	dotar	VSI2
dotásemos	dotar	VSI4
dotaseis	dotar	VSI5
dotasen	dotar	VSI6
dotad	dotar	VMP
dotadme	dotar	VMSE
dotadle	dotar	VMSE
dotadnos	dotar	VMPE
dotaos	dotar	VMPE
dotadles	dotar	VMPE
dotadlo	dotar	VMMSE
dotadla	dotar	VMFSE
dotadlos	dotar	VMMPE
dotadlas	dotar	VMFPE
dotádmelo	dotar	VMMSE
dotádselo	dotar	VMMSE
dotádnoslo	dotar	VMMSE
dotáoslo	dotar	VMMSE
dotádmelos	dotar	VMMPE
dotádselos	dotar	VMMPE
dotádnoslos	dotar	VMMPE
dotáoslos	dotar	VMMPE
dotádmela	dotar	VMFSE
dotádsela	dotar	VMFSE
dotádnosla	dotar	VMFSE
dotáosla	dotar	VMFSE
dotádmelas	dotar	VMFPE
dotádselas	dotar	VMFPE
dotádnoslas	dotar	VMFPE
dotáoslas	dotar	VMFPE
dotado	dotar	VPM
dotados	dotar	VPMP
dotada	dotar	VPF
dotadas	dotar	VPFP
dotando	dotar	VG
dotándome	dotar	VGSE
dotándote	dotar	VGSE
dotándole	dotar	VGSE
dotándonos	dotar	VGPE
dotándoos	dotar	VGPE
dotándolo	dotar	VGMSE
dotándola	dotar	VGFSE
dotándolos	dotar	VGMPE
dotándolas	dotar	VGFPE
dotándomelo	dotar	VGMSE
dotándotelo	dotar	VGMSE
dotándoselo	dotar	VGMSE
dotándonoslo	dotar	VGMSE
dotándooslo	dotar	VGMSE
dotándomelos	dotar	VGMPE
dotándotelos	dotar	VGMPE
dotándoselos	dotar	VGMPE
dotándonoslos	dotar	VGMPE
dotándooslos	dotar	VGMPE
dotándomela	dotar	VGFSE
dotándotela	dotar	VGFSE
dotándosela	dotar	VGFSE
dotándonosla	dotar	VGFSE
dotándoosla	dotar	VGFSE
dotándomelas	dotar	VGFPE
dotándotelas	dotar	VGFPE
dotándoselas	dotar	VGFPE
dotándonoslas	dotar	VGFPE
dotándooslas	dotar	VGFPE
dotrinar	dotrinar	O
dotrino	dotrinar	VIP1
dotrinas	dotrinar	VIP2
dotrina	dotrinar	VIP3
dotrinamos	dotrinar	VIP4
dotrináis	dotrinar	VIP5
dotrinan	dotrinar	VIP6
dotrinaba	dotrinar	VII1
dotrinabas	dotrinar	VII2
dotrinábamos	dotrinar	VII4
dotrinabais	dotrinar	VII5
dotrinaban	dotrinar	VII6
dotrinaré	dotrinar	VIF1
dotrinarás	dotrinar	VIF2
dotrinará	dotrinar	VIF3
dotrinaremos	dotrinar	VIF4
dotrinaréis	dotrinar	VIF5
dotrinarán	dotrinar	VIF6
dotrinaría	dotrinar	VIC1
dotrinarías	dotrinar	VIC2
dotrinaría	dotrinar	VIC3
dotrinaríamos	dotrinar	VIC4
dotrinaríais	dotrinar	VIC5
dotrinarían	dotrinar	VIC6
dotriné	dotrinar	VIX1
dotrinaste	dotrinar	VIX2
dotrinó	dotrinar	VIX3
dotrinasteis	dotrinar	VIX5
dotrinaron	dotrinar	VIX6
dotrine	dotrinar	VSP1
dotrines	dotrinar	VSP2
dotrinemos	dotrinar	VSP4
dotrinéis	dotrinar	VSP5
dotrinen	dotrinar	VSP6
dotrinara	dotrinar	VSX1
dotrinaras	dotrinar	VSX2
dotrináramos	dotrinar	VSX4
dotrinarais	dotrinar	VSX5
dotrinaran	dotrinar	VSX6
dotrinare	dotrinar	VSF1
dotrinares	dotrinar	VSF2
dotrináremos	dotrinar	VSF4
dotrinareis	dotrinar	VSF5
dotrinaren	dotrinar	VSF6
dotrinase	dotrinar	VSI1
dotrinases	dotrinar	VSI2
dotrinásemos	dotrinar	VSI4
dotrinaseis	dotrinar	VSI5
dotrinasen	dotrinar	VSI6
dotrinad	dotrinar	VMP
dotrinadme	dotrinar	VMSE
dotrinadle	dotrinar	VMSE
dotrinadnos	dotrinar	VMPE
dotrinaos	dotrinar	VMPE
dotrinadles	dotrinar	VMPE
dotrinadlo	dotrinar	VMMSE
dotrinadla	dotrinar	VMFSE
dotrinadlos	dotrinar	VMMPE
dotrinadlas	dotrinar	VMFPE
dotrinádmelo	dotrinar	VMMSE
dotrinádselo	dotrinar	VMMSE
dotrinádnoslo	dotrinar	VMMSE
dotrináoslo	dotrinar	VMMSE
dotrinádmelos	dotrinar	VMMPE
dotrinádselos	dotrinar	VMMPE
dotrinádnoslos	dotrinar	VMMPE
dotrináoslos	dotrinar	VMMPE
dotrinádmela	dotrinar	VMFSE
dotrinádsela	dotrinar	VMFSE
dotrinádnosla	dotrinar	VMFSE
dotrináosla	dotrinar	VMFSE
dotrinádmelas	dotrinar	VMFPE
dotrinádselas	dotrinar	VMFPE
dotrinádnoslas	dotrinar	VMFPE
dotrináoslas	dotrinar	VMFPE
dotrinado	dotrinar	VPM
dotrinados	dotrinar	VPMP
dotrinada	dotrinar	VPF
dotrinadas	dotrinar	VPFP
dotrinando	dotrinar	VG
dotrinándome	dotrinar	VGSE
dotrinándote	dotrinar	VGSE
dotrinándole	dotrinar	VGSE
dotrinándonos	dotrinar	VGPE
dotrinándoos	dotrinar	VGPE
dotrinándolo	dotrinar	VGMSE
dotrinándola	dotrinar	VGFSE
dotrinándolos	dotrinar	VGMPE
dotrinándolas	dotrinar	VGFPE
dotrinándomelo	dotrinar	VGMSE
dotrinándotelo	dotrinar	VGMSE
dotrinándoselo	dotrinar	VGMSE
dotrinándonoslo	dotrinar	VGMSE
dotrinándooslo	dotrinar	VGMSE
dotrinándomelos	dotrinar	VGMPE
dotrinándotelos	dotrinar	VGMPE
dotrinándoselos	dotrinar	VGMPE
dotrinándonoslos	dotrinar	VGMPE
dotrinándooslos	dotrinar	VGMPE
dotrinándomela	dotrinar	VGFSE
dotrinándotela	dotrinar	VGFSE
dotrinándosela	dotrinar	VGFSE
dotrinándonosla	dotrinar	VGFSE
dotrinándoosla	dotrinar	VGFSE
dotrinándomelas	dotrinar	VGFPE
dotrinándotelas	dotrinar	VGFPE
dotrinándoselas	dotrinar	VGFPE
dotrinándonoslas	dotrinar	VGFPE
dotrinándooslas	dotrinar	VGFPE
