egregiamente	egregiamente	O
egregio	egregio	O
egregias	egregio	FP
egregia	egregio	F
egregios	egregio	P
egresado	egresado	O
egresadas	egresado	FP
egresada	egresado	F
egresados	egresado	P
egresión	egresión	O
egresiones	egresión	P
egreso	egreso	O
egresos	egreso	P
egresar	egresar	O
egreso	egresar	VIP1
egresas	egresar	VIP2
egresa	egresar	VIP3
egresamos	egresar	VIP4
egresáis	egresar	VIP5
egresan	egresar	VIP6
egresaba	egresar	VII1
egresabas	egresar	VII2
egresábamos	egresar	VII4
egresabais	egresar	VII5
egresaban	egresar	VII6
egresaré	egresar	VIF1
egresarás	egresar	VIF2
egresará	egresar	VIF3
egresaremos	egresar	VIF4
egresaréis	egresar	VIF5
egresarán	egresar	VIF6
egresaría	egresar	VIC1
egresarías	egresar	VIC2
egresaría	egresar	VIC3
egresaríamos	egresar	VIC4
egresaríais	egresar	VIC5
egresarían	egresar	VIC6
egresé	egresar	VIX1
egresaste	egresar	VIX2
egresó	egresar	VIX3
egresasteis	egresar	VIX5
egresaron	egresar	VIX6
egrese	egresar	VSP1
egreses	egresar	VSP2
egresemos	egresar	VSP4
egreséis	egresar	VSP5
egresen	egresar	VSP6
egresara	egresar	VSX1
egresaras	egresar	VSX2
egresáramos	egresar	VSX4
egresarais	egresar	VSX5
egresaran	egresar	VSX6
egresare	egresar	VSF1
egresares	egresar	VSF2
egresáremos	egresar	VSF4
egresareis	egresar	VSF5
egresaren	egresar	VSF6
egresase	egresar	VSI1
egresases	egresar	VSI2
egresásemos	egresar	VSI4
egresaseis	egresar	VSI5
egresasen	egresar	VSI6
egresad	egresar	VMP
egresadme	egresar	VMSE
egresadle	egresar	VMSE
egresadnos	egresar	VMPE
egresaos	egresar	VMPE
egresadles	egresar	VMPE
egresado	egresar	VPM
egresados	egresar	VPMP
egresada	egresar	VPF
egresadas	egresar	VPFP
egresando	egresar	VG
egresándome	egresar	VGSE
egresándote	egresar	VGSE
egresándole	egresar	VGSE
egresándonos	egresar	VGPE
egresándoos	egresar	VGPE
