eje	eje	O
ejes	eje	P
ejecución	ejecución	O
ejecuciones	ejecución	P
ejecutable	ejecutable	O
ejecutables	ejecutable	P
ejecutadero	ejecutadero	O
ejecutaderas	ejecutadero	FP
ejecutadera	ejecutadero	F
ejecutaderos	ejecutadero	P
ejecutante	ejecutante	O
ejecutantes	ejecutante	P
ejecutiva	ejecutiva	O
ejecutivas	ejecutiva	P
ejecutivamente	ejecutivamente	O
ejecutivo	ejecutivo	O
ejecutivas	ejecutivo	FP
ejecutiva	ejecutivo	F
ejecutivos	ejecutivo	P
ejecutor	ejecutor	O
ejecutoras	ejecutor	FP
ejecutora	ejecutor	F
ejecutores	ejecutor	P
ejecutoria	ejecutoria	O
ejecutorias	ejecutoria	P
ejecutorio	ejecutorio	O
ejecutorias	ejecutorio	FP
ejecutoria	ejecutorio	F
ejecutorios	ejecutorio	P
ejecutoría	ejecutoría	O
ejecutorías	ejecutoría	P
ejem	ejem	O
ejemes	ejem	P
ejemplaridad	ejemplaridad	O
ejemplaridades	ejemplaridad	P
ejemplario	ejemplario	O
ejemplarios	ejemplario	P
ejemplarizador	ejemplarizador	O
ejemplarizadoras	ejemplarizador	FP
ejemplarizadora	ejemplarizador	F
ejemplarizadores	ejemplarizador	P
ejemplarizante	ejemplarizante	O
ejemplarizantes	ejemplarizante	P
ejemplarmente	ejemplarmente	O
ejemplificación	ejemplificación	O
ejemplificaciones	ejemplificación	P
ejemplo	ejemplo	O
ejemplos	ejemplo	P
ejercicio	ejercicio	O
ejercicios	ejercicio	P
ejercido	ejercido	O
ejercidas	ejercido	FP
ejercida	ejercido	F
ejercidos	ejercido	P
ejercitación	ejercitación	O
ejercitaciones	ejercitación	P
ejercitador	ejercitador	O
ejercitadoras	ejercitador	FP
ejercitadora	ejercitador	F
ejercitadores	ejercitador	P
ejercitante	ejercitante	O
ejercitantes	ejercitante	P
ejercitativo	ejercitativo	O
ejercitativas	ejercitativo	FP
ejercitativa	ejercitativo	F
ejercitativos	ejercitativo	P
ejército	ejército	O
ejércitos	ejército	P
ejercer	ejercer	O
ejerco	ejercer	VIP1
ejerces	ejercer	VIP2
ejerce	ejercer	VIP3
ejercemos	ejercer	VIP4
ejercéis	ejercer	VIP5
ejercen	ejercer	VIP6
ejercía	ejercer	VII1
ejercías	ejercer	VII2
ejercíamos	ejercer	VII4
ejercíais	ejercer	VII5
ejercían	ejercer	VII6
ejerceré	ejercer	VIF1
ejercerás	ejercer	VIF2
ejercerá	ejercer	VIF3
ejerceremos	ejercer	VIF4
ejerceréis	ejercer	VIF5
ejercerán	ejercer	VIF6
ejercería	ejercer	VIC1
ejercerías	ejercer	VIC2
ejercería	ejercer	VIC3
ejerceríamos	ejercer	VIC4
ejerceríais	ejercer	VIC5
ejercerían	ejercer	VIC6
ejercí	ejercer	VIX1
ejerciste	ejercer	VIX2
ejerció	ejercer	VIX3
ejercisteis	ejercer	VIX5
ejercieron	ejercer	VIX6
ejerca	ejercer	VSP1
ejercas	ejercer	VSP2
ejercamos	ejercer	VSP4
ejercáis	ejercer	VSP5
ejercan	ejercer	VSP6
ejerciera	ejercer	VSX1
ejercieras	ejercer	VSX2
ejerciéramos	ejercer	VSX4
ejercierais	ejercer	VSX5
ejercieran	ejercer	VSX6
ejerciere	ejercer	VSF1
ejercieres	ejercer	VSF2
ejerciéremos	ejercer	VSF4
ejerciereis	ejercer	VSF5
ejercieren	ejercer	VSF6
ejerciese	ejercer	VSI1
ejercieses	ejercer	VSI2
ejerciésemos	ejercer	VSI4
ejercieseis	ejercer	VSI5
ejerciesen	ejercer	VSI6
ejerced	ejercer	VMP
ejercedme	ejercer	VMSE
ejercedle	ejercer	VMSE
ejercednos	ejercer	VMPE
ejerceos	ejercer	VMPE
ejercedles	ejercer	VMPE
ejercedlo	ejercer	VMMSE
ejercedla	ejercer	VMFSE
ejercedlos	ejercer	VMMPE
ejercedlas	ejercer	VMFPE
ejercédmelo	ejercer	VMMSE
ejercédselo	ejercer	VMMSE
ejercédnoslo	ejercer	VMMSE
ejercéoslo	ejercer	VMMSE
ejercédmelos	ejercer	VMMPE
ejercédselos	ejercer	VMMPE
ejercédnoslos	ejercer	VMMPE
ejercéoslos	ejercer	VMMPE
ejercédmela	ejercer	VMFSE
ejercédsela	ejercer	VMFSE
ejercédnosla	ejercer	VMFSE
ejercéosla	ejercer	VMFSE
ejercédmelas	ejercer	VMFPE
ejercédselas	ejercer	VMFPE
ejercédnoslas	ejercer	VMFPE
ejercéoslas	ejercer	VMFPE
ejercido	ejercer	VPM
ejercidos	ejercer	VPMP
ejercida	ejercer	VPF
ejercidas	ejercer	VPFP
ejerciendo	ejercer	VG
ejerciéndome	ejercer	VGSE
ejerciéndote	ejercer	VGSE
ejerciéndole	ejercer	VGSE
ejerciéndonos	ejercer	VGPE
ejerciéndoos	ejercer	VGPE
ejerciéndolo	ejercer	VGMSE
ejerciéndola	ejercer	VGFSE
ejerciéndolos	ejercer	VGMPE
ejerciéndolas	ejercer	VGFPE
ejerciéndomelo	ejercer	VGMSE
ejerciéndotelo	ejercer	VGMSE
ejerciéndoselo	ejercer	VGMSE
ejerciéndonoslo	ejercer	VGMSE
ejerciéndooslo	ejercer	VGMSE
ejerciéndomelos	ejercer	VGMPE
ejerciéndotelos	ejercer	VGMPE
ejerciéndoselos	ejercer	VGMPE
ejerciéndonoslos	ejercer	VGMPE
ejerciéndooslos	ejercer	VGMPE
ejerciéndomela	ejercer	VGFSE
ejerciéndotela	ejercer	VGFSE
ejerciéndosela	ejercer	VGFSE
ejerciéndonosla	ejercer	VGFSE
ejerciéndoosla	ejercer	VGFSE
ejerciéndomelas	ejercer	VGFPE
ejerciéndotelas	ejercer	VGFPE
ejerciéndoselas	ejercer	VGFPE
ejerciéndonoslas	ejercer	VGFPE
ejerciéndooslas	ejercer	VGFPE
ejecutar	ejecutar	O
ejecuto	ejecutar	VIP1
ejecutas	ejecutar	VIP2
ejecuta	ejecutar	VIP3
ejecutamos	ejecutar	VIP4
ejecutáis	ejecutar	VIP5
ejecutan	ejecutar	VIP6
ejecutaba	ejecutar	VII1
ejecutabas	ejecutar	VII2
ejecutábamos	ejecutar	VII4
ejecutabais	ejecutar	VII5
ejecutaban	ejecutar	VII6
ejecutaré	ejecutar	VIF1
ejecutarás	ejecutar	VIF2
ejecutará	ejecutar	VIF3
ejecutaremos	ejecutar	VIF4
ejecutaréis	ejecutar	VIF5
ejecutarán	ejecutar	VIF6
ejecutaría	ejecutar	VIC1
ejecutarías	ejecutar	VIC2
ejecutaría	ejecutar	VIC3
ejecutaríamos	ejecutar	VIC4
ejecutaríais	ejecutar	VIC5
ejecutarían	ejecutar	VIC6
ejecuté	ejecutar	VIX1
ejecutaste	ejecutar	VIX2
ejecutó	ejecutar	VIX3
ejecutasteis	ejecutar	VIX5
ejecutaron	ejecutar	VIX6
ejecute	ejecutar	VSP1
ejecutes	ejecutar	VSP2
ejecutemos	ejecutar	VSP4
ejecutéis	ejecutar	VSP5
ejecuten	ejecutar	VSP6
ejecutara	ejecutar	VSX1
ejecutaras	ejecutar	VSX2
ejecutáramos	ejecutar	VSX4
ejecutarais	ejecutar	VSX5
ejecutaran	ejecutar	VSX6
ejecutare	ejecutar	VSF1
ejecutares	ejecutar	VSF2
ejecutáremos	ejecutar	VSF4
ejecutareis	ejecutar	VSF5
ejecutaren	ejecutar	VSF6
ejecutase	ejecutar	VSI1
ejecutases	ejecutar	VSI2
ejecutásemos	ejecutar	VSI4
ejecutaseis	ejecutar	VSI5
ejecutasen	ejecutar	VSI6
ejecutad	ejecutar	VMP
ejecutadme	ejecutar	VMSE
ejecutadle	ejecutar	VMSE
ejecutadnos	ejecutar	VMPE
ejecutaos	ejecutar	VMPE
ejecutadles	ejecutar	VMPE
ejecutadlo	ejecutar	VMMSE
ejecutadla	ejecutar	VMFSE
ejecutadlos	ejecutar	VMMPE
ejecutadlas	ejecutar	VMFPE
ejecutádmelo	ejecutar	VMMSE
ejecutádselo	ejecutar	VMMSE
ejecutádnoslo	ejecutar	VMMSE
ejecutáoslo	ejecutar	VMMSE
ejecutádmelos	ejecutar	VMMPE
ejecutádselos	ejecutar	VMMPE
ejecutádnoslos	ejecutar	VMMPE
ejecutáoslos	ejecutar	VMMPE
ejecutádmela	ejecutar	VMFSE
ejecutádsela	ejecutar	VMFSE
ejecutádnosla	ejecutar	VMFSE
ejecutáosla	ejecutar	VMFSE
ejecutádmelas	ejecutar	VMFPE
ejecutádselas	ejecutar	VMFPE
ejecutádnoslas	ejecutar	VMFPE
ejecutáoslas	ejecutar	VMFPE
ejecutado	ejecutar	VPM
ejecutados	ejecutar	VPMP
ejecutada	ejecutar	VPF
ejecutadas	ejecutar	VPFP
ejecutando	ejecutar	VG
ejecutándome	ejecutar	VGSE
ejecutándote	ejecutar	VGSE
ejecutándole	ejecutar	VGSE
ejecutándonos	ejecutar	VGPE
ejecutándoos	ejecutar	VGPE
ejecutándolo	ejecutar	VGMSE
ejecutándola	ejecutar	VGFSE
ejecutándolos	ejecutar	VGMPE
ejecutándolas	ejecutar	VGFPE
ejecutándomelo	ejecutar	VGMSE
ejecutándotelo	ejecutar	VGMSE
ejecutándoselo	ejecutar	VGMSE
ejecutándonoslo	ejecutar	VGMSE
ejecutándooslo	ejecutar	VGMSE
ejecutándomelos	ejecutar	VGMPE
ejecutándotelos	ejecutar	VGMPE
ejecutándoselos	ejecutar	VGMPE
ejecutándonoslos	ejecutar	VGMPE
ejecutándooslos	ejecutar	VGMPE
ejecutándomela	ejecutar	VGFSE
ejecutándotela	ejecutar	VGFSE
ejecutándosela	ejecutar	VGFSE
ejecutándonosla	ejecutar	VGFSE
ejecutándoosla	ejecutar	VGFSE
ejecutándomelas	ejecutar	VGFPE
ejecutándotelas	ejecutar	VGFPE
ejecutándoselas	ejecutar	VGFPE
ejecutándonoslas	ejecutar	VGFPE
ejecutándooslas	ejecutar	VGFPE
ejecutoriar	ejecutoriar	O
ejecutorio	ejecutoriar	VIP1
ejecutorias	ejecutoriar	VIP2
ejecutoria	ejecutoriar	VIP3
ejecutoriamos	ejecutoriar	VIP4
ejecutoriáis	ejecutoriar	VIP5
ejecutorian	ejecutoriar	VIP6
ejecutoriaba	ejecutoriar	VII1
ejecutoriabas	ejecutoriar	VII2
ejecutoriábamos	ejecutoriar	VII4
ejecutoriabais	ejecutoriar	VII5
ejecutoriaban	ejecutoriar	VII6
ejecutoriaré	ejecutoriar	VIF1
ejecutoriarás	ejecutoriar	VIF2
ejecutoriará	ejecutoriar	VIF3
ejecutoriaremos	ejecutoriar	VIF4
ejecutoriaréis	ejecutoriar	VIF5
ejecutoriarán	ejecutoriar	VIF6
ejecutoriaría	ejecutoriar	VIC1
ejecutoriarías	ejecutoriar	VIC2
ejecutoriaría	ejecutoriar	VIC3
ejecutoriaríamos	ejecutoriar	VIC4
ejecutoriaríais	ejecutoriar	VIC5
ejecutoriarían	ejecutoriar	VIC6
ejecutorié	ejecutoriar	VIX1
ejecutoriaste	ejecutoriar	VIX2
ejecutorió	ejecutoriar	VIX3
ejecutoriasteis	ejecutoriar	VIX5
ejecutoriaron	ejecutoriar	VIX6
ejecutorie	ejecutoriar	VSP1
ejecutories	ejecutoriar	VSP2
ejecutoriemos	ejecutoriar	VSP4
ejecutoriéis	ejecutoriar	VSP5
ejecutorien	ejecutoriar	VSP6
ejecutoriara	ejecutoriar	VSX1
ejecutoriaras	ejecutoriar	VSX2
ejecutoriáramos	ejecutoriar	VSX4
ejecutoriarais	ejecutoriar	VSX5
ejecutoriaran	ejecutoriar	VSX6
ejecutoriare	ejecutoriar	VSF1
ejecutoriares	ejecutoriar	VSF2
ejecutoriáremos	ejecutoriar	VSF4
ejecutoriareis	ejecutoriar	VSF5
ejecutoriaren	ejecutoriar	VSF6
ejecutoriase	ejecutoriar	VSI1
ejecutoriases	ejecutoriar	VSI2
ejecutoriásemos	ejecutoriar	VSI4
ejecutoriaseis	ejecutoriar	VSI5
ejecutoriasen	ejecutoriar	VSI6
ejecutoriad	ejecutoriar	VMP
ejecutoriadme	ejecutoriar	VMSE
ejecutoriadle	ejecutoriar	VMSE
ejecutoriadnos	ejecutoriar	VMPE
ejecutoriaos	ejecutoriar	VMPE
ejecutoriadles	ejecutoriar	VMPE
ejecutoriadlo	ejecutoriar	VMMSE
ejecutoriadla	ejecutoriar	VMFSE
ejecutoriadlos	ejecutoriar	VMMPE
ejecutoriadlas	ejecutoriar	VMFPE
ejecutoriádmelo	ejecutoriar	VMMSE
ejecutoriádselo	ejecutoriar	VMMSE
ejecutoriádnoslo	ejecutoriar	VMMSE
ejecutoriáoslo	ejecutoriar	VMMSE
ejecutoriádmelos	ejecutoriar	VMMPE
ejecutoriádselos	ejecutoriar	VMMPE
ejecutoriádnoslos	ejecutoriar	VMMPE
ejecutoriáoslos	ejecutoriar	VMMPE
ejecutoriádmela	ejecutoriar	VMFSE
ejecutoriádsela	ejecutoriar	VMFSE
ejecutoriádnosla	ejecutoriar	VMFSE
ejecutoriáosla	ejecutoriar	VMFSE
ejecutoriádmelas	ejecutoriar	VMFPE
ejecutoriádselas	ejecutoriar	VMFPE
ejecutoriádnoslas	ejecutoriar	VMFPE
ejecutoriáoslas	ejecutoriar	VMFPE
ejecutoriado	ejecutoriar	VPM
ejecutoriados	ejecutoriar	VPMP
ejecutoriada	ejecutoriar	VPF
ejecutoriadas	ejecutoriar	VPFP
ejecutoriando	ejecutoriar	VG
ejecutoriándome	ejecutoriar	VGSE
ejecutoriándote	ejecutoriar	VGSE
ejecutoriándole	ejecutoriar	VGSE
ejecutoriándonos	ejecutoriar	VGPE
ejecutoriándoos	ejecutoriar	VGPE
ejecutoriándolo	ejecutoriar	VGMSE
ejecutoriándola	ejecutoriar	VGFSE
ejecutoriándolos	ejecutoriar	VGMPE
ejecutoriándolas	ejecutoriar	VGFPE
ejecutoriándomelo	ejecutoriar	VGMSE
ejecutoriándotelo	ejecutoriar	VGMSE
ejecutoriándoselo	ejecutoriar	VGMSE
ejecutoriándonoslo	ejecutoriar	VGMSE
ejecutoriándooslo	ejecutoriar	VGMSE
ejecutoriándomelos	ejecutoriar	VGMPE
ejecutoriándotelos	ejecutoriar	VGMPE
ejecutoriándoselos	ejecutoriar	VGMPE
ejecutoriándonoslos	ejecutoriar	VGMPE
ejecutoriándooslos	ejecutoriar	VGMPE
ejecutoriándomela	ejecutoriar	VGFSE
ejecutoriándotela	ejecutoriar	VGFSE
ejecutoriándosela	ejecutoriar	VGFSE
ejecutoriándonosla	ejecutoriar	VGFSE
ejecutoriándoosla	ejecutoriar	VGFSE
ejecutoriándomelas	ejecutoriar	VGFPE
ejecutoriándotelas	ejecutoriar	VGFPE
ejecutoriándoselas	ejecutoriar	VGFPE
ejecutoriándonoslas	ejecutoriar	VGFPE
ejecutoriándooslas	ejecutoriar	VGFPE
ejemplar	ejemplar	O
ejemplo	ejemplar	VIP1
ejemplas	ejemplar	VIP2
ejempla	ejemplar	VIP3
ejemplamos	ejemplar	VIP4
ejempláis	ejemplar	VIP5
ejemplan	ejemplar	VIP6
ejemplaba	ejemplar	VII1
ejemplabas	ejemplar	VII2
ejemplábamos	ejemplar	VII4
ejemplabais	ejemplar	VII5
ejemplaban	ejemplar	VII6
ejemplaré	ejemplar	VIF1
ejemplarás	ejemplar	VIF2
ejemplará	ejemplar	VIF3
ejemplaremos	ejemplar	VIF4
ejemplaréis	ejemplar	VIF5
ejemplarán	ejemplar	VIF6
ejemplaría	ejemplar	VIC1
ejemplarías	ejemplar	VIC2
ejemplaría	ejemplar	VIC3
ejemplaríamos	ejemplar	VIC4
ejemplaríais	ejemplar	VIC5
ejemplarían	ejemplar	VIC6
ejemplé	ejemplar	VIX1
ejemplaste	ejemplar	VIX2
ejempló	ejemplar	VIX3
ejemplasteis	ejemplar	VIX5
ejemplaron	ejemplar	VIX6
ejemple	ejemplar	VSP1
ejemples	ejemplar	VSP2
ejemplemos	ejemplar	VSP4
ejempléis	ejemplar	VSP5
ejemplen	ejemplar	VSP6
ejemplara	ejemplar	VSX1
ejemplaras	ejemplar	VSX2
ejempláramos	ejemplar	VSX4
ejemplarais	ejemplar	VSX5
ejemplaran	ejemplar	VSX6
ejemplare	ejemplar	VSF1
ejemplares	ejemplar	VSF2
ejempláremos	ejemplar	VSF4
ejemplareis	ejemplar	VSF5
ejemplaren	ejemplar	VSF6
ejemplase	ejemplar	VSI1
ejemplases	ejemplar	VSI2
ejemplásemos	ejemplar	VSI4
ejemplaseis	ejemplar	VSI5
ejemplasen	ejemplar	VSI6
ejemplad	ejemplar	VMP
ejempladme	ejemplar	VMSE
ejempladle	ejemplar	VMSE
ejempladnos	ejemplar	VMPE
ejemplaos	ejemplar	VMPE
ejempladles	ejemplar	VMPE
ejempladlo	ejemplar	VMMSE
ejempladla	ejemplar	VMFSE
ejempladlos	ejemplar	VMMPE
ejempladlas	ejemplar	VMFPE
ejempládmelo	ejemplar	VMMSE
ejempládselo	ejemplar	VMMSE
ejempládnoslo	ejemplar	VMMSE
ejempláoslo	ejemplar	VMMSE
ejempládmelos	ejemplar	VMMPE
ejempládselos	ejemplar	VMMPE
ejempládnoslos	ejemplar	VMMPE
ejempláoslos	ejemplar	VMMPE
ejempládmela	ejemplar	VMFSE
ejempládsela	ejemplar	VMFSE
ejempládnosla	ejemplar	VMFSE
ejempláosla	ejemplar	VMFSE
ejempládmelas	ejemplar	VMFPE
ejempládselas	ejemplar	VMFPE
ejempládnoslas	ejemplar	VMFPE
ejempláoslas	ejemplar	VMFPE
ejemplado	ejemplar	VPM
ejemplados	ejemplar	VPMP
ejemplada	ejemplar	VPF
ejempladas	ejemplar	VPFP
ejemplando	ejemplar	VG
ejemplándome	ejemplar	VGSE
ejemplándote	ejemplar	VGSE
ejemplándole	ejemplar	VGSE
ejemplándonos	ejemplar	VGPE
ejemplándoos	ejemplar	VGPE
ejemplándolo	ejemplar	VGMSE
ejemplándola	ejemplar	VGFSE
ejemplándolos	ejemplar	VGMPE
ejemplándolas	ejemplar	VGFPE
ejemplándomelo	ejemplar	VGMSE
ejemplándotelo	ejemplar	VGMSE
ejemplándoselo	ejemplar	VGMSE
ejemplándonoslo	ejemplar	VGMSE
ejemplándooslo	ejemplar	VGMSE
ejemplándomelos	ejemplar	VGMPE
ejemplándotelos	ejemplar	VGMPE
ejemplándoselos	ejemplar	VGMPE
ejemplándonoslos	ejemplar	VGMPE
ejemplándooslos	ejemplar	VGMPE
ejemplándomela	ejemplar	VGFSE
ejemplándotela	ejemplar	VGFSE
ejemplándosela	ejemplar	VGFSE
ejemplándonosla	ejemplar	VGFSE
ejemplándoosla	ejemplar	VGFSE
ejemplándomelas	ejemplar	VGFPE
ejemplándotelas	ejemplar	VGFPE
ejemplándoselas	ejemplar	VGFPE
ejemplándonoslas	ejemplar	VGFPE
ejemplándooslas	ejemplar	VGFPE
ejemplares	ejemplar	P
ejemplarizar	ejemplarizar	O
ejemplarizo	ejemplarizar	VIP1
ejemplarizas	ejemplarizar	VIP2
ejemplariza	ejemplarizar	VIP3
ejemplarizamos	ejemplarizar	VIP4
ejemplarizáis	ejemplarizar	VIP5
ejemplarizan	ejemplarizar	VIP6
ejemplarizaba	ejemplarizar	VII1
ejemplarizabas	ejemplarizar	VII2
ejemplarizábamos	ejemplarizar	VII4
ejemplarizabais	ejemplarizar	VII5
ejemplarizaban	ejemplarizar	VII6
ejemplarizaré	ejemplarizar	VIF1
ejemplarizarás	ejemplarizar	VIF2
ejemplarizará	ejemplarizar	VIF3
ejemplarizaremos	ejemplarizar	VIF4
ejemplarizaréis	ejemplarizar	VIF5
ejemplarizarán	ejemplarizar	VIF6
ejemplarizaría	ejemplarizar	VIC1
ejemplarizarías	ejemplarizar	VIC2
ejemplarizaría	ejemplarizar	VIC3
ejemplarizaríamos	ejemplarizar	VIC4
ejemplarizaríais	ejemplarizar	VIC5
ejemplarizarían	ejemplarizar	VIC6
ejemplaricé	ejemplarizar	VIX1
ejemplarizaste	ejemplarizar	VIX2
ejemplarizó	ejemplarizar	VIX3
ejemplarizasteis	ejemplarizar	VIX5
ejemplarizaron	ejemplarizar	VIX6
ejemplarice	ejemplarizar	VSP1
ejemplarices	ejemplarizar	VSP2
ejemplaricemos	ejemplarizar	VSP4
ejemplaricéis	ejemplarizar	VSP5
ejemplaricen	ejemplarizar	VSP6
ejemplarizara	ejemplarizar	VSX1
ejemplarizaras	ejemplarizar	VSX2
ejemplarizáramos	ejemplarizar	VSX4
ejemplarizarais	ejemplarizar	VSX5
ejemplarizaran	ejemplarizar	VSX6
ejemplarizare	ejemplarizar	VSF1
ejemplarizares	ejemplarizar	VSF2
ejemplarizáremos	ejemplarizar	VSF4
ejemplarizareis	ejemplarizar	VSF5
ejemplarizaren	ejemplarizar	VSF6
ejemplarizase	ejemplarizar	VSI1
ejemplarizases	ejemplarizar	VSI2
ejemplarizásemos	ejemplarizar	VSI4
ejemplarizaseis	ejemplarizar	VSI5
ejemplarizasen	ejemplarizar	VSI6
ejemplarizad	ejemplarizar	VMP
ejemplarizadme	ejemplarizar	VMSE
ejemplarizadle	ejemplarizar	VMSE
ejemplarizadnos	ejemplarizar	VMPE
ejemplarizaos	ejemplarizar	VMPE
ejemplarizadles	ejemplarizar	VMPE
ejemplarizadlo	ejemplarizar	VMMSE
ejemplarizadla	ejemplarizar	VMFSE
ejemplarizadlos	ejemplarizar	VMMPE
ejemplarizadlas	ejemplarizar	VMFPE
ejemplarizádmelo	ejemplarizar	VMMSE
ejemplarizádselo	ejemplarizar	VMMSE
ejemplarizádnoslo	ejemplarizar	VMMSE
ejemplarizáoslo	ejemplarizar	VMMSE
ejemplarizádmelos	ejemplarizar	VMMPE
ejemplarizádselos	ejemplarizar	VMMPE
ejemplarizádnoslos	ejemplarizar	VMMPE
ejemplarizáoslos	ejemplarizar	VMMPE
ejemplarizádmela	ejemplarizar	VMFSE
ejemplarizádsela	ejemplarizar	VMFSE
ejemplarizádnosla	ejemplarizar	VMFSE
ejemplarizáosla	ejemplarizar	VMFSE
ejemplarizádmelas	ejemplarizar	VMFPE
ejemplarizádselas	ejemplarizar	VMFPE
ejemplarizádnoslas	ejemplarizar	VMFPE
ejemplarizáoslas	ejemplarizar	VMFPE
ejemplarizado	ejemplarizar	VPM
ejemplarizados	ejemplarizar	VPMP
ejemplarizada	ejemplarizar	VPF
ejemplarizadas	ejemplarizar	VPFP
ejemplarizando	ejemplarizar	VG
ejemplarizándome	ejemplarizar	VGSE
ejemplarizándote	ejemplarizar	VGSE
ejemplarizándole	ejemplarizar	VGSE
ejemplarizándonos	ejemplarizar	VGPE
ejemplarizándoos	ejemplarizar	VGPE
ejemplarizándolo	ejemplarizar	VGMSE
ejemplarizándola	ejemplarizar	VGFSE
ejemplarizándolos	ejemplarizar	VGMPE
ejemplarizándolas	ejemplarizar	VGFPE
ejemplarizándomelo	ejemplarizar	VGMSE
ejemplarizándotelo	ejemplarizar	VGMSE
ejemplarizándoselo	ejemplarizar	VGMSE
ejemplarizándonoslo	ejemplarizar	VGMSE
ejemplarizándooslo	ejemplarizar	VGMSE
ejemplarizándomelos	ejemplarizar	VGMPE
ejemplarizándotelos	ejemplarizar	VGMPE
ejemplarizándoselos	ejemplarizar	VGMPE
ejemplarizándonoslos	ejemplarizar	VGMPE
ejemplarizándooslos	ejemplarizar	VGMPE
ejemplarizándomela	ejemplarizar	VGFSE
ejemplarizándotela	ejemplarizar	VGFSE
ejemplarizándosela	ejemplarizar	VGFSE
ejemplarizándonosla	ejemplarizar	VGFSE
ejemplarizándoosla	ejemplarizar	VGFSE
ejemplarizándomelas	ejemplarizar	VGFPE
ejemplarizándotelas	ejemplarizar	VGFPE
ejemplarizándoselas	ejemplarizar	VGFPE
ejemplarizándonoslas	ejemplarizar	VGFPE
ejemplarizándooslas	ejemplarizar	VGFPE
ejemplificar	ejemplificar	O
ejemplifico	ejemplificar	VIP1
ejemplificas	ejemplificar	VIP2
ejemplifica	ejemplificar	VIP3
ejemplificamos	ejemplificar	VIP4
ejemplificáis	ejemplificar	VIP5
ejemplifican	ejemplificar	VIP6
ejemplificaba	ejemplificar	VII1
ejemplificabas	ejemplificar	VII2
ejemplificábamos	ejemplificar	VII4
ejemplificabais	ejemplificar	VII5
ejemplificaban	ejemplificar	VII6
ejemplificaré	ejemplificar	VIF1
ejemplificarás	ejemplificar	VIF2
ejemplificará	ejemplificar	VIF3
ejemplificaremos	ejemplificar	VIF4
ejemplificaréis	ejemplificar	VIF5
ejemplificarán	ejemplificar	VIF6
ejemplificaría	ejemplificar	VIC1
ejemplificarías	ejemplificar	VIC2
ejemplificaría	ejemplificar	VIC3
ejemplificaríamos	ejemplificar	VIC4
ejemplificaríais	ejemplificar	VIC5
ejemplificarían	ejemplificar	VIC6
ejemplifiqué	ejemplificar	VIX1
ejemplificaste	ejemplificar	VIX2
ejemplificó	ejemplificar	VIX3
ejemplificasteis	ejemplificar	VIX5
ejemplificaron	ejemplificar	VIX6
ejemplifique	ejemplificar	VSP1
ejemplifiques	ejemplificar	VSP2
ejemplifiquemos	ejemplificar	VSP4
ejemplifiquéis	ejemplificar	VSP5
ejemplifiquen	ejemplificar	VSP6
ejemplificara	ejemplificar	VSX1
ejemplificaras	ejemplificar	VSX2
ejemplificáramos	ejemplificar	VSX4
ejemplificarais	ejemplificar	VSX5
ejemplificaran	ejemplificar	VSX6
ejemplificare	ejemplificar	VSF1
ejemplificares	ejemplificar	VSF2
ejemplificáremos	ejemplificar	VSF4
ejemplificareis	ejemplificar	VSF5
ejemplificaren	ejemplificar	VSF6
ejemplificase	ejemplificar	VSI1
ejemplificases	ejemplificar	VSI2
ejemplificásemos	ejemplificar	VSI4
ejemplificaseis	ejemplificar	VSI5
ejemplificasen	ejemplificar	VSI6
ejemplificad	ejemplificar	VMP
ejemplificadme	ejemplificar	VMSE
ejemplificadle	ejemplificar	VMSE
ejemplificadnos	ejemplificar	VMPE
ejemplificaos	ejemplificar	VMPE
ejemplificadles	ejemplificar	VMPE
ejemplificadlo	ejemplificar	VMMSE
ejemplificadla	ejemplificar	VMFSE
ejemplificadlos	ejemplificar	VMMPE
ejemplificadlas	ejemplificar	VMFPE
ejemplificádmelo	ejemplificar	VMMSE
ejemplificádselo	ejemplificar	VMMSE
ejemplificádnoslo	ejemplificar	VMMSE
ejemplificáoslo	ejemplificar	VMMSE
ejemplificádmelos	ejemplificar	VMMPE
ejemplificádselos	ejemplificar	VMMPE
ejemplificádnoslos	ejemplificar	VMMPE
ejemplificáoslos	ejemplificar	VMMPE
ejemplificádmela	ejemplificar	VMFSE
ejemplificádsela	ejemplificar	VMFSE
ejemplificádnosla	ejemplificar	VMFSE
ejemplificáosla	ejemplificar	VMFSE
ejemplificádmelas	ejemplificar	VMFPE
ejemplificádselas	ejemplificar	VMFPE
ejemplificádnoslas	ejemplificar	VMFPE
ejemplificáoslas	ejemplificar	VMFPE
ejemplificado	ejemplificar	VPM
ejemplificados	ejemplificar	VPMP
ejemplificada	ejemplificar	VPF
ejemplificadas	ejemplificar	VPFP
ejemplificando	ejemplificar	VG
ejemplificándome	ejemplificar	VGSE
ejemplificándote	ejemplificar	VGSE
ejemplificándole	ejemplificar	VGSE
ejemplificándonos	ejemplificar	VGPE
ejemplificándoos	ejemplificar	VGPE
ejemplificándolo	ejemplificar	VGMSE
ejemplificándola	ejemplificar	VGFSE
ejemplificándolos	ejemplificar	VGMPE
ejemplificándolas	ejemplificar	VGFPE
ejemplificándomelo	ejemplificar	VGMSE
ejemplificándotelo	ejemplificar	VGMSE
ejemplificándoselo	ejemplificar	VGMSE
ejemplificándonoslo	ejemplificar	VGMSE
ejemplificándooslo	ejemplificar	VGMSE
ejemplificándomelos	ejemplificar	VGMPE
ejemplificándotelos	ejemplificar	VGMPE
ejemplificándoselos	ejemplificar	VGMPE
ejemplificándonoslos	ejemplificar	VGMPE
ejemplificándooslos	ejemplificar	VGMPE
ejemplificándomela	ejemplificar	VGFSE
ejemplificándotela	ejemplificar	VGFSE
ejemplificándosela	ejemplificar	VGFSE
ejemplificándonosla	ejemplificar	VGFSE
ejemplificándoosla	ejemplificar	VGFSE
ejemplificándomelas	ejemplificar	VGFPE
ejemplificándotelas	ejemplificar	VGFPE
ejemplificándoselas	ejemplificar	VGFPE
ejemplificándonoslas	ejemplificar	VGFPE
ejemplificándooslas	ejemplificar	VGFPE
ejercitar	ejercitar	O
ejercito	ejercitar	VIP1
ejercitas	ejercitar	VIP2
ejercita	ejercitar	VIP3
ejercitamos	ejercitar	VIP4
ejercitáis	ejercitar	VIP5
ejercitan	ejercitar	VIP6
ejercitaba	ejercitar	VII1
ejercitabas	ejercitar	VII2
ejercitábamos	ejercitar	VII4
ejercitabais	ejercitar	VII5
ejercitaban	ejercitar	VII6
ejercitaré	ejercitar	VIF1
ejercitarás	ejercitar	VIF2
ejercitará	ejercitar	VIF3
ejercitaremos	ejercitar	VIF4
ejercitaréis	ejercitar	VIF5
ejercitarán	ejercitar	VIF6
ejercitaría	ejercitar	VIC1
ejercitarías	ejercitar	VIC2
ejercitaría	ejercitar	VIC3
ejercitaríamos	ejercitar	VIC4
ejercitaríais	ejercitar	VIC5
ejercitarían	ejercitar	VIC6
ejercité	ejercitar	VIX1
ejercitaste	ejercitar	VIX2
ejercitó	ejercitar	VIX3
ejercitasteis	ejercitar	VIX5
ejercitaron	ejercitar	VIX6
ejercite	ejercitar	VSP1
ejercites	ejercitar	VSP2
ejercitemos	ejercitar	VSP4
ejercitéis	ejercitar	VSP5
ejerciten	ejercitar	VSP6
ejercitara	ejercitar	VSX1
ejercitaras	ejercitar	VSX2
ejercitáramos	ejercitar	VSX4
ejercitarais	ejercitar	VSX5
ejercitaran	ejercitar	VSX6
ejercitare	ejercitar	VSF1
ejercitares	ejercitar	VSF2
ejercitáremos	ejercitar	VSF4
ejercitareis	ejercitar	VSF5
ejercitaren	ejercitar	VSF6
ejercitase	ejercitar	VSI1
ejercitases	ejercitar	VSI2
ejercitásemos	ejercitar	VSI4
ejercitaseis	ejercitar	VSI5
ejercitasen	ejercitar	VSI6
ejercitad	ejercitar	VMP
ejercitadme	ejercitar	VMSE
ejercitadle	ejercitar	VMSE
ejercitadnos	ejercitar	VMPE
ejercitaos	ejercitar	VMPE
ejercitadles	ejercitar	VMPE
ejercitadlo	ejercitar	VMMSE
ejercitadla	ejercitar	VMFSE
ejercitadlos	ejercitar	VMMPE
ejercitadlas	ejercitar	VMFPE
ejercitádmelo	ejercitar	VMMSE
ejercitádselo	ejercitar	VMMSE
ejercitádnoslo	ejercitar	VMMSE
ejercitáoslo	ejercitar	VMMSE
ejercitádmelos	ejercitar	VMMPE
ejercitádselos	ejercitar	VMMPE
ejercitádnoslos	ejercitar	VMMPE
ejercitáoslos	ejercitar	VMMPE
ejercitádmela	ejercitar	VMFSE
ejercitádsela	ejercitar	VMFSE
ejercitádnosla	ejercitar	VMFSE
ejercitáosla	ejercitar	VMFSE
ejercitádmelas	ejercitar	VMFPE
ejercitádselas	ejercitar	VMFPE
ejercitádnoslas	ejercitar	VMFPE
ejercitáoslas	ejercitar	VMFPE
ejercitado	ejercitar	VPM
ejercitados	ejercitar	VPMP
ejercitada	ejercitar	VPF
ejercitadas	ejercitar	VPFP
ejercitando	ejercitar	VG
ejercitándome	ejercitar	VGSE
ejercitándote	ejercitar	VGSE
ejercitándole	ejercitar	VGSE
ejercitándonos	ejercitar	VGPE
ejercitándoos	ejercitar	VGPE
ejercitándolo	ejercitar	VGMSE
ejercitándola	ejercitar	VGFSE
ejercitándolos	ejercitar	VGMPE
ejercitándolas	ejercitar	VGFPE
ejercitándomelo	ejercitar	VGMSE
ejercitándotelo	ejercitar	VGMSE
ejercitándoselo	ejercitar	VGMSE
ejercitándonoslo	ejercitar	VGMSE
ejercitándooslo	ejercitar	VGMSE
ejercitándomelos	ejercitar	VGMPE
ejercitándotelos	ejercitar	VGMPE
ejercitándoselos	ejercitar	VGMPE
ejercitándonoslos	ejercitar	VGMPE
ejercitándooslos	ejercitar	VGMPE
ejercitándomela	ejercitar	VGFSE
ejercitándotela	ejercitar	VGFSE
ejercitándosela	ejercitar	VGFSE
ejercitándonosla	ejercitar	VGFSE
ejercitándoosla	ejercitar	VGFSE
ejercitándomelas	ejercitar	VGFPE
ejercitándotelas	ejercitar	VGFPE
ejercitándoselas	ejercitar	VGFPE
ejercitándonoslas	ejercitar	VGFPE
ejercitándooslas	ejercitar	VGFPE
