falacia	falacia	O
falacias	falacia	P
falago	falago	O
falagos	falago	P
falaguero	falaguero	O
falagueras	falaguero	FP
falaguera	falaguero	F
falagueros	falaguero	P
falagüeño	falagüeño	O
falagüeñas	falagüeño	FP
falagüeña	falagüeño	F
falagüeños	falagüeño	P
falange	falange	O
falanges	falange	P
falangeta	falangeta	O
falangetas	falangeta	P
falangia	falangia	O
falangias	falangia	P
falangiano	falangiano	O
falangianas	falangiano	FP
falangiana	falangiano	F
falangianos	falangiano	P
falangina	falangina	O
falanginas	falangina	P
falangio	falangio	O
falangios	falangio	P
falangismo	falangismo	O
falangismos	falangismo	P
falangista	falangista	O
falangistas	falangista	P
falansterio	falansterio	O
falansterios	falansterio	P
falaris	falaris	O
falaropo	falaropo	O
falaropos	falaropo	P
falaz	falaz	O
falaces	falaz	P
falazmente	falazmente	O
falbalá	falbalá	O
falbalás	falbalá	P
falca	falca	O
falcas	falca	P
falcado	falcado	O
falcadas	falcado	FP
falcada	falcado	F
falcados	falcado	P
falcario	falcario	O
falcarios	falcario	P
falce	falce	O
falces	falce	P
falcidia	falcidia	O
falcidias	falcidia	P
falciforme	falciforme	O
falciformes	falciforme	P
falcinelo	falcinelo	O
falcinelos	falcinelo	P
falcino	falcino	O
falcinos	falcino	P
falcirrostro	falcirrostro	O
falcirrostras	falcirrostro	FP
falcirrostra	falcirrostro	F
falcirrostros	falcirrostro	P
falconete	falconete	O
falconetes	falconete	P
falconiano	falconiano	O
falconianas	falconiano	FP
falconiana	falconiano	F
falconianos	falconiano	P
falconiforme	falconiforme	O
falconiformes	falconiforme	P
falcón	falcón	O
falcones	falcón	P
falcónido	falcónido	O
falcónidas	falcónido	FP
falcónida	falcónido	F
falcónidos	falcónido	P
falda	falda	O
faldas	falda	P
faldamenta	faldamenta	O
faldamentas	faldamenta	P
faldamento	faldamento	O
faldamentos	faldamento	P
faldar	faldar	O
faldares	faldar	P
faldellín	faldellín	O
faldellines	faldellín	P
faldeo	faldeo	O
faldeos	faldeo	P
faldero	faldero	O
falderas	faldero	FP
faldera	faldero	F
falderos	faldero	P
faldeta	faldeta	O
faldetas	faldeta	P
faldicorto	faldicorto	O
faldicortas	faldicorto	FP
faldicorta	faldicorto	F
faldicortos	faldicorto	P
faldillas	faldillas	O
faldinegro	faldinegro	O
faldinegras	faldinegro	FP
faldinegra	faldinegro	F
faldinegros	faldinegro	P
faldistorio	faldistorio	O
faldistorios	faldistorio	P
faldriquera	faldriquera	O
faldriqueras	faldriquera	P
faldudo	faldudo	O
faldudas	faldudo	FP
falduda	faldudo	F
faldudos	faldudo	P
faldulario	faldulario	O
faldularios	faldulario	P
faldón	faldón	O
faldones	faldón	P
falecio	falecio	O
falecios	falecio	P
falena	falena	O
falenas	falena	P
falencia	falencia	O
falencias	falencia	P
falerno	falerno	O
falernos	falerno	P
faleucio	faleucio	O
faleucios	faleucio	P
faleuco	faleuco	O
faleucos	faleuco	P
falibilidad	falibilidad	O
falibilidades	falibilidad	P
falible	falible	O
falibles	falible	P
falidamente	falidamente	O
falido	falido	O
falidas	falido	FP
falida	falido	F
falidos	falido	P
falimiento	falimiento	O
falimientos	falimiento	P
falisco	falisco	O
faliscos	falisco	P
falla	falla	O
fallas	falla	P
fallada	fallada	O
falladas	fallada	P
fallador	fallador	O
falladoras	fallador	FP
falladora	fallador	F
falladores	fallador	P
fallanca	fallanca	O
fallancas	fallanca	P
falleba	falleba	O
fallebas	falleba	P
fallecedero	fallecedero	O
fallecederas	fallecedero	FP
fallecedera	fallecedero	F
fallecederos	fallecedero	P
fallecido	fallecido	O
fallecidas	fallecido	FP
fallecida	fallecido	F
fallecidos	fallecido	P
fallecimiento	fallecimiento	O
fallecimientos	fallecimiento	P
fallero	fallero	O
falleras	fallero	FP
fallera	fallero	F
falleros	fallero	P
fallidero	fallidero	O
fallideras	fallidero	FP
fallidera	fallidero	F
fallideros	fallidero	P
fallido	fallido	O
fallidas	fallido	FP
fallida	fallido	F
fallidos	fallido	P
fallo	fallo	O
fallas	fallo	FP
falla	fallo	F
fallos	fallo	P
falluto	falluto	O
fallutas	falluto	FP
falluta	falluto	F
fallutos	falluto	P
falo	falo	O
falos	falo	P
falocracia	falocracia	O
falocracias	falocracia	P
falordia	falordia	O
falordias	falordia	P
faloria	faloria	O
falorias	faloria	P
falquía	falquía	O
falquías	falquía	P
falsa	falsa	O
falsas	falsa	P
falsaarmadura	falsaarmadura	O
falsaarmaduras	falsaarmadura	P
falsabraga	falsabraga	O
falsabragas	falsabraga	P
falsada	falsada	O
falsadas	falsada	P
falsamente	falsamente	O
falsario	falsario	O
falsarias	falsario	FP
falsaria	falsario	F
falsarios	falsario	P
falsarregla	falsarregla	O
falsarreglas	falsarregla	P
falseador	falseador	O
falseadoras	falseador	FP
falseadora	falseador	F
falseadores	falseador	P
falseamiento	falseamiento	O
falseamientos	falseamiento	P
falsedad	falsedad	O
falsedades	falsedad	P
falseo	falseo	O
falseos	falseo	P
falseta	falseta	O
falsetas	falseta	P
falsete	falsete	O
falsetes	falsete	P
falsificación	falsificación	O
falsificaciones	falsificación	P
falsificador	falsificador	O
falsificadoras	falsificador	FP
falsificadora	falsificador	F
falsificadores	falsificador	P
falsilla	falsilla	O
falsillas	falsilla	P
falso	falso	O
falsas	falso	FP
falsa	falso	F
falsos	falso	P
falsopeto	falsopeto	O
falsopetos	falsopeto	P
falsía	falsía	O
falsías	falsía	P
falta	falta	O
faltas	falta	P
falte	falte	O
faltes	falte	P
faltista	faltista	O
faltistas	faltista	P
falto	falto	O
faltas	falto	FP
falta	falto	F
faltos	falto	P
faltoso	faltoso	O
faltosas	faltoso	FP
faltosa	faltoso	F
faltosos	faltoso	P
faltrero	faltrero	O
faltreras	faltrero	FP
faltrera	faltrero	F
faltreros	faltrero	P
faltriquera	faltriquera	O
faltriqueras	faltriquera	P
faltón	faltón	O
faltonas	faltón	FP
faltona	faltón	F
faltones	faltón	P
faluca	faluca	O
falucas	faluca	P
falucho	falucho	O
faluchos	falucho	P
falárica	falárica	O
faláricas	falárica	P
falócrata	falócrata	O
falócratas	falócrata	P
falúa	falúa	O
falúas	falúa	P
fálico	fálico	O
fálicas	fálico	FP
fálica	fálico	F
fálicos	fálico	P
fallecer	fallecer	O
fallezco	fallecer	VIP1
falleces	fallecer	VIP2
fallece	fallecer	VIP3
fallecemos	fallecer	VIP4
fallecéis	fallecer	VIP5
fallecen	fallecer	VIP6
fallecía	fallecer	VII1
fallecías	fallecer	VII2
fallecíamos	fallecer	VII4
fallecíais	fallecer	VII5
fallecían	fallecer	VII6
falleceré	fallecer	VIF1
fallecerás	fallecer	VIF2
fallecerá	fallecer	VIF3
falleceremos	fallecer	VIF4
falleceréis	fallecer	VIF5
fallecerán	fallecer	VIF6
fallecería	fallecer	VIC1
fallecerías	fallecer	VIC2
fallecería	fallecer	VIC3
falleceríamos	fallecer	VIC4
falleceríais	fallecer	VIC5
fallecerían	fallecer	VIC6
fallecí	fallecer	VIX1
falleciste	fallecer	VIX2
falleció	fallecer	VIX3
fallecisteis	fallecer	VIX5
fallecieron	fallecer	VIX6
fallezca	fallecer	VSP1
fallezcas	fallecer	VSP2
fallezcamos	fallecer	VSP4
fallezcáis	fallecer	VSP5
fallezcan	fallecer	VSP6
falleciera	fallecer	VSX1
fallecieras	fallecer	VSX2
falleciéramos	fallecer	VSX4
fallecierais	fallecer	VSX5
fallecieran	fallecer	VSX6
falleciere	fallecer	VSF1
fallecieres	fallecer	VSF2
falleciéremos	fallecer	VSF4
falleciereis	fallecer	VSF5
fallecieren	fallecer	VSF6
falleciese	fallecer	VSI1
fallecieses	fallecer	VSI2
falleciésemos	fallecer	VSI4
fallecieseis	fallecer	VSI5
falleciesen	fallecer	VSI6
falleced	fallecer	VMP
fallecedme	fallecer	VMSE
fallecedle	fallecer	VMSE
fallecednos	fallecer	VMPE
falleceos	fallecer	VMPE
fallecedles	fallecer	VMPE
fallecido	fallecer	VPM
fallecidos	fallecer	VPMP
fallecida	fallecer	VPF
fallecidas	fallecer	VPFP
falleciendo	fallecer	VG
falleciéndome	fallecer	VGSE
falleciéndote	fallecer	VGSE
falleciéndole	fallecer	VGSE
falleciéndonos	fallecer	VGPE
falleciéndoos	fallecer	VGPE
falagar	falagar	O
falago	falagar	VIP1
falagas	falagar	VIP2
falaga	falagar	VIP3
falagamos	falagar	VIP4
falagáis	falagar	VIP5
falagan	falagar	VIP6
falagaba	falagar	VII1
falagabas	falagar	VII2
falagábamos	falagar	VII4
falagabais	falagar	VII5
falagaban	falagar	VII6
falagaré	falagar	VIF1
falagarás	falagar	VIF2
falagará	falagar	VIF3
falagaremos	falagar	VIF4
falagaréis	falagar	VIF5
falagarán	falagar	VIF6
falagaría	falagar	VIC1
falagarías	falagar	VIC2
falagaría	falagar	VIC3
falagaríamos	falagar	VIC4
falagaríais	falagar	VIC5
falagarían	falagar	VIC6
falagé	falagar	VIX1
falagaste	falagar	VIX2
falagó	falagar	VIX3
falagasteis	falagar	VIX5
falagaron	falagar	VIX6
falague	falagar	VSP1
falagues	falagar	VSP2
falaguemos	falagar	VSP4
falaguéis	falagar	VSP5
falaguen	falagar	VSP6
falagara	falagar	VSX1
falagaras	falagar	VSX2
falagáramos	falagar	VSX4
falagarais	falagar	VSX5
falagaran	falagar	VSX6
falagare	falagar	VSF1
falagares	falagar	VSF2
falagáremos	falagar	VSF4
falagareis	falagar	VSF5
falagaren	falagar	VSF6
falagase	falagar	VSI1
falagases	falagar	VSI2
falagásemos	falagar	VSI4
falagaseis	falagar	VSI5
falagasen	falagar	VSI6
falagad	falagar	VMP
falagadme	falagar	VMSE
falagadle	falagar	VMSE
falagadnos	falagar	VMPE
falagaos	falagar	VMPE
falagadles	falagar	VMPE
falagadlo	falagar	VMMSE
falagadla	falagar	VMFSE
falagadlos	falagar	VMMPE
falagadlas	falagar	VMFPE
falagádmelo	falagar	VMMSE
falagádselo	falagar	VMMSE
falagádnoslo	falagar	VMMSE
falagáoslo	falagar	VMMSE
falagádmelos	falagar	VMMPE
falagádselos	falagar	VMMPE
falagádnoslos	falagar	VMMPE
falagáoslos	falagar	VMMPE
falagádmela	falagar	VMFSE
falagádsela	falagar	VMFSE
falagádnosla	falagar	VMFSE
falagáosla	falagar	VMFSE
falagádmelas	falagar	VMFPE
falagádselas	falagar	VMFPE
falagádnoslas	falagar	VMFPE
falagáoslas	falagar	VMFPE
falagado	falagar	VPM
falagados	falagar	VPMP
falagada	falagar	VPF
falagadas	falagar	VPFP
falagando	falagar	VG
falagándome	falagar	VGSE
falagándote	falagar	VGSE
falagándole	falagar	VGSE
falagándonos	falagar	VGPE
falagándoos	falagar	VGPE
falagándolo	falagar	VGMSE
falagándola	falagar	VGFSE
falagándolos	falagar	VGMPE
falagándolas	falagar	VGFPE
falagándomelo	falagar	VGMSE
falagándotelo	falagar	VGMSE
falagándoselo	falagar	VGMSE
falagándonoslo	falagar	VGMSE
falagándooslo	falagar	VGMSE
falagándomelos	falagar	VGMPE
falagándotelos	falagar	VGMPE
falagándoselos	falagar	VGMPE
falagándonoslos	falagar	VGMPE
falagándooslos	falagar	VGMPE
falagándomela	falagar	VGFSE
falagándotela	falagar	VGFSE
falagándosela	falagar	VGFSE
falagándonosla	falagar	VGFSE
falagándoosla	falagar	VGFSE
falagándomelas	falagar	VGFPE
falagándotelas	falagar	VGFPE
falagándoselas	falagar	VGFPE
falagándonoslas	falagar	VGFPE
falagándooslas	falagar	VGFPE
falcar	falcar	O
falco	falcar	VIP1
falcas	falcar	VIP2
falca	falcar	VIP3
falcamos	falcar	VIP4
falcáis	falcar	VIP5
falcan	falcar	VIP6
falcaba	falcar	VII1
falcabas	falcar	VII2
falcábamos	falcar	VII4
falcabais	falcar	VII5
falcaban	falcar	VII6
falcaré	falcar	VIF1
falcarás	falcar	VIF2
falcará	falcar	VIF3
falcaremos	falcar	VIF4
falcaréis	falcar	VIF5
falcarán	falcar	VIF6
falcaría	falcar	VIC1
falcarías	falcar	VIC2
falcaría	falcar	VIC3
falcaríamos	falcar	VIC4
falcaríais	falcar	VIC5
falcarían	falcar	VIC6
falqué	falcar	VIX1
falcaste	falcar	VIX2
falcó	falcar	VIX3
falcasteis	falcar	VIX5
falcaron	falcar	VIX6
falque	falcar	VSP1
falques	falcar	VSP2
falquemos	falcar	VSP4
falquéis	falcar	VSP5
falquen	falcar	VSP6
falcara	falcar	VSX1
falcaras	falcar	VSX2
falcáramos	falcar	VSX4
falcarais	falcar	VSX5
falcaran	falcar	VSX6
falcare	falcar	VSF1
falcares	falcar	VSF2
falcáremos	falcar	VSF4
falcareis	falcar	VSF5
falcaren	falcar	VSF6
falcase	falcar	VSI1
falcases	falcar	VSI2
falcásemos	falcar	VSI4
falcaseis	falcar	VSI5
falcasen	falcar	VSI6
falcad	falcar	VMP
falcadme	falcar	VMSE
falcadle	falcar	VMSE
falcadnos	falcar	VMPE
falcaos	falcar	VMPE
falcadles	falcar	VMPE
falcadlo	falcar	VMMSE
falcadla	falcar	VMFSE
falcadlos	falcar	VMMPE
falcadlas	falcar	VMFPE
falcádmelo	falcar	VMMSE
falcádselo	falcar	VMMSE
falcádnoslo	falcar	VMMSE
falcáoslo	falcar	VMMSE
falcádmelos	falcar	VMMPE
falcádselos	falcar	VMMPE
falcádnoslos	falcar	VMMPE
falcáoslos	falcar	VMMPE
falcádmela	falcar	VMFSE
falcádsela	falcar	VMFSE
falcádnosla	falcar	VMFSE
falcáosla	falcar	VMFSE
falcádmelas	falcar	VMFPE
falcádselas	falcar	VMFPE
falcádnoslas	falcar	VMFPE
falcáoslas	falcar	VMFPE
falcado	falcar	VPM
falcados	falcar	VPMP
falcada	falcar	VPF
falcadas	falcar	VPFP
falcando	falcar	VG
falcándome	falcar	VGSE
falcándote	falcar	VGSE
falcándole	falcar	VGSE
falcándonos	falcar	VGPE
falcándoos	falcar	VGPE
falcándolo	falcar	VGMSE
falcándola	falcar	VGFSE
falcándolos	falcar	VGMPE
falcándolas	falcar	VGFPE
falcándomelo	falcar	VGMSE
falcándotelo	falcar	VGMSE
falcándoselo	falcar	VGMSE
falcándonoslo	falcar	VGMSE
falcándooslo	falcar	VGMSE
falcándomelos	falcar	VGMPE
falcándotelos	falcar	VGMPE
falcándoselos	falcar	VGMPE
falcándonoslos	falcar	VGMPE
falcándooslos	falcar	VGMPE
falcándomela	falcar	VGFSE
falcándotela	falcar	VGFSE
falcándosela	falcar	VGFSE
falcándonosla	falcar	VGFSE
falcándoosla	falcar	VGFSE
falcándomelas	falcar	VGFPE
falcándotelas	falcar	VGFPE
falcándoselas	falcar	VGFPE
falcándonoslas	falcar	VGFPE
falcándooslas	falcar	VGFPE
faldear	faldear	O
faldeo	faldear	VIP1
faldeas	faldear	VIP2
faldea	faldear	VIP3
faldeamos	faldear	VIP4
faldeáis	faldear	VIP5
faldean	faldear	VIP6
faldeaba	faldear	VII1
faldeabas	faldear	VII2
faldeábamos	faldear	VII4
faldeabais	faldear	VII5
faldeaban	faldear	VII6
faldearé	faldear	VIF1
faldearás	faldear	VIF2
faldeará	faldear	VIF3
faldearemos	faldear	VIF4
faldearéis	faldear	VIF5
faldearán	faldear	VIF6
faldearía	faldear	VIC1
faldearías	faldear	VIC2
faldearía	faldear	VIC3
faldearíamos	faldear	VIC4
faldearíais	faldear	VIC5
faldearían	faldear	VIC6
faldeé	faldear	VIX1
faldeaste	faldear	VIX2
faldeó	faldear	VIX3
faldeasteis	faldear	VIX5
faldearon	faldear	VIX6
faldee	faldear	VSP1
faldees	faldear	VSP2
faldeemos	faldear	VSP4
faldeéis	faldear	VSP5
faldeen	faldear	VSP6
faldeara	faldear	VSX1
faldearas	faldear	VSX2
faldeáramos	faldear	VSX4
faldearais	faldear	VSX5
faldearan	faldear	VSX6
faldeare	faldear	VSF1
faldeares	faldear	VSF2
faldeáremos	faldear	VSF4
faldeareis	faldear	VSF5
faldearen	faldear	VSF6
faldease	faldear	VSI1
faldeases	faldear	VSI2
faldeásemos	faldear	VSI4
faldeaseis	faldear	VSI5
faldeasen	faldear	VSI6
faldead	faldear	VMP
faldeadme	faldear	VMSE
faldeadle	faldear	VMSE
faldeadnos	faldear	VMPE
faldeaos	faldear	VMPE
faldeadles	faldear	VMPE
faldeadlo	faldear	VMMSE
faldeadla	faldear	VMFSE
faldeadlos	faldear	VMMPE
faldeadlas	faldear	VMFPE
faldeádmelo	faldear	VMMSE
faldeádselo	faldear	VMMSE
faldeádnoslo	faldear	VMMSE
faldeáoslo	faldear	VMMSE
faldeádmelos	faldear	VMMPE
faldeádselos	faldear	VMMPE
faldeádnoslos	faldear	VMMPE
faldeáoslos	faldear	VMMPE
faldeádmela	faldear	VMFSE
faldeádsela	faldear	VMFSE
faldeádnosla	faldear	VMFSE
faldeáosla	faldear	VMFSE
faldeádmelas	faldear	VMFPE
faldeádselas	faldear	VMFPE
faldeádnoslas	faldear	VMFPE
faldeáoslas	faldear	VMFPE
faldeado	faldear	VPM
faldeados	faldear	VPMP
faldeada	faldear	VPF
faldeadas	faldear	VPFP
faldeando	faldear	VG
faldeándome	faldear	VGSE
faldeándote	faldear	VGSE
faldeándole	faldear	VGSE
faldeándonos	faldear	VGPE
faldeándoos	faldear	VGPE
faldeándolo	faldear	VGMSE
faldeándola	faldear	VGFSE
faldeándolos	faldear	VGMPE
faldeándolas	faldear	VGFPE
faldeándomelo	faldear	VGMSE
faldeándotelo	faldear	VGMSE
faldeándoselo	faldear	VGMSE
faldeándonoslo	faldear	VGMSE
faldeándooslo	faldear	VGMSE
faldeándomelos	faldear	VGMPE
faldeándotelos	faldear	VGMPE
faldeándoselos	faldear	VGMPE
faldeándonoslos	faldear	VGMPE
faldeándooslos	faldear	VGMPE
faldeándomela	faldear	VGFSE
faldeándotela	faldear	VGFSE
faldeándosela	faldear	VGFSE
faldeándonosla	faldear	VGFSE
faldeándoosla	faldear	VGFSE
faldeándomelas	faldear	VGFPE
faldeándotelas	faldear	VGFPE
faldeándoselas	faldear	VGFPE
faldeándonoslas	faldear	VGFPE
faldeándooslas	faldear	VGFPE
fallar	fallar	O
fallo	fallar	VIP1
fallas	fallar	VIP2
falla	fallar	VIP3
fallamos	fallar	VIP4
falláis	fallar	VIP5
fallan	fallar	VIP6
fallaba	fallar	VII1
fallabas	fallar	VII2
fallábamos	fallar	VII4
fallabais	fallar	VII5
fallaban	fallar	VII6
fallaré	fallar	VIF1
fallarás	fallar	VIF2
fallará	fallar	VIF3
fallaremos	fallar	VIF4
fallaréis	fallar	VIF5
fallarán	fallar	VIF6
fallaría	fallar	VIC1
fallarías	fallar	VIC2
fallaría	fallar	VIC3
fallaríamos	fallar	VIC4
fallaríais	fallar	VIC5
fallarían	fallar	VIC6
fallé	fallar	VIX1
fallaste	fallar	VIX2
falló	fallar	VIX3
fallasteis	fallar	VIX5
fallaron	fallar	VIX6
falle	fallar	VSP1
falles	fallar	VSP2
fallemos	fallar	VSP4
falléis	fallar	VSP5
fallen	fallar	VSP6
fallara	fallar	VSX1
fallaras	fallar	VSX2
falláramos	fallar	VSX4
fallarais	fallar	VSX5
fallaran	fallar	VSX6
fallare	fallar	VSF1
fallares	fallar	VSF2
falláremos	fallar	VSF4
fallareis	fallar	VSF5
fallaren	fallar	VSF6
fallase	fallar	VSI1
fallases	fallar	VSI2
fallásemos	fallar	VSI4
fallaseis	fallar	VSI5
fallasen	fallar	VSI6
fallad	fallar	VMP
falladme	fallar	VMSE
falladle	fallar	VMSE
falladnos	fallar	VMPE
fallaos	fallar	VMPE
falladles	fallar	VMPE
falladlo	fallar	VMMSE
falladla	fallar	VMFSE
falladlos	fallar	VMMPE
falladlas	fallar	VMFPE
falládmelo	fallar	VMMSE
falládselo	fallar	VMMSE
falládnoslo	fallar	VMMSE
falláoslo	fallar	VMMSE
falládmelos	fallar	VMMPE
falládselos	fallar	VMMPE
falládnoslos	fallar	VMMPE
falláoslos	fallar	VMMPE
falládmela	fallar	VMFSE
falládsela	fallar	VMFSE
falládnosla	fallar	VMFSE
falláosla	fallar	VMFSE
falládmelas	fallar	VMFPE
falládselas	fallar	VMFPE
falládnoslas	fallar	VMFPE
falláoslas	fallar	VMFPE
fallado	fallar	VPM
fallados	fallar	VPMP
fallada	fallar	VPF
falladas	fallar	VPFP
fallando	fallar	VG
fallándome	fallar	VGSE
fallándote	fallar	VGSE
fallándole	fallar	VGSE
fallándonos	fallar	VGPE
fallándoos	fallar	VGPE
fallándolo	fallar	VGMSE
fallándola	fallar	VGFSE
fallándolos	fallar	VGMPE
fallándolas	fallar	VGFPE
fallándomelo	fallar	VGMSE
fallándotelo	fallar	VGMSE
fallándoselo	fallar	VGMSE
fallándonoslo	fallar	VGMSE
fallándooslo	fallar	VGMSE
fallándomelos	fallar	VGMPE
fallándotelos	fallar	VGMPE
fallándoselos	fallar	VGMPE
fallándonoslos	fallar	VGMPE
fallándooslos	fallar	VGMPE
fallándomela	fallar	VGFSE
fallándotela	fallar	VGFSE
fallándosela	fallar	VGFSE
fallándonosla	fallar	VGFSE
fallándoosla	fallar	VGFSE
fallándomelas	fallar	VGFPE
fallándotelas	fallar	VGFPE
fallándoselas	fallar	VGFPE
fallándonoslas	fallar	VGFPE
fallándooslas	fallar	VGFPE
falsar	falsar	O
falso	falsar	VIP1
falsas	falsar	VIP2
falsa	falsar	VIP3
falsamos	falsar	VIP4
falsáis	falsar	VIP5
falsan	falsar	VIP6
falsaba	falsar	VII1
falsabas	falsar	VII2
falsábamos	falsar	VII4
falsabais	falsar	VII5
falsaban	falsar	VII6
falsaré	falsar	VIF1
falsarás	falsar	VIF2
falsará	falsar	VIF3
falsaremos	falsar	VIF4
falsaréis	falsar	VIF5
falsarán	falsar	VIF6
falsaría	falsar	VIC1
falsarías	falsar	VIC2
falsaría	falsar	VIC3
falsaríamos	falsar	VIC4
falsaríais	falsar	VIC5
falsarían	falsar	VIC6
falsé	falsar	VIX1
falsaste	falsar	VIX2
falsó	falsar	VIX3
falsasteis	falsar	VIX5
falsaron	falsar	VIX6
false	falsar	VSP1
falses	falsar	VSP2
falsemos	falsar	VSP4
falséis	falsar	VSP5
falsen	falsar	VSP6
falsara	falsar	VSX1
falsaras	falsar	VSX2
falsáramos	falsar	VSX4
falsarais	falsar	VSX5
falsaran	falsar	VSX6
falsare	falsar	VSF1
falsares	falsar	VSF2
falsáremos	falsar	VSF4
falsareis	falsar	VSF5
falsaren	falsar	VSF6
falsase	falsar	VSI1
falsases	falsar	VSI2
falsásemos	falsar	VSI4
falsaseis	falsar	VSI5
falsasen	falsar	VSI6
falsad	falsar	VMP
falsadme	falsar	VMSE
falsadle	falsar	VMSE
falsadnos	falsar	VMPE
falsaos	falsar	VMPE
falsadles	falsar	VMPE
falsadlo	falsar	VMMSE
falsadla	falsar	VMFSE
falsadlos	falsar	VMMPE
falsadlas	falsar	VMFPE
falsádmelo	falsar	VMMSE
falsádselo	falsar	VMMSE
falsádnoslo	falsar	VMMSE
falsáoslo	falsar	VMMSE
falsádmelos	falsar	VMMPE
falsádselos	falsar	VMMPE
falsádnoslos	falsar	VMMPE
falsáoslos	falsar	VMMPE
falsádmela	falsar	VMFSE
falsádsela	falsar	VMFSE
falsádnosla	falsar	VMFSE
falsáosla	falsar	VMFSE
falsádmelas	falsar	VMFPE
falsádselas	falsar	VMFPE
falsádnoslas	falsar	VMFPE
falsáoslas	falsar	VMFPE
falsado	falsar	VPM
falsados	falsar	VPMP
falsada	falsar	VPF
falsadas	falsar	VPFP
falsando	falsar	VG
falsándome	falsar	VGSE
falsándote	falsar	VGSE
falsándole	falsar	VGSE
falsándonos	falsar	VGPE
falsándoos	falsar	VGPE
falsándolo	falsar	VGMSE
falsándola	falsar	VGFSE
falsándolos	falsar	VGMPE
falsándolas	falsar	VGFPE
falsándomelo	falsar	VGMSE
falsándotelo	falsar	VGMSE
falsándoselo	falsar	VGMSE
falsándonoslo	falsar	VGMSE
falsándooslo	falsar	VGMSE
falsándomelos	falsar	VGMPE
falsándotelos	falsar	VGMPE
falsándoselos	falsar	VGMPE
falsándonoslos	falsar	VGMPE
falsándooslos	falsar	VGMPE
falsándomela	falsar	VGFSE
falsándotela	falsar	VGFSE
falsándosela	falsar	VGFSE
falsándonosla	falsar	VGFSE
falsándoosla	falsar	VGFSE
falsándomelas	falsar	VGFPE
falsándotelas	falsar	VGFPE
falsándoselas	falsar	VGFPE
falsándonoslas	falsar	VGFPE
falsándooslas	falsar	VGFPE
falsear	falsear	O
falseo	falsear	VIP1
falseas	falsear	VIP2
falsea	falsear	VIP3
falseamos	falsear	VIP4
falseáis	falsear	VIP5
falsean	falsear	VIP6
falseaba	falsear	VII1
falseabas	falsear	VII2
falseábamos	falsear	VII4
falseabais	falsear	VII5
falseaban	falsear	VII6
falsearé	falsear	VIF1
falsearás	falsear	VIF2
falseará	falsear	VIF3
falsearemos	falsear	VIF4
falsearéis	falsear	VIF5
falsearán	falsear	VIF6
falsearía	falsear	VIC1
falsearías	falsear	VIC2
falsearía	falsear	VIC3
falsearíamos	falsear	VIC4
falsearíais	falsear	VIC5
falsearían	falsear	VIC6
falseé	falsear	VIX1
falseaste	falsear	VIX2
falseó	falsear	VIX3
falseasteis	falsear	VIX5
falsearon	falsear	VIX6
falsee	falsear	VSP1
falsees	falsear	VSP2
falseemos	falsear	VSP4
falseéis	falsear	VSP5
falseen	falsear	VSP6
falseara	falsear	VSX1
falsearas	falsear	VSX2
falseáramos	falsear	VSX4
falsearais	falsear	VSX5
falsearan	falsear	VSX6
falseare	falsear	VSF1
falseares	falsear	VSF2
falseáremos	falsear	VSF4
falseareis	falsear	VSF5
falsearen	falsear	VSF6
falsease	falsear	VSI1
falseases	falsear	VSI2
falseásemos	falsear	VSI4
falseaseis	falsear	VSI5
falseasen	falsear	VSI6
falsead	falsear	VMP
falseadme	falsear	VMSE
falseadle	falsear	VMSE
falseadnos	falsear	VMPE
falseaos	falsear	VMPE
falseadles	falsear	VMPE
falseadlo	falsear	VMMSE
falseadla	falsear	VMFSE
falseadlos	falsear	VMMPE
falseadlas	falsear	VMFPE
falseádmelo	falsear	VMMSE
falseádselo	falsear	VMMSE
falseádnoslo	falsear	VMMSE
falseáoslo	falsear	VMMSE
falseádmelos	falsear	VMMPE
falseádselos	falsear	VMMPE
falseádnoslos	falsear	VMMPE
falseáoslos	falsear	VMMPE
falseádmela	falsear	VMFSE
falseádsela	falsear	VMFSE
falseádnosla	falsear	VMFSE
falseáosla	falsear	VMFSE
falseádmelas	falsear	VMFPE
falseádselas	falsear	VMFPE
falseádnoslas	falsear	VMFPE
falseáoslas	falsear	VMFPE
falseado	falsear	VPM
falseados	falsear	VPMP
falseada	falsear	VPF
falseadas	falsear	VPFP
falseando	falsear	VG
falseándome	falsear	VGSE
falseándote	falsear	VGSE
falseándole	falsear	VGSE
falseándonos	falsear	VGPE
falseándoos	falsear	VGPE
falseándolo	falsear	VGMSE
falseándola	falsear	VGFSE
falseándolos	falsear	VGMPE
falseándolas	falsear	VGFPE
falseándomelo	falsear	VGMSE
falseándotelo	falsear	VGMSE
falseándoselo	falsear	VGMSE
falseándonoslo	falsear	VGMSE
falseándooslo	falsear	VGMSE
falseándomelos	falsear	VGMPE
falseándotelos	falsear	VGMPE
falseándoselos	falsear	VGMPE
falseándonoslos	falsear	VGMPE
falseándooslos	falsear	VGMPE
falseándomela	falsear	VGFSE
falseándotela	falsear	VGFSE
falseándosela	falsear	VGFSE
falseándonosla	falsear	VGFSE
falseándoosla	falsear	VGFSE
falseándomelas	falsear	VGFPE
falseándotelas	falsear	VGFPE
falseándoselas	falsear	VGFPE
falseándonoslas	falsear	VGFPE
falseándooslas	falsear	VGFPE
falsificar	falsificar	O
falsifico	falsificar	VIP1
falsificas	falsificar	VIP2
falsifica	falsificar	VIP3
falsificamos	falsificar	VIP4
falsificáis	falsificar	VIP5
falsifican	falsificar	VIP6
falsificaba	falsificar	VII1
falsificabas	falsificar	VII2
falsificábamos	falsificar	VII4
falsificabais	falsificar	VII5
falsificaban	falsificar	VII6
falsificaré	falsificar	VIF1
falsificarás	falsificar	VIF2
falsificará	falsificar	VIF3
falsificaremos	falsificar	VIF4
falsificaréis	falsificar	VIF5
falsificarán	falsificar	VIF6
falsificaría	falsificar	VIC1
falsificarías	falsificar	VIC2
falsificaría	falsificar	VIC3
falsificaríamos	falsificar	VIC4
falsificaríais	falsificar	VIC5
falsificarían	falsificar	VIC6
falsifiqué	falsificar	VIX1
falsificaste	falsificar	VIX2
falsificó	falsificar	VIX3
falsificasteis	falsificar	VIX5
falsificaron	falsificar	VIX6
falsifique	falsificar	VSP1
falsifiques	falsificar	VSP2
falsifiquemos	falsificar	VSP4
falsifiquéis	falsificar	VSP5
falsifiquen	falsificar	VSP6
falsificara	falsificar	VSX1
falsificaras	falsificar	VSX2
falsificáramos	falsificar	VSX4
falsificarais	falsificar	VSX5
falsificaran	falsificar	VSX6
falsificare	falsificar	VSF1
falsificares	falsificar	VSF2
falsificáremos	falsificar	VSF4
falsificareis	falsificar	VSF5
falsificaren	falsificar	VSF6
falsificase	falsificar	VSI1
falsificases	falsificar	VSI2
falsificásemos	falsificar	VSI4
falsificaseis	falsificar	VSI5
falsificasen	falsificar	VSI6
falsificad	falsificar	VMP
falsificadme	falsificar	VMSE
falsificadle	falsificar	VMSE
falsificadnos	falsificar	VMPE
falsificaos	falsificar	VMPE
falsificadles	falsificar	VMPE
falsificadlo	falsificar	VMMSE
falsificadla	falsificar	VMFSE
falsificadlos	falsificar	VMMPE
falsificadlas	falsificar	VMFPE
falsificádmelo	falsificar	VMMSE
falsificádselo	falsificar	VMMSE
falsificádnoslo	falsificar	VMMSE
falsificáoslo	falsificar	VMMSE
falsificádmelos	falsificar	VMMPE
falsificádselos	falsificar	VMMPE
falsificádnoslos	falsificar	VMMPE
falsificáoslos	falsificar	VMMPE
falsificádmela	falsificar	VMFSE
falsificádsela	falsificar	VMFSE
falsificádnosla	falsificar	VMFSE
falsificáosla	falsificar	VMFSE
falsificádmelas	falsificar	VMFPE
falsificádselas	falsificar	VMFPE
falsificádnoslas	falsificar	VMFPE
falsificáoslas	falsificar	VMFPE
falsificado	falsificar	VPM
falsificados	falsificar	VPMP
falsificada	falsificar	VPF
falsificadas	falsificar	VPFP
falsificando	falsificar	VG
falsificándome	falsificar	VGSE
falsificándote	falsificar	VGSE
falsificándole	falsificar	VGSE
falsificándonos	falsificar	VGPE
falsificándoos	falsificar	VGPE
falsificándolo	falsificar	VGMSE
falsificándola	falsificar	VGFSE
falsificándolos	falsificar	VGMPE
falsificándolas	falsificar	VGFPE
falsificándomelo	falsificar	VGMSE
falsificándotelo	falsificar	VGMSE
falsificándoselo	falsificar	VGMSE
falsificándonoslo	falsificar	VGMSE
falsificándooslo	falsificar	VGMSE
falsificándomelos	falsificar	VGMPE
falsificándotelos	falsificar	VGMPE
falsificándoselos	falsificar	VGMPE
falsificándonoslos	falsificar	VGMPE
falsificándooslos	falsificar	VGMPE
falsificándomela	falsificar	VGFSE
falsificándotela	falsificar	VGFSE
falsificándosela	falsificar	VGFSE
falsificándonosla	falsificar	VGFSE
falsificándoosla	falsificar	VGFSE
falsificándomelas	falsificar	VGFPE
falsificándotelas	falsificar	VGFPE
falsificándoselas	falsificar	VGFPE
falsificándonoslas	falsificar	VGFPE
falsificándooslas	falsificar	VGFPE
faltar	faltar	O
falto	faltar	VIP1
faltas	faltar	VIP2
falta	faltar	VIP3
faltamos	faltar	VIP4
faltáis	faltar	VIP5
faltan	faltar	VIP6
faltaba	faltar	VII1
faltabas	faltar	VII2
faltábamos	faltar	VII4
faltabais	faltar	VII5
faltaban	faltar	VII6
faltaré	faltar	VIF1
faltarás	faltar	VIF2
faltará	faltar	VIF3
faltaremos	faltar	VIF4
faltaréis	faltar	VIF5
faltarán	faltar	VIF6
faltaría	faltar	VIC1
faltarías	faltar	VIC2
faltaría	faltar	VIC3
faltaríamos	faltar	VIC4
faltaríais	faltar	VIC5
faltarían	faltar	VIC6
falté	faltar	VIX1
faltaste	faltar	VIX2
faltó	faltar	VIX3
faltasteis	faltar	VIX5
faltaron	faltar	VIX6
falte	faltar	VSP1
faltes	faltar	VSP2
faltemos	faltar	VSP4
faltéis	faltar	VSP5
falten	faltar	VSP6
faltara	faltar	VSX1
faltaras	faltar	VSX2
faltáramos	faltar	VSX4
faltarais	faltar	VSX5
faltaran	faltar	VSX6
faltare	faltar	VSF1
faltares	faltar	VSF2
faltáremos	faltar	VSF4
faltareis	faltar	VSF5
faltaren	faltar	VSF6
faltase	faltar	VSI1
faltases	faltar	VSI2
faltásemos	faltar	VSI4
faltaseis	faltar	VSI5
faltasen	faltar	VSI6
faltad	faltar	VMP
faltadme	faltar	VMSE
faltadle	faltar	VMSE
faltadnos	faltar	VMPE
faltaos	faltar	VMPE
faltadles	faltar	VMPE
faltado	faltar	VPM
faltados	faltar	VPMP
faltada	faltar	VPF
faltadas	faltar	VPFP
faltando	faltar	VG
faltándome	faltar	VGSE
faltándote	faltar	VGSE
faltándole	faltar	VGSE
faltándonos	faltar	VGPE
faltándoos	faltar	VGPE
