fes	f	P
fes	fe	P
fescenino	fescenino	O
fesceninas	fescenino	FP
fescenina	fescenino	F
fesceninos	fescenino	P
fesoria	fesoria	O
fesorias	fesoria	P
festa	festa	O
festas	festa	P
festejador	festejador	O
festejadoras	festejador	FP
festejadora	festejador	F
festejadores	festejador	P
festejo	festejo	O
festejos	festejo	P
festero	festero	O
festeras	festero	FP
festera	festero	F
festeros	festero	P
festinación	festinación	O
festinaciones	festinación	P
festival	festival	O
festivales	festival	P
festivamente	festivamente	O
festividad	festividad	O
festividades	festividad	P
festivo	festivo	O
festivas	festivo	FP
festiva	festivo	F
festivos	festivo	P
festoneado	festoneado	O
festoneadas	festoneado	FP
festoneada	festoneado	F
festoneados	festoneado	P
festín	festín	O
festines	festín	P
festón	festón	O
festones	festón	P
fes	fer	VIP2
fes	far	VSP2
festear	festear	O
festeo	festear	VIP1
festeas	festear	VIP2
festea	festear	VIP3
festeamos	festear	VIP4
festeáis	festear	VIP5
festean	festear	VIP6
festeaba	festear	VII1
festeabas	festear	VII2
festeábamos	festear	VII4
festeabais	festear	VII5
festeaban	festear	VII6
festearé	festear	VIF1
festearás	festear	VIF2
festeará	festear	VIF3
festearemos	festear	VIF4
festearéis	festear	VIF5
festearán	festear	VIF6
festearía	festear	VIC1
festearías	festear	VIC2
festearía	festear	VIC3
festearíamos	festear	VIC4
festearíais	festear	VIC5
festearían	festear	VIC6
festeé	festear	VIX1
festeaste	festear	VIX2
festeó	festear	VIX3
festeasteis	festear	VIX5
festearon	festear	VIX6
festee	festear	VSP1
festees	festear	VSP2
festeemos	festear	VSP4
festeéis	festear	VSP5
festeen	festear	VSP6
festeara	festear	VSX1
festearas	festear	VSX2
festeáramos	festear	VSX4
festearais	festear	VSX5
festearan	festear	VSX6
festeare	festear	VSF1
festeares	festear	VSF2
festeáremos	festear	VSF4
festeareis	festear	VSF5
festearen	festear	VSF6
festease	festear	VSI1
festeases	festear	VSI2
festeásemos	festear	VSI4
festeaseis	festear	VSI5
festeasen	festear	VSI6
festead	festear	VMP
festeadme	festear	VMSE
festeadle	festear	VMSE
festeadnos	festear	VMPE
festeaos	festear	VMPE
festeadles	festear	VMPE
festeadlo	festear	VMMSE
festeadla	festear	VMFSE
festeadlos	festear	VMMPE
festeadlas	festear	VMFPE
festeádmelo	festear	VMMSE
festeádselo	festear	VMMSE
festeádnoslo	festear	VMMSE
festeáoslo	festear	VMMSE
festeádmelos	festear	VMMPE
festeádselos	festear	VMMPE
festeádnoslos	festear	VMMPE
festeáoslos	festear	VMMPE
festeádmela	festear	VMFSE
festeádsela	festear	VMFSE
festeádnosla	festear	VMFSE
festeáosla	festear	VMFSE
festeádmelas	festear	VMFPE
festeádselas	festear	VMFPE
festeádnoslas	festear	VMFPE
festeáoslas	festear	VMFPE
festeado	festear	VPM
festeados	festear	VPMP
festeada	festear	VPF
festeadas	festear	VPFP
festeando	festear	VG
festeándome	festear	VGSE
festeándote	festear	VGSE
festeándole	festear	VGSE
festeándonos	festear	VGPE
festeándoos	festear	VGPE
festeándolo	festear	VGMSE
festeándola	festear	VGFSE
festeándolos	festear	VGMPE
festeándolas	festear	VGFPE
festeándomelo	festear	VGMSE
festeándotelo	festear	VGMSE
festeándoselo	festear	VGMSE
festeándonoslo	festear	VGMSE
festeándooslo	festear	VGMSE
festeándomelos	festear	VGMPE
festeándotelos	festear	VGMPE
festeándoselos	festear	VGMPE
festeándonoslos	festear	VGMPE
festeándooslos	festear	VGMPE
festeándomela	festear	VGFSE
festeándotela	festear	VGFSE
festeándosela	festear	VGFSE
festeándonosla	festear	VGFSE
festeándoosla	festear	VGFSE
festeándomelas	festear	VGFPE
festeándotelas	festear	VGFPE
festeándoselas	festear	VGFPE
festeándonoslas	festear	VGFPE
festeándooslas	festear	VGFPE
festejar	festejar	O
festejo	festejar	VIP1
festejas	festejar	VIP2
festeja	festejar	VIP3
festejamos	festejar	VIP4
festejáis	festejar	VIP5
festejan	festejar	VIP6
festejaba	festejar	VII1
festejabas	festejar	VII2
festejábamos	festejar	VII4
festejabais	festejar	VII5
festejaban	festejar	VII6
festejaré	festejar	VIF1
festejarás	festejar	VIF2
festejará	festejar	VIF3
festejaremos	festejar	VIF4
festejaréis	festejar	VIF5
festejarán	festejar	VIF6
festejaría	festejar	VIC1
festejarías	festejar	VIC2
festejaría	festejar	VIC3
festejaríamos	festejar	VIC4
festejaríais	festejar	VIC5
festejarían	festejar	VIC6
festejé	festejar	VIX1
festejaste	festejar	VIX2
festejó	festejar	VIX3
festejasteis	festejar	VIX5
festejaron	festejar	VIX6
festeje	festejar	VSP1
festejes	festejar	VSP2
festejemos	festejar	VSP4
festejéis	festejar	VSP5
festejen	festejar	VSP6
festejara	festejar	VSX1
festejaras	festejar	VSX2
festejáramos	festejar	VSX4
festejarais	festejar	VSX5
festejaran	festejar	VSX6
festejare	festejar	VSF1
festejares	festejar	VSF2
festejáremos	festejar	VSF4
festejareis	festejar	VSF5
festejaren	festejar	VSF6
festejase	festejar	VSI1
festejases	festejar	VSI2
festejásemos	festejar	VSI4
festejaseis	festejar	VSI5
festejasen	festejar	VSI6
festejad	festejar	VMP
festejadme	festejar	VMSE
festejadle	festejar	VMSE
festejadnos	festejar	VMPE
festejaos	festejar	VMPE
festejadles	festejar	VMPE
festejadlo	festejar	VMMSE
festejadla	festejar	VMFSE
festejadlos	festejar	VMMPE
festejadlas	festejar	VMFPE
festejádmelo	festejar	VMMSE
festejádselo	festejar	VMMSE
festejádnoslo	festejar	VMMSE
festejáoslo	festejar	VMMSE
festejádmelos	festejar	VMMPE
festejádselos	festejar	VMMPE
festejádnoslos	festejar	VMMPE
festejáoslos	festejar	VMMPE
festejádmela	festejar	VMFSE
festejádsela	festejar	VMFSE
festejádnosla	festejar	VMFSE
festejáosla	festejar	VMFSE
festejádmelas	festejar	VMFPE
festejádselas	festejar	VMFPE
festejádnoslas	festejar	VMFPE
festejáoslas	festejar	VMFPE
festejado	festejar	VPM
festejados	festejar	VPMP
festejada	festejar	VPF
festejadas	festejar	VPFP
festejando	festejar	VG
festejándome	festejar	VGSE
festejándote	festejar	VGSE
festejándole	festejar	VGSE
festejándonos	festejar	VGPE
festejándoos	festejar	VGPE
festejándolo	festejar	VGMSE
festejándola	festejar	VGFSE
festejándolos	festejar	VGMPE
festejándolas	festejar	VGFPE
festejándomelo	festejar	VGMSE
festejándotelo	festejar	VGMSE
festejándoselo	festejar	VGMSE
festejándonoslo	festejar	VGMSE
festejándooslo	festejar	VGMSE
festejándomelos	festejar	VGMPE
festejándotelos	festejar	VGMPE
festejándoselos	festejar	VGMPE
festejándonoslos	festejar	VGMPE
festejándooslos	festejar	VGMPE
festejándomela	festejar	VGFSE
festejándotela	festejar	VGFSE
festejándosela	festejar	VGFSE
festejándonosla	festejar	VGFSE
festejándoosla	festejar	VGFSE
festejándomelas	festejar	VGFPE
festejándotelas	festejar	VGFPE
festejándoselas	festejar	VGFPE
festejándonoslas	festejar	VGFPE
festejándooslas	festejar	VGFPE
festinar	festinar	O
festino	festinar	VIP1
festinas	festinar	VIP2
festina	festinar	VIP3
festinamos	festinar	VIP4
festináis	festinar	VIP5
festinan	festinar	VIP6
festinaba	festinar	VII1
festinabas	festinar	VII2
festinábamos	festinar	VII4
festinabais	festinar	VII5
festinaban	festinar	VII6
festinaré	festinar	VIF1
festinarás	festinar	VIF2
festinará	festinar	VIF3
festinaremos	festinar	VIF4
festinaréis	festinar	VIF5
festinarán	festinar	VIF6
festinaría	festinar	VIC1
festinarías	festinar	VIC2
festinaría	festinar	VIC3
festinaríamos	festinar	VIC4
festinaríais	festinar	VIC5
festinarían	festinar	VIC6
festiné	festinar	VIX1
festinaste	festinar	VIX2
festinó	festinar	VIX3
festinasteis	festinar	VIX5
festinaron	festinar	VIX6
festine	festinar	VSP1
festines	festinar	VSP2
festinemos	festinar	VSP4
festinéis	festinar	VSP5
festinen	festinar	VSP6
festinara	festinar	VSX1
festinaras	festinar	VSX2
festináramos	festinar	VSX4
festinarais	festinar	VSX5
festinaran	festinar	VSX6
festinare	festinar	VSF1
festinares	festinar	VSF2
festináremos	festinar	VSF4
festinareis	festinar	VSF5
festinaren	festinar	VSF6
festinase	festinar	VSI1
festinases	festinar	VSI2
festinásemos	festinar	VSI4
festinaseis	festinar	VSI5
festinasen	festinar	VSI6
festinad	festinar	VMP
festinadme	festinar	VMSE
festinadle	festinar	VMSE
festinadnos	festinar	VMPE
festinaos	festinar	VMPE
festinadles	festinar	VMPE
festinadlo	festinar	VMMSE
festinadla	festinar	VMFSE
festinadlos	festinar	VMMPE
festinadlas	festinar	VMFPE
festinádmelo	festinar	VMMSE
festinádselo	festinar	VMMSE
festinádnoslo	festinar	VMMSE
festináoslo	festinar	VMMSE
festinádmelos	festinar	VMMPE
festinádselos	festinar	VMMPE
festinádnoslos	festinar	VMMPE
festináoslos	festinar	VMMPE
festinádmela	festinar	VMFSE
festinádsela	festinar	VMFSE
festinádnosla	festinar	VMFSE
festináosla	festinar	VMFSE
festinádmelas	festinar	VMFPE
festinádselas	festinar	VMFPE
festinádnoslas	festinar	VMFPE
festináoslas	festinar	VMFPE
festinado	festinar	VPM
festinados	festinar	VPMP
festinada	festinar	VPF
festinadas	festinar	VPFP
festinando	festinar	VG
festinándome	festinar	VGSE
festinándote	festinar	VGSE
festinándole	festinar	VGSE
festinándonos	festinar	VGPE
festinándoos	festinar	VGPE
festinándolo	festinar	VGMSE
festinándola	festinar	VGFSE
festinándolos	festinar	VGMPE
festinándolas	festinar	VGFPE
festinándomelo	festinar	VGMSE
festinándotelo	festinar	VGMSE
festinándoselo	festinar	VGMSE
festinándonoslo	festinar	VGMSE
festinándooslo	festinar	VGMSE
festinándomelos	festinar	VGMPE
festinándotelos	festinar	VGMPE
festinándoselos	festinar	VGMPE
festinándonoslos	festinar	VGMPE
festinándooslos	festinar	VGMPE
festinándomela	festinar	VGFSE
festinándotela	festinar	VGFSE
festinándosela	festinar	VGFSE
festinándonosla	festinar	VGFSE
festinándoosla	festinar	VGFSE
festinándomelas	festinar	VGFPE
festinándotelas	festinar	VGFPE
festinándoselas	festinar	VGFPE
festinándonoslas	festinar	VGFPE
festinándooslas	festinar	VGFPE
festonar	festonar	O
festono	festonar	VIP1
festonas	festonar	VIP2
festona	festonar	VIP3
festonamos	festonar	VIP4
festonáis	festonar	VIP5
festonan	festonar	VIP6
festonaba	festonar	VII1
festonabas	festonar	VII2
festonábamos	festonar	VII4
festonabais	festonar	VII5
festonaban	festonar	VII6
festonaré	festonar	VIF1
festonarás	festonar	VIF2
festonará	festonar	VIF3
festonaremos	festonar	VIF4
festonaréis	festonar	VIF5
festonarán	festonar	VIF6
festonaría	festonar	VIC1
festonarías	festonar	VIC2
festonaría	festonar	VIC3
festonaríamos	festonar	VIC4
festonaríais	festonar	VIC5
festonarían	festonar	VIC6
festoné	festonar	VIX1
festonaste	festonar	VIX2
festonó	festonar	VIX3
festonasteis	festonar	VIX5
festonaron	festonar	VIX6
festone	festonar	VSP1
festones	festonar	VSP2
festonemos	festonar	VSP4
festonéis	festonar	VSP5
festonen	festonar	VSP6
festonara	festonar	VSX1
festonaras	festonar	VSX2
festonáramos	festonar	VSX4
festonarais	festonar	VSX5
festonaran	festonar	VSX6
festonare	festonar	VSF1
festonares	festonar	VSF2
festonáremos	festonar	VSF4
festonareis	festonar	VSF5
festonaren	festonar	VSF6
festonase	festonar	VSI1
festonases	festonar	VSI2
festonásemos	festonar	VSI4
festonaseis	festonar	VSI5
festonasen	festonar	VSI6
festonad	festonar	VMP
festonadme	festonar	VMSE
festonadle	festonar	VMSE
festonadnos	festonar	VMPE
festonaos	festonar	VMPE
festonadles	festonar	VMPE
festonadlo	festonar	VMMSE
festonadla	festonar	VMFSE
festonadlos	festonar	VMMPE
festonadlas	festonar	VMFPE
festonádmelo	festonar	VMMSE
festonádselo	festonar	VMMSE
festonádnoslo	festonar	VMMSE
festonáoslo	festonar	VMMSE
festonádmelos	festonar	VMMPE
festonádselos	festonar	VMMPE
festonádnoslos	festonar	VMMPE
festonáoslos	festonar	VMMPE
festonádmela	festonar	VMFSE
festonádsela	festonar	VMFSE
festonádnosla	festonar	VMFSE
festonáosla	festonar	VMFSE
festonádmelas	festonar	VMFPE
festonádselas	festonar	VMFPE
festonádnoslas	festonar	VMFPE
festonáoslas	festonar	VMFPE
festonado	festonar	VPM
festonados	festonar	VPMP
festonada	festonar	VPF
festonadas	festonar	VPFP
festonando	festonar	VG
festonándome	festonar	VGSE
festonándote	festonar	VGSE
festonándole	festonar	VGSE
festonándonos	festonar	VGPE
festonándoos	festonar	VGPE
festonándolo	festonar	VGMSE
festonándola	festonar	VGFSE
festonándolos	festonar	VGMPE
festonándolas	festonar	VGFPE
festonándomelo	festonar	VGMSE
festonándotelo	festonar	VGMSE
festonándoselo	festonar	VGMSE
festonándonoslo	festonar	VGMSE
festonándooslo	festonar	VGMSE
festonándomelos	festonar	VGMPE
festonándotelos	festonar	VGMPE
festonándoselos	festonar	VGMPE
festonándonoslos	festonar	VGMPE
festonándooslos	festonar	VGMPE
festonándomela	festonar	VGFSE
festonándotela	festonar	VGFSE
festonándosela	festonar	VGFSE
festonándonosla	festonar	VGFSE
festonándoosla	festonar	VGFSE
festonándomelas	festonar	VGFPE
festonándotelas	festonar	VGFPE
festonándoselas	festonar	VGFPE
festonándonoslas	festonar	VGFPE
festonándooslas	festonar	VGFPE
festonear	festonear	O
festoneo	festonear	VIP1
festoneas	festonear	VIP2
festonea	festonear	VIP3
festoneamos	festonear	VIP4
festoneáis	festonear	VIP5
festonean	festonear	VIP6
festoneaba	festonear	VII1
festoneabas	festonear	VII2
festoneábamos	festonear	VII4
festoneabais	festonear	VII5
festoneaban	festonear	VII6
festonearé	festonear	VIF1
festonearás	festonear	VIF2
festoneará	festonear	VIF3
festonearemos	festonear	VIF4
festonearéis	festonear	VIF5
festonearán	festonear	VIF6
festonearía	festonear	VIC1
festonearías	festonear	VIC2
festonearía	festonear	VIC3
festonearíamos	festonear	VIC4
festonearíais	festonear	VIC5
festonearían	festonear	VIC6
festoneé	festonear	VIX1
festoneaste	festonear	VIX2
festoneó	festonear	VIX3
festoneasteis	festonear	VIX5
festonearon	festonear	VIX6
festonee	festonear	VSP1
festonees	festonear	VSP2
festoneemos	festonear	VSP4
festoneéis	festonear	VSP5
festoneen	festonear	VSP6
festoneara	festonear	VSX1
festonearas	festonear	VSX2
festoneáramos	festonear	VSX4
festonearais	festonear	VSX5
festonearan	festonear	VSX6
festoneare	festonear	VSF1
festoneares	festonear	VSF2
festoneáremos	festonear	VSF4
festoneareis	festonear	VSF5
festonearen	festonear	VSF6
festonease	festonear	VSI1
festoneases	festonear	VSI2
festoneásemos	festonear	VSI4
festoneaseis	festonear	VSI5
festoneasen	festonear	VSI6
festonead	festonear	VMP
festoneadme	festonear	VMSE
festoneadle	festonear	VMSE
festoneadnos	festonear	VMPE
festoneaos	festonear	VMPE
festoneadles	festonear	VMPE
festoneadlo	festonear	VMMSE
festoneadla	festonear	VMFSE
festoneadlos	festonear	VMMPE
festoneadlas	festonear	VMFPE
festoneádmelo	festonear	VMMSE
festoneádselo	festonear	VMMSE
festoneádnoslo	festonear	VMMSE
festoneáoslo	festonear	VMMSE
festoneádmelos	festonear	VMMPE
festoneádselos	festonear	VMMPE
festoneádnoslos	festonear	VMMPE
festoneáoslos	festonear	VMMPE
festoneádmela	festonear	VMFSE
festoneádsela	festonear	VMFSE
festoneádnosla	festonear	VMFSE
festoneáosla	festonear	VMFSE
festoneádmelas	festonear	VMFPE
festoneádselas	festonear	VMFPE
festoneádnoslas	festonear	VMFPE
festoneáoslas	festonear	VMFPE
festoneado	festonear	VPM
festoneados	festonear	VPMP
festoneada	festonear	VPF
festoneadas	festonear	VPFP
festoneando	festonear	VG
festoneándome	festonear	VGSE
festoneándote	festonear	VGSE
festoneándole	festonear	VGSE
festoneándonos	festonear	VGPE
festoneándoos	festonear	VGPE
festoneándolo	festonear	VGMSE
festoneándola	festonear	VGFSE
festoneándolos	festonear	VGMPE
festoneándolas	festonear	VGFPE
festoneándomelo	festonear	VGMSE
festoneándotelo	festonear	VGMSE
festoneándoselo	festonear	VGMSE
festoneándonoslo	festonear	VGMSE
festoneándooslo	festonear	VGMSE
festoneándomelos	festonear	VGMPE
festoneándotelos	festonear	VGMPE
festoneándoselos	festonear	VGMPE
festoneándonoslos	festonear	VGMPE
festoneándooslos	festonear	VGMPE
festoneándomela	festonear	VGFSE
festoneándotela	festonear	VGFSE
festoneándosela	festonear	VGFSE
festoneándonosla	festonear	VGFSE
festoneándoosla	festonear	VGFSE
festoneándomelas	festonear	VGFPE
festoneándotelas	festonear	VGFPE
festoneándoselas	festonear	VGFPE
festoneándonoslas	festonear	VGFPE
festoneándooslas	festonear	VGFPE
