fis	fi	P
fisberta	fisberta	O
fisbertas	fisberta	P
fiscal	fiscal	O
fiscales	fiscal	P
fiscalidad	fiscalidad	O
fiscalidades	fiscalidad	P
fiscalizable	fiscalizable	O
fiscalizables	fiscalizable	P
fiscalización	fiscalización	O
fiscalizaciones	fiscalización	P
fiscalizador	fiscalizador	O
fiscalizadoras	fiscalizador	FP
fiscalizadora	fiscalizador	F
fiscalizadores	fiscalizador	P
fiscalmente	fiscalmente	O
fiscalía	fiscalía	O
fiscalías	fiscalía	P
fisco	fisco	O
fiscos	fisco	P
fiscorno	fiscorno	O
fiscornos	fiscorno	P
fisga	fisga	O
fisgas	fisga	P
fisgador	fisgador	O
fisgadoras	fisgador	FP
fisgadora	fisgador	F
fisgadores	fisgador	P
fisgoneo	fisgoneo	O
fisgoneos	fisgoneo	P
fisgón	fisgón	O
fisgonas	fisgón	FP
fisgona	fisgón	F
fisgones	fisgón	P
fisiatra	fisiatra	O
fisiatras	fisiatra	P
fisiatría	fisiatría	O
fisiatrías	fisiatría	P
fisible	fisible	O
fisibles	fisible	P
fisicoquímico	fisicoquímico	O
fisicoquímicas	fisicoquímico	FP
fisicoquímica	fisicoquímico	F
fisicoquímicos	fisicoquímico	P
fisiocracia	fisiocracia	O
fisiocracias	fisiocracia	P
fisiognomía	fisiognomía	O
fisiognomías	fisiognomía	P
fisiognómico	fisiognómico	O
fisiognómicas	fisiognómico	FP
fisiognómica	fisiognómico	F
fisiognómicos	fisiognómico	P
fisiografía	fisiografía	O
fisiografías	fisiografía	P
fisiográfico	fisiográfico	O
fisiográficas	fisiográfico	FP
fisiográfica	fisiográfico	F
fisiográficos	fisiográfico	P
fisiología	fisiología	O
fisiologías	fisiología	P
fisiológicamente	fisiológicamente	O
fisiológico	fisiológico	O
fisiológicas	fisiológico	FP
fisiológica	fisiológico	F
fisiológicos	fisiológico	P
fisionable	fisionable	O
fisionables	fisionable	P
fisionomía	fisionomía	O
fisionomías	fisionomía	P
fisiopatología	fisiopatología	O
fisiopatologías	fisiopatología	P
fisioterapeuta	fisioterapeuta	O
fisioterapeutas	fisioterapeuta	P
fisioterapia	fisioterapia	O
fisioterapias	fisioterapia	P
fisioterapista	fisioterapista	O
fisioterapistas	fisioterapista	P
fisioterapéutico	fisioterapéutico	O
fisioterapéuticas	fisioterapéutico	FP
fisioterapéutica	fisioterapéutico	F
fisioterapéuticos	fisioterapéutico	P
fisioterápico	fisioterápico	O
fisioterápicas	fisioterápico	FP
fisioterápica	fisioterápico	F
fisioterápicos	fisioterápico	P
fisiparidad	fisiparidad	O
fisiparidades	fisiparidad	P
fisirrostro	fisirrostro	O
fisirrostras	fisirrostro	FP
fisirrostra	fisirrostro	F
fisirrostros	fisirrostro	P
fisiátrico	fisiátrico	O
fisiátricas	fisiátrico	FP
fisiátrica	fisiátrico	F
fisiátricos	fisiátrico	P
fisiócrata	fisiócrata	O
fisiócratas	fisiócrata	P
fisiólogo	fisiólogo	O
fisiólogas	fisiólogo	FP
fisióloga	fisiólogo	F
fisiólogos	fisiólogo	P
fisión	fisión	O
fisiones	fisión	P
fisonomista	fisonomista	O
fisonomistas	fisonomista	P
fisonomía	fisonomía	O
fisonomías	fisonomía	P
fisonómico	fisonómico	O
fisonómicas	fisonómico	FP
fisonómica	fisonómico	F
fisonómicos	fisonómico	P
fisostigmina	fisostigmina	O
fisostigminas	fisostigmina	P
fisto	fisto	O
fistas	fisto	FP
fista	fisto	F
fistos	fisto	P
fistol	fistol	O
fistoles	fistol	P
fistra	fistra	O
fistras	fistra	P
fistuloso	fistuloso	O
fistulosas	fistuloso	FP
fistulosa	fistuloso	F
fistulosos	fistuloso	P
fisura	fisura	O
fisuras	fisura	P
fisán	fisán	O
fisanes	fisán	P
fisípedo	fisípedo	O
fisípedas	fisípedo	FP
fisípeda	fisípedo	F
fisípedos	fisípedo	P
fisónomo	fisónomo	O
fisónomas	fisónomo	FP
fisónoma	fisónomo	F
fisónomos	fisónomo	P
fisóstomo	fisóstomo	O
fisóstomas	fisóstomo	FP
fisóstoma	fisóstomo	F
fisóstomos	fisóstomo	P
física	física	O
físicas	física	P
físicamente	físicamente	O
físico	físico	O
físicas	físico	FP
física	físico	F
físicos	físico	P
fístola	fístola	O
fístolas	fístola	P
fístula	fístula	O
fístulas	fístula	P
fiste	fer	VIX2
fisteis	fer	VIX5
fiscalear	fiscalear	O
fiscaleo	fiscalear	VIP1
fiscaleas	fiscalear	VIP2
fiscalea	fiscalear	VIP3
fiscaleamos	fiscalear	VIP4
fiscaleáis	fiscalear	VIP5
fiscalean	fiscalear	VIP6
fiscaleaba	fiscalear	VII1
fiscaleabas	fiscalear	VII2
fiscaleábamos	fiscalear	VII4
fiscaleabais	fiscalear	VII5
fiscaleaban	fiscalear	VII6
fiscalearé	fiscalear	VIF1
fiscalearás	fiscalear	VIF2
fiscaleará	fiscalear	VIF3
fiscalearemos	fiscalear	VIF4
fiscalearéis	fiscalear	VIF5
fiscalearán	fiscalear	VIF6
fiscalearía	fiscalear	VIC1
fiscalearías	fiscalear	VIC2
fiscalearía	fiscalear	VIC3
fiscalearíamos	fiscalear	VIC4
fiscalearíais	fiscalear	VIC5
fiscalearían	fiscalear	VIC6
fiscaleé	fiscalear	VIX1
fiscaleaste	fiscalear	VIX2
fiscaleó	fiscalear	VIX3
fiscaleasteis	fiscalear	VIX5
fiscalearon	fiscalear	VIX6
fiscalee	fiscalear	VSP1
fiscalees	fiscalear	VSP2
fiscaleemos	fiscalear	VSP4
fiscaleéis	fiscalear	VSP5
fiscaleen	fiscalear	VSP6
fiscaleara	fiscalear	VSX1
fiscalearas	fiscalear	VSX2
fiscaleáramos	fiscalear	VSX4
fiscalearais	fiscalear	VSX5
fiscalearan	fiscalear	VSX6
fiscaleare	fiscalear	VSF1
fiscaleares	fiscalear	VSF2
fiscaleáremos	fiscalear	VSF4
fiscaleareis	fiscalear	VSF5
fiscalearen	fiscalear	VSF6
fiscalease	fiscalear	VSI1
fiscaleases	fiscalear	VSI2
fiscaleásemos	fiscalear	VSI4
fiscaleaseis	fiscalear	VSI5
fiscaleasen	fiscalear	VSI6
fiscalead	fiscalear	VMP
fiscaleadme	fiscalear	VMSE
fiscaleadle	fiscalear	VMSE
fiscaleadnos	fiscalear	VMPE
fiscaleaos	fiscalear	VMPE
fiscaleadles	fiscalear	VMPE
fiscaleadlo	fiscalear	VMMSE
fiscaleadla	fiscalear	VMFSE
fiscaleadlos	fiscalear	VMMPE
fiscaleadlas	fiscalear	VMFPE
fiscaleádmelo	fiscalear	VMMSE
fiscaleádselo	fiscalear	VMMSE
fiscaleádnoslo	fiscalear	VMMSE
fiscaleáoslo	fiscalear	VMMSE
fiscaleádmelos	fiscalear	VMMPE
fiscaleádselos	fiscalear	VMMPE
fiscaleádnoslos	fiscalear	VMMPE
fiscaleáoslos	fiscalear	VMMPE
fiscaleádmela	fiscalear	VMFSE
fiscaleádsela	fiscalear	VMFSE
fiscaleádnosla	fiscalear	VMFSE
fiscaleáosla	fiscalear	VMFSE
fiscaleádmelas	fiscalear	VMFPE
fiscaleádselas	fiscalear	VMFPE
fiscaleádnoslas	fiscalear	VMFPE
fiscaleáoslas	fiscalear	VMFPE
fiscaleado	fiscalear	VPM
fiscaleados	fiscalear	VPMP
fiscaleada	fiscalear	VPF
fiscaleadas	fiscalear	VPFP
fiscaleando	fiscalear	VG
fiscaleándome	fiscalear	VGSE
fiscaleándote	fiscalear	VGSE
fiscaleándole	fiscalear	VGSE
fiscaleándonos	fiscalear	VGPE
fiscaleándoos	fiscalear	VGPE
fiscaleándolo	fiscalear	VGMSE
fiscaleándola	fiscalear	VGFSE
fiscaleándolos	fiscalear	VGMPE
fiscaleándolas	fiscalear	VGFPE
fiscaleándomelo	fiscalear	VGMSE
fiscaleándotelo	fiscalear	VGMSE
fiscaleándoselo	fiscalear	VGMSE
fiscaleándonoslo	fiscalear	VGMSE
fiscaleándooslo	fiscalear	VGMSE
fiscaleándomelos	fiscalear	VGMPE
fiscaleándotelos	fiscalear	VGMPE
fiscaleándoselos	fiscalear	VGMPE
fiscaleándonoslos	fiscalear	VGMPE
fiscaleándooslos	fiscalear	VGMPE
fiscaleándomela	fiscalear	VGFSE
fiscaleándotela	fiscalear	VGFSE
fiscaleándosela	fiscalear	VGFSE
fiscaleándonosla	fiscalear	VGFSE
fiscaleándoosla	fiscalear	VGFSE
fiscaleándomelas	fiscalear	VGFPE
fiscaleándotelas	fiscalear	VGFPE
fiscaleándoselas	fiscalear	VGFPE
fiscaleándonoslas	fiscalear	VGFPE
fiscaleándooslas	fiscalear	VGFPE
fiscalizar	fiscalizar	O
fiscalizo	fiscalizar	VIP1
fiscalizas	fiscalizar	VIP2
fiscaliza	fiscalizar	VIP3
fiscalizamos	fiscalizar	VIP4
fiscalizáis	fiscalizar	VIP5
fiscalizan	fiscalizar	VIP6
fiscalizaba	fiscalizar	VII1
fiscalizabas	fiscalizar	VII2
fiscalizábamos	fiscalizar	VII4
fiscalizabais	fiscalizar	VII5
fiscalizaban	fiscalizar	VII6
fiscalizaré	fiscalizar	VIF1
fiscalizarás	fiscalizar	VIF2
fiscalizará	fiscalizar	VIF3
fiscalizaremos	fiscalizar	VIF4
fiscalizaréis	fiscalizar	VIF5
fiscalizarán	fiscalizar	VIF6
fiscalizaría	fiscalizar	VIC1
fiscalizarías	fiscalizar	VIC2
fiscalizaría	fiscalizar	VIC3
fiscalizaríamos	fiscalizar	VIC4
fiscalizaríais	fiscalizar	VIC5
fiscalizarían	fiscalizar	VIC6
fiscalicé	fiscalizar	VIX1
fiscalizaste	fiscalizar	VIX2
fiscalizó	fiscalizar	VIX3
fiscalizasteis	fiscalizar	VIX5
fiscalizaron	fiscalizar	VIX6
fiscalice	fiscalizar	VSP1
fiscalices	fiscalizar	VSP2
fiscalicemos	fiscalizar	VSP4
fiscalicéis	fiscalizar	VSP5
fiscalicen	fiscalizar	VSP6
fiscalizara	fiscalizar	VSX1
fiscalizaras	fiscalizar	VSX2
fiscalizáramos	fiscalizar	VSX4
fiscalizarais	fiscalizar	VSX5
fiscalizaran	fiscalizar	VSX6
fiscalizare	fiscalizar	VSF1
fiscalizares	fiscalizar	VSF2
fiscalizáremos	fiscalizar	VSF4
fiscalizareis	fiscalizar	VSF5
fiscalizaren	fiscalizar	VSF6
fiscalizase	fiscalizar	VSI1
fiscalizases	fiscalizar	VSI2
fiscalizásemos	fiscalizar	VSI4
fiscalizaseis	fiscalizar	VSI5
fiscalizasen	fiscalizar	VSI6
fiscalizad	fiscalizar	VMP
fiscalizadme	fiscalizar	VMSE
fiscalizadle	fiscalizar	VMSE
fiscalizadnos	fiscalizar	VMPE
fiscalizaos	fiscalizar	VMPE
fiscalizadles	fiscalizar	VMPE
fiscalizadlo	fiscalizar	VMMSE
fiscalizadla	fiscalizar	VMFSE
fiscalizadlos	fiscalizar	VMMPE
fiscalizadlas	fiscalizar	VMFPE
fiscalizádmelo	fiscalizar	VMMSE
fiscalizádselo	fiscalizar	VMMSE
fiscalizádnoslo	fiscalizar	VMMSE
fiscalizáoslo	fiscalizar	VMMSE
fiscalizádmelos	fiscalizar	VMMPE
fiscalizádselos	fiscalizar	VMMPE
fiscalizádnoslos	fiscalizar	VMMPE
fiscalizáoslos	fiscalizar	VMMPE
fiscalizádmela	fiscalizar	VMFSE
fiscalizádsela	fiscalizar	VMFSE
fiscalizádnosla	fiscalizar	VMFSE
fiscalizáosla	fiscalizar	VMFSE
fiscalizádmelas	fiscalizar	VMFPE
fiscalizádselas	fiscalizar	VMFPE
fiscalizádnoslas	fiscalizar	VMFPE
fiscalizáoslas	fiscalizar	VMFPE
fiscalizado	fiscalizar	VPM
fiscalizados	fiscalizar	VPMP
fiscalizada	fiscalizar	VPF
fiscalizadas	fiscalizar	VPFP
fiscalizando	fiscalizar	VG
fiscalizándome	fiscalizar	VGSE
fiscalizándote	fiscalizar	VGSE
fiscalizándole	fiscalizar	VGSE
fiscalizándonos	fiscalizar	VGPE
fiscalizándoos	fiscalizar	VGPE
fiscalizándolo	fiscalizar	VGMSE
fiscalizándola	fiscalizar	VGFSE
fiscalizándolos	fiscalizar	VGMPE
fiscalizándolas	fiscalizar	VGFPE
fiscalizándomelo	fiscalizar	VGMSE
fiscalizándotelo	fiscalizar	VGMSE
fiscalizándoselo	fiscalizar	VGMSE
fiscalizándonoslo	fiscalizar	VGMSE
fiscalizándooslo	fiscalizar	VGMSE
fiscalizándomelos	fiscalizar	VGMPE
fiscalizándotelos	fiscalizar	VGMPE
fiscalizándoselos	fiscalizar	VGMPE
fiscalizándonoslos	fiscalizar	VGMPE
fiscalizándooslos	fiscalizar	VGMPE
fiscalizándomela	fiscalizar	VGFSE
fiscalizándotela	fiscalizar	VGFSE
fiscalizándosela	fiscalizar	VGFSE
fiscalizándonosla	fiscalizar	VGFSE
fiscalizándoosla	fiscalizar	VGFSE
fiscalizándomelas	fiscalizar	VGFPE
fiscalizándotelas	fiscalizar	VGFPE
fiscalizándoselas	fiscalizar	VGFPE
fiscalizándonoslas	fiscalizar	VGFPE
fiscalizándooslas	fiscalizar	VGFPE
fisgar	fisgar	O
fisgo	fisgar	VIP1
fisgas	fisgar	VIP2
fisga	fisgar	VIP3
fisgamos	fisgar	VIP4
fisgáis	fisgar	VIP5
fisgan	fisgar	VIP6
fisgaba	fisgar	VII1
fisgabas	fisgar	VII2
fisgábamos	fisgar	VII4
fisgabais	fisgar	VII5
fisgaban	fisgar	VII6
fisgaré	fisgar	VIF1
fisgarás	fisgar	VIF2
fisgará	fisgar	VIF3
fisgaremos	fisgar	VIF4
fisgaréis	fisgar	VIF5
fisgarán	fisgar	VIF6
fisgaría	fisgar	VIC1
fisgarías	fisgar	VIC2
fisgaría	fisgar	VIC3
fisgaríamos	fisgar	VIC4
fisgaríais	fisgar	VIC5
fisgarían	fisgar	VIC6
fisgé	fisgar	VIX1
fisgaste	fisgar	VIX2
fisgó	fisgar	VIX3
fisgasteis	fisgar	VIX5
fisgaron	fisgar	VIX6
fisgue	fisgar	VSP1
fisgues	fisgar	VSP2
fisguemos	fisgar	VSP4
fisguéis	fisgar	VSP5
fisguen	fisgar	VSP6
fisgara	fisgar	VSX1
fisgaras	fisgar	VSX2
fisgáramos	fisgar	VSX4
fisgarais	fisgar	VSX5
fisgaran	fisgar	VSX6
fisgare	fisgar	VSF1
fisgares	fisgar	VSF2
fisgáremos	fisgar	VSF4
fisgareis	fisgar	VSF5
fisgaren	fisgar	VSF6
fisgase	fisgar	VSI1
fisgases	fisgar	VSI2
fisgásemos	fisgar	VSI4
fisgaseis	fisgar	VSI5
fisgasen	fisgar	VSI6
fisgad	fisgar	VMP
fisgadme	fisgar	VMSE
fisgadle	fisgar	VMSE
fisgadnos	fisgar	VMPE
fisgaos	fisgar	VMPE
fisgadles	fisgar	VMPE
fisgadlo	fisgar	VMMSE
fisgadla	fisgar	VMFSE
fisgadlos	fisgar	VMMPE
fisgadlas	fisgar	VMFPE
fisgádmelo	fisgar	VMMSE
fisgádselo	fisgar	VMMSE
fisgádnoslo	fisgar	VMMSE
fisgáoslo	fisgar	VMMSE
fisgádmelos	fisgar	VMMPE
fisgádselos	fisgar	VMMPE
fisgádnoslos	fisgar	VMMPE
fisgáoslos	fisgar	VMMPE
fisgádmela	fisgar	VMFSE
fisgádsela	fisgar	VMFSE
fisgádnosla	fisgar	VMFSE
fisgáosla	fisgar	VMFSE
fisgádmelas	fisgar	VMFPE
fisgádselas	fisgar	VMFPE
fisgádnoslas	fisgar	VMFPE
fisgáoslas	fisgar	VMFPE
fisgado	fisgar	VPM
fisgados	fisgar	VPMP
fisgada	fisgar	VPF
fisgadas	fisgar	VPFP
fisgando	fisgar	VG
fisgándome	fisgar	VGSE
fisgándote	fisgar	VGSE
fisgándole	fisgar	VGSE
fisgándonos	fisgar	VGPE
fisgándoos	fisgar	VGPE
fisgándolo	fisgar	VGMSE
fisgándola	fisgar	VGFSE
fisgándolos	fisgar	VGMPE
fisgándolas	fisgar	VGFPE
fisgándomelo	fisgar	VGMSE
fisgándotelo	fisgar	VGMSE
fisgándoselo	fisgar	VGMSE
fisgándonoslo	fisgar	VGMSE
fisgándooslo	fisgar	VGMSE
fisgándomelos	fisgar	VGMPE
fisgándotelos	fisgar	VGMPE
fisgándoselos	fisgar	VGMPE
fisgándonoslos	fisgar	VGMPE
fisgándooslos	fisgar	VGMPE
fisgándomela	fisgar	VGFSE
fisgándotela	fisgar	VGFSE
fisgándosela	fisgar	VGFSE
fisgándonosla	fisgar	VGFSE
fisgándoosla	fisgar	VGFSE
fisgándomelas	fisgar	VGFPE
fisgándotelas	fisgar	VGFPE
fisgándoselas	fisgar	VGFPE
fisgándonoslas	fisgar	VGFPE
fisgándooslas	fisgar	VGFPE
fisgonear	fisgonear	O
fisgoneo	fisgonear	VIP1
fisgoneas	fisgonear	VIP2
fisgonea	fisgonear	VIP3
fisgoneamos	fisgonear	VIP4
fisgoneáis	fisgonear	VIP5
fisgonean	fisgonear	VIP6
fisgoneaba	fisgonear	VII1
fisgoneabas	fisgonear	VII2
fisgoneábamos	fisgonear	VII4
fisgoneabais	fisgonear	VII5
fisgoneaban	fisgonear	VII6
fisgonearé	fisgonear	VIF1
fisgonearás	fisgonear	VIF2
fisgoneará	fisgonear	VIF3
fisgonearemos	fisgonear	VIF4
fisgonearéis	fisgonear	VIF5
fisgonearán	fisgonear	VIF6
fisgonearía	fisgonear	VIC1
fisgonearías	fisgonear	VIC2
fisgonearía	fisgonear	VIC3
fisgonearíamos	fisgonear	VIC4
fisgonearíais	fisgonear	VIC5
fisgonearían	fisgonear	VIC6
fisgoneé	fisgonear	VIX1
fisgoneaste	fisgonear	VIX2
fisgoneó	fisgonear	VIX3
fisgoneasteis	fisgonear	VIX5
fisgonearon	fisgonear	VIX6
fisgonee	fisgonear	VSP1
fisgonees	fisgonear	VSP2
fisgoneemos	fisgonear	VSP4
fisgoneéis	fisgonear	VSP5
fisgoneen	fisgonear	VSP6
fisgoneara	fisgonear	VSX1
fisgonearas	fisgonear	VSX2
fisgoneáramos	fisgonear	VSX4
fisgonearais	fisgonear	VSX5
fisgonearan	fisgonear	VSX6
fisgoneare	fisgonear	VSF1
fisgoneares	fisgonear	VSF2
fisgoneáremos	fisgonear	VSF4
fisgoneareis	fisgonear	VSF5
fisgonearen	fisgonear	VSF6
fisgonease	fisgonear	VSI1
fisgoneases	fisgonear	VSI2
fisgoneásemos	fisgonear	VSI4
fisgoneaseis	fisgonear	VSI5
fisgoneasen	fisgonear	VSI6
fisgonead	fisgonear	VMP
fisgoneadme	fisgonear	VMSE
fisgoneadle	fisgonear	VMSE
fisgoneadnos	fisgonear	VMPE
fisgoneaos	fisgonear	VMPE
fisgoneadles	fisgonear	VMPE
fisgoneadlo	fisgonear	VMMSE
fisgoneadla	fisgonear	VMFSE
fisgoneadlos	fisgonear	VMMPE
fisgoneadlas	fisgonear	VMFPE
fisgoneádmelo	fisgonear	VMMSE
fisgoneádselo	fisgonear	VMMSE
fisgoneádnoslo	fisgonear	VMMSE
fisgoneáoslo	fisgonear	VMMSE
fisgoneádmelos	fisgonear	VMMPE
fisgoneádselos	fisgonear	VMMPE
fisgoneádnoslos	fisgonear	VMMPE
fisgoneáoslos	fisgonear	VMMPE
fisgoneádmela	fisgonear	VMFSE
fisgoneádsela	fisgonear	VMFSE
fisgoneádnosla	fisgonear	VMFSE
fisgoneáosla	fisgonear	VMFSE
fisgoneádmelas	fisgonear	VMFPE
fisgoneádselas	fisgonear	VMFPE
fisgoneádnoslas	fisgonear	VMFPE
fisgoneáoslas	fisgonear	VMFPE
fisgoneado	fisgonear	VPM
fisgoneados	fisgonear	VPMP
fisgoneada	fisgonear	VPF
fisgoneadas	fisgonear	VPFP
fisgoneando	fisgonear	VG
fisgoneándome	fisgonear	VGSE
fisgoneándote	fisgonear	VGSE
fisgoneándole	fisgonear	VGSE
fisgoneándonos	fisgonear	VGPE
fisgoneándoos	fisgonear	VGPE
fisgoneándolo	fisgonear	VGMSE
fisgoneándola	fisgonear	VGFSE
fisgoneándolos	fisgonear	VGMPE
fisgoneándolas	fisgonear	VGFPE
fisgoneándomelo	fisgonear	VGMSE
fisgoneándotelo	fisgonear	VGMSE
fisgoneándoselo	fisgonear	VGMSE
fisgoneándonoslo	fisgonear	VGMSE
fisgoneándooslo	fisgonear	VGMSE
fisgoneándomelos	fisgonear	VGMPE
fisgoneándotelos	fisgonear	VGMPE
fisgoneándoselos	fisgonear	VGMPE
fisgoneándonoslos	fisgonear	VGMPE
fisgoneándooslos	fisgonear	VGMPE
fisgoneándomela	fisgonear	VGFSE
fisgoneándotela	fisgonear	VGFSE
fisgoneándosela	fisgonear	VGFSE
fisgoneándonosla	fisgonear	VGFSE
fisgoneándoosla	fisgonear	VGFSE
fisgoneándomelas	fisgonear	VGFPE
fisgoneándotelas	fisgonear	VGFPE
fisgoneándoselas	fisgonear	VGFPE
fisgoneándonoslas	fisgonear	VGFPE
fisgoneándooslas	fisgonear	VGFPE
fisionar	fisionar	O
fisiono	fisionar	VIP1
fisionas	fisionar	VIP2
fisiona	fisionar	VIP3
fisionamos	fisionar	VIP4
fisionáis	fisionar	VIP5
fisionan	fisionar	VIP6
fisionaba	fisionar	VII1
fisionabas	fisionar	VII2
fisionábamos	fisionar	VII4
fisionabais	fisionar	VII5
fisionaban	fisionar	VII6
fisionaré	fisionar	VIF1
fisionarás	fisionar	VIF2
fisionará	fisionar	VIF3
fisionaremos	fisionar	VIF4
fisionaréis	fisionar	VIF5
fisionarán	fisionar	VIF6
fisionaría	fisionar	VIC1
fisionarías	fisionar	VIC2
fisionaría	fisionar	VIC3
fisionaríamos	fisionar	VIC4
fisionaríais	fisionar	VIC5
fisionarían	fisionar	VIC6
fisioné	fisionar	VIX1
fisionaste	fisionar	VIX2
fisionó	fisionar	VIX3
fisionasteis	fisionar	VIX5
fisionaron	fisionar	VIX6
fisione	fisionar	VSP1
fisiones	fisionar	VSP2
fisionemos	fisionar	VSP4
fisionéis	fisionar	VSP5
fisionen	fisionar	VSP6
fisionara	fisionar	VSX1
fisionaras	fisionar	VSX2
fisionáramos	fisionar	VSX4
fisionarais	fisionar	VSX5
fisionaran	fisionar	VSX6
fisionare	fisionar	VSF1
fisionares	fisionar	VSF2
fisionáremos	fisionar	VSF4
fisionareis	fisionar	VSF5
fisionaren	fisionar	VSF6
fisionase	fisionar	VSI1
fisionases	fisionar	VSI2
fisionásemos	fisionar	VSI4
fisionaseis	fisionar	VSI5
fisionasen	fisionar	VSI6
fisionad	fisionar	VMP
fisionadme	fisionar	VMSE
fisionadle	fisionar	VMSE
fisionadnos	fisionar	VMPE
fisionaos	fisionar	VMPE
fisionadles	fisionar	VMPE
fisionadlo	fisionar	VMMSE
fisionadla	fisionar	VMFSE
fisionadlos	fisionar	VMMPE
fisionadlas	fisionar	VMFPE
fisionádmelo	fisionar	VMMSE
fisionádselo	fisionar	VMMSE
fisionádnoslo	fisionar	VMMSE
fisionáoslo	fisionar	VMMSE
fisionádmelos	fisionar	VMMPE
fisionádselos	fisionar	VMMPE
fisionádnoslos	fisionar	VMMPE
fisionáoslos	fisionar	VMMPE
fisionádmela	fisionar	VMFSE
fisionádsela	fisionar	VMFSE
fisionádnosla	fisionar	VMFSE
fisionáosla	fisionar	VMFSE
fisionádmelas	fisionar	VMFPE
fisionádselas	fisionar	VMFPE
fisionádnoslas	fisionar	VMFPE
fisionáoslas	fisionar	VMFPE
fisionado	fisionar	VPM
fisionados	fisionar	VPMP
fisionada	fisionar	VPF
fisionadas	fisionar	VPFP
fisionando	fisionar	VG
fisionándome	fisionar	VGSE
fisionándote	fisionar	VGSE
fisionándole	fisionar	VGSE
fisionándonos	fisionar	VGPE
fisionándoos	fisionar	VGPE
fisionándolo	fisionar	VGMSE
fisionándola	fisionar	VGFSE
fisionándolos	fisionar	VGMPE
fisionándolas	fisionar	VGFPE
fisionándomelo	fisionar	VGMSE
fisionándotelo	fisionar	VGMSE
fisionándoselo	fisionar	VGMSE
fisionándonoslo	fisionar	VGMSE
fisionándooslo	fisionar	VGMSE
fisionándomelos	fisionar	VGMPE
fisionándotelos	fisionar	VGMPE
fisionándoselos	fisionar	VGMPE
fisionándonoslos	fisionar	VGMPE
fisionándooslos	fisionar	VGMPE
fisionándomela	fisionar	VGFSE
fisionándotela	fisionar	VGFSE
fisionándosela	fisionar	VGFSE
fisionándonosla	fisionar	VGFSE
fisionándoosla	fisionar	VGFSE
fisionándomelas	fisionar	VGFPE
fisionándotelas	fisionar	VGFPE
fisionándoselas	fisionar	VGFPE
fisionándonoslas	fisionar	VGFPE
fisionándooslas	fisionar	VGFPE
fisiquear	fisiquear	O
fisiqueo	fisiquear	VIP1
fisiqueas	fisiquear	VIP2
fisiquea	fisiquear	VIP3
fisiqueamos	fisiquear	VIP4
fisiqueáis	fisiquear	VIP5
fisiquean	fisiquear	VIP6
fisiqueaba	fisiquear	VII1
fisiqueabas	fisiquear	VII2
fisiqueábamos	fisiquear	VII4
fisiqueabais	fisiquear	VII5
fisiqueaban	fisiquear	VII6
fisiquearé	fisiquear	VIF1
fisiquearás	fisiquear	VIF2
fisiqueará	fisiquear	VIF3
fisiquearemos	fisiquear	VIF4
fisiquearéis	fisiquear	VIF5
fisiquearán	fisiquear	VIF6
fisiquearía	fisiquear	VIC1
fisiquearías	fisiquear	VIC2
fisiquearía	fisiquear	VIC3
fisiquearíamos	fisiquear	VIC4
fisiquearíais	fisiquear	VIC5
fisiquearían	fisiquear	VIC6
fisiqueé	fisiquear	VIX1
fisiqueaste	fisiquear	VIX2
fisiqueó	fisiquear	VIX3
fisiqueasteis	fisiquear	VIX5
fisiquearon	fisiquear	VIX6
fisiquee	fisiquear	VSP1
fisiquees	fisiquear	VSP2
fisiqueemos	fisiquear	VSP4
fisiqueéis	fisiquear	VSP5
fisiqueen	fisiquear	VSP6
fisiqueara	fisiquear	VSX1
fisiquearas	fisiquear	VSX2
fisiqueáramos	fisiquear	VSX4
fisiquearais	fisiquear	VSX5
fisiquearan	fisiquear	VSX6
fisiqueare	fisiquear	VSF1
fisiqueares	fisiquear	VSF2
fisiqueáremos	fisiquear	VSF4
fisiqueareis	fisiquear	VSF5
fisiquearen	fisiquear	VSF6
fisiquease	fisiquear	VSI1
fisiqueases	fisiquear	VSI2
fisiqueásemos	fisiquear	VSI4
fisiqueaseis	fisiquear	VSI5
fisiqueasen	fisiquear	VSI6
fisiquead	fisiquear	VMP
fisiqueadme	fisiquear	VMSE
fisiqueadle	fisiquear	VMSE
fisiqueadnos	fisiquear	VMPE
fisiqueaos	fisiquear	VMPE
fisiqueadles	fisiquear	VMPE
fisiqueado	fisiquear	VPM
fisiqueados	fisiquear	VPMP
fisiqueada	fisiquear	VPF
fisiqueadas	fisiquear	VPFP
fisiqueando	fisiquear	VG
fisiqueándome	fisiquear	VGSE
fisiqueándote	fisiquear	VGSE
fisiqueándole	fisiquear	VGSE
fisiqueándonos	fisiquear	VGPE
fisiqueándoos	fisiquear	VGPE
fistolar	fistolar	O
fistolo	fistolar	VIP1
fistolas	fistolar	VIP2
fistola	fistolar	VIP3
fistolamos	fistolar	VIP4
fistoláis	fistolar	VIP5
fistolan	fistolar	VIP6
fistolaba	fistolar	VII1
fistolabas	fistolar	VII2
fistolábamos	fistolar	VII4
fistolabais	fistolar	VII5
fistolaban	fistolar	VII6
fistolaré	fistolar	VIF1
fistolarás	fistolar	VIF2
fistolará	fistolar	VIF3
fistolaremos	fistolar	VIF4
fistolaréis	fistolar	VIF5
fistolarán	fistolar	VIF6
fistolaría	fistolar	VIC1
fistolarías	fistolar	VIC2
fistolaría	fistolar	VIC3
fistolaríamos	fistolar	VIC4
fistolaríais	fistolar	VIC5
fistolarían	fistolar	VIC6
fistolé	fistolar	VIX1
fistolaste	fistolar	VIX2
fistoló	fistolar	VIX3
fistolasteis	fistolar	VIX5
fistolaron	fistolar	VIX6
fistole	fistolar	VSP1
fistoles	fistolar	VSP2
fistolemos	fistolar	VSP4
fistoléis	fistolar	VSP5
fistolen	fistolar	VSP6
fistolara	fistolar	VSX1
fistolaras	fistolar	VSX2
fistoláramos	fistolar	VSX4
fistolarais	fistolar	VSX5
fistolaran	fistolar	VSX6
fistolare	fistolar	VSF1
fistolares	fistolar	VSF2
fistoláremos	fistolar	VSF4
fistolareis	fistolar	VSF5
fistolaren	fistolar	VSF6
fistolase	fistolar	VSI1
fistolases	fistolar	VSI2
fistolásemos	fistolar	VSI4
fistolaseis	fistolar	VSI5
fistolasen	fistolar	VSI6
fistolad	fistolar	VMP
fistoladme	fistolar	VMSE
fistoladle	fistolar	VMSE
fistoladnos	fistolar	VMPE
fistolaos	fistolar	VMPE
fistoladles	fistolar	VMPE
fistoladlo	fistolar	VMMSE
fistoladla	fistolar	VMFSE
fistoladlos	fistolar	VMMPE
fistoladlas	fistolar	VMFPE
fistoládmelo	fistolar	VMMSE
fistoládselo	fistolar	VMMSE
fistoládnoslo	fistolar	VMMSE
fistoláoslo	fistolar	VMMSE
fistoládmelos	fistolar	VMMPE
fistoládselos	fistolar	VMMPE
fistoládnoslos	fistolar	VMMPE
fistoláoslos	fistolar	VMMPE
fistoládmela	fistolar	VMFSE
fistoládsela	fistolar	VMFSE
fistoládnosla	fistolar	VMFSE
fistoláosla	fistolar	VMFSE
fistoládmelas	fistolar	VMFPE
fistoládselas	fistolar	VMFPE
fistoládnoslas	fistolar	VMFPE
fistoláoslas	fistolar	VMFPE
fistolado	fistolar	VPM
fistolados	fistolar	VPMP
fistolada	fistolar	VPF
fistoladas	fistolar	VPFP
fistolando	fistolar	VG
fistolándome	fistolar	VGSE
fistolándote	fistolar	VGSE
fistolándole	fistolar	VGSE
fistolándonos	fistolar	VGPE
fistolándoos	fistolar	VGPE
fistolándolo	fistolar	VGMSE
fistolándola	fistolar	VGFSE
fistolándolos	fistolar	VGMPE
fistolándolas	fistolar	VGFPE
fistolándomelo	fistolar	VGMSE
fistolándotelo	fistolar	VGMSE
fistolándoselo	fistolar	VGMSE
fistolándonoslo	fistolar	VGMSE
fistolándooslo	fistolar	VGMSE
fistolándomelos	fistolar	VGMPE
fistolándotelos	fistolar	VGMPE
fistolándoselos	fistolar	VGMPE
fistolándonoslos	fistolar	VGMPE
fistolándooslos	fistolar	VGMPE
fistolándomela	fistolar	VGFSE
fistolándotela	fistolar	VGFSE
fistolándosela	fistolar	VGFSE
fistolándonosla	fistolar	VGFSE
fistolándoosla	fistolar	VGFSE
fistolándomelas	fistolar	VGFPE
fistolándotelas	fistolar	VGFPE
fistolándoselas	fistolar	VGFPE
fistolándonoslas	fistolar	VGFPE
fistolándooslas	fistolar	VGFPE
fistular	fistular	O
fistulo	fistular	VIP1
fistulas	fistular	VIP2
fistula	fistular	VIP3
fistulamos	fistular	VIP4
fistuláis	fistular	VIP5
fistulan	fistular	VIP6
fistulaba	fistular	VII1
fistulabas	fistular	VII2
fistulábamos	fistular	VII4
fistulabais	fistular	VII5
fistulaban	fistular	VII6
fistularé	fistular	VIF1
fistularás	fistular	VIF2
fistulará	fistular	VIF3
fistularemos	fistular	VIF4
fistularéis	fistular	VIF5
fistularán	fistular	VIF6
fistularía	fistular	VIC1
fistularías	fistular	VIC2
fistularía	fistular	VIC3
fistularíamos	fistular	VIC4
fistularíais	fistular	VIC5
fistularían	fistular	VIC6
fistulé	fistular	VIX1
fistulaste	fistular	VIX2
fistuló	fistular	VIX3
fistulasteis	fistular	VIX5
fistularon	fistular	VIX6
fistule	fistular	VSP1
fistules	fistular	VSP2
fistulemos	fistular	VSP4
fistuléis	fistular	VSP5
fistulen	fistular	VSP6
fistulara	fistular	VSX1
fistularas	fistular	VSX2
fistuláramos	fistular	VSX4
fistularais	fistular	VSX5
fistularan	fistular	VSX6
fistulare	fistular	VSF1
fistulares	fistular	VSF2
fistuláremos	fistular	VSF4
fistulareis	fistular	VSF5
fistularen	fistular	VSF6
fistulase	fistular	VSI1
fistulases	fistular	VSI2
fistulásemos	fistular	VSI4
fistulaseis	fistular	VSI5
fistulasen	fistular	VSI6
fistulad	fistular	VMP
fistuladme	fistular	VMSE
fistuladle	fistular	VMSE
fistuladnos	fistular	VMPE
fistulaos	fistular	VMPE
fistuladles	fistular	VMPE
fistuladlo	fistular	VMMSE
fistuladla	fistular	VMFSE
fistuladlos	fistular	VMMPE
fistuladlas	fistular	VMFPE
fistuládmelo	fistular	VMMSE
fistuládselo	fistular	VMMSE
fistuládnoslo	fistular	VMMSE
fistuláoslo	fistular	VMMSE
fistuládmelos	fistular	VMMPE
fistuládselos	fistular	VMMPE
fistuládnoslos	fistular	VMMPE
fistuláoslos	fistular	VMMPE
fistuládmela	fistular	VMFSE
fistuládsela	fistular	VMFSE
fistuládnosla	fistular	VMFSE
fistuláosla	fistular	VMFSE
fistuládmelas	fistular	VMFPE
fistuládselas	fistular	VMFPE
fistuládnoslas	fistular	VMFPE
fistuláoslas	fistular	VMFPE
fistulado	fistular	VPM
fistulados	fistular	VPMP
fistulada	fistular	VPF
fistuladas	fistular	VPFP
fistulando	fistular	VG
fistulándome	fistular	VGSE
fistulándote	fistular	VGSE
fistulándole	fistular	VGSE
fistulándonos	fistular	VGPE
fistulándoos	fistular	VGPE
fistulándolo	fistular	VGMSE
fistulándola	fistular	VGFSE
fistulándolos	fistular	VGMPE
fistulándolas	fistular	VGFPE
fistulándomelo	fistular	VGMSE
fistulándotelo	fistular	VGMSE
fistulándoselo	fistular	VGMSE
fistulándonoslo	fistular	VGMSE
fistulándooslo	fistular	VGMSE
fistulándomelos	fistular	VGMPE
fistulándotelos	fistular	VGMPE
fistulándoselos	fistular	VGMPE
fistulándonoslos	fistular	VGMPE
fistulándooslos	fistular	VGMPE
fistulándomela	fistular	VGFSE
fistulándotela	fistular	VGFSE
fistulándosela	fistular	VGFSE
fistulándonosla	fistular	VGFSE
fistulándoosla	fistular	VGFSE
fistulándomelas	fistular	VGFPE
fistulándotelas	fistular	VGFPE
fistulándoselas	fistular	VGFPE
fistulándonoslas	fistular	VGFPE
fistulándooslas	fistular	VGFPE
fistulares	fistular	P
