foca	foca	O
focas	foca	P
focal	focal	O
focales	focal	P
focalización	focalización	O
focalizaciones	focalización	P
foceifiza	foceifiza	O
foceifizas	foceifiza	P
focense	focense	O
focenses	focense	P
focha	focha	O
fochas	focha	P
focino	focino	O
focinos	focino	P
foco	foco	O
focos	foco	P
fóculo	fóculo	O
fóculos	fóculo	P
focalizar	focalizar	O
focalizo	focalizar	VIP1
focalizas	focalizar	VIP2
focaliza	focalizar	VIP3
focalizamos	focalizar	VIP4
focalizáis	focalizar	VIP5
focalizan	focalizar	VIP6
focalizaba	focalizar	VII1
focalizabas	focalizar	VII2
focalizábamos	focalizar	VII4
focalizabais	focalizar	VII5
focalizaban	focalizar	VII6
focalizaré	focalizar	VIF1
focalizarás	focalizar	VIF2
focalizará	focalizar	VIF3
focalizaremos	focalizar	VIF4
focalizaréis	focalizar	VIF5
focalizarán	focalizar	VIF6
focalizaría	focalizar	VIC1
focalizarías	focalizar	VIC2
focalizaría	focalizar	VIC3
focalizaríamos	focalizar	VIC4
focalizaríais	focalizar	VIC5
focalizarían	focalizar	VIC6
focalicé	focalizar	VIX1
focalizaste	focalizar	VIX2
focalizó	focalizar	VIX3
focalizasteis	focalizar	VIX5
focalizaron	focalizar	VIX6
focalice	focalizar	VSP1
focalices	focalizar	VSP2
focalicemos	focalizar	VSP4
focalicéis	focalizar	VSP5
focalicen	focalizar	VSP6
focalizara	focalizar	VSX1
focalizaras	focalizar	VSX2
focalizáramos	focalizar	VSX4
focalizarais	focalizar	VSX5
focalizaran	focalizar	VSX6
focalizare	focalizar	VSF1
focalizares	focalizar	VSF2
focalizáremos	focalizar	VSF4
focalizareis	focalizar	VSF5
focalizaren	focalizar	VSF6
focalizase	focalizar	VSI1
focalizases	focalizar	VSI2
focalizásemos	focalizar	VSI4
focalizaseis	focalizar	VSI5
focalizasen	focalizar	VSI6
focalizad	focalizar	VMP
focalizadme	focalizar	VMSE
focalizadle	focalizar	VMSE
focalizadnos	focalizar	VMPE
focalizaos	focalizar	VMPE
focalizadles	focalizar	VMPE
focalizadlo	focalizar	VMMSE
focalizadla	focalizar	VMFSE
focalizadlos	focalizar	VMMPE
focalizadlas	focalizar	VMFPE
focalizádmelo	focalizar	VMMSE
focalizádselo	focalizar	VMMSE
focalizádnoslo	focalizar	VMMSE
focalizáoslo	focalizar	VMMSE
focalizádmelos	focalizar	VMMPE
focalizádselos	focalizar	VMMPE
focalizádnoslos	focalizar	VMMPE
focalizáoslos	focalizar	VMMPE
focalizádmela	focalizar	VMFSE
focalizádsela	focalizar	VMFSE
focalizádnosla	focalizar	VMFSE
focalizáosla	focalizar	VMFSE
focalizádmelas	focalizar	VMFPE
focalizádselas	focalizar	VMFPE
focalizádnoslas	focalizar	VMFPE
focalizáoslas	focalizar	VMFPE
focalizado	focalizar	VPM
focalizados	focalizar	VPMP
focalizada	focalizar	VPF
focalizadas	focalizar	VPFP
focalizando	focalizar	VG
focalizándome	focalizar	VGSE
focalizándote	focalizar	VGSE
focalizándole	focalizar	VGSE
focalizándonos	focalizar	VGPE
focalizándoos	focalizar	VGPE
focalizándolo	focalizar	VGMSE
focalizándola	focalizar	VGFSE
focalizándolos	focalizar	VGMPE
focalizándolas	focalizar	VGFPE
focalizándomelo	focalizar	VGMSE
focalizándotelo	focalizar	VGMSE
focalizándoselo	focalizar	VGMSE
focalizándonoslo	focalizar	VGMSE
focalizándooslo	focalizar	VGMSE
focalizándomelos	focalizar	VGMPE
focalizándotelos	focalizar	VGMPE
focalizándoselos	focalizar	VGMPE
focalizándonoslos	focalizar	VGMPE
focalizándooslos	focalizar	VGMPE
focalizándomela	focalizar	VGFSE
focalizándotela	focalizar	VGFSE
focalizándosela	focalizar	VGFSE
focalizándonosla	focalizar	VGFSE
focalizándoosla	focalizar	VGFSE
focalizándomelas	focalizar	VGFPE
focalizándotelas	focalizar	VGFPE
focalizándoselas	focalizar	VGFPE
focalizándonoslas	focalizar	VGFPE
focalizándooslas	focalizar	VGFPE
