gama	gama	O
gamas	gama	P
gamada	gamada	O
gamadas	gamada	P
gamarra	gamarra	O
gamarras	gamarra	P
gamarza	gamarza	O
gamarzas	gamarza	P
gamba	gamba	O
gambas	gamba	P
gambado	gambado	O
gambadas	gambado	FP
gambada	gambado	F
gambados	gambado	P
gambaj	gambaj	O
gambajes	gambaj	P
gambalúa	gambalúa	O
gambalúas	gambalúa	P
gambax	gambax	O
gambaxes	gambax	P
gamberra	gamberra	O
gamberras	gamberra	P
gamberrada	gamberrada	O
gamberradas	gamberrada	P
gamberrismo	gamberrismo	O
gamberrismos	gamberrismo	P
gamberro	gamberro	O
gamberras	gamberro	FP
gamberra	gamberro	F
gamberros	gamberro	P
gambesina	gambesina	O
gambesinas	gambesina	P
gambesón	gambesón	O
gambesones	gambesón	P
gambeta	gambeta	O
gambetas	gambeta	P
gambeteo	gambeteo	O
gambeteos	gambeteo	P
gambeto	gambeto	O
gambetas	gambeto	FP
gambeta	gambeto	F
gambetos	gambeto	P
gambito	gambito	O
gambitos	gambito	P
gamboa	gamboa	O
gamboas	gamboa	P
gambocho	gambocho	O
gambochos	gambocho	P
gambota	gambota	O
gambotas	gambota	P
gambox	gambox	O
gamboxes	gambox	P
gambucero	gambucero	O
gambuceros	gambucero	P
gambuj	gambuj	O
gambujes	gambuj	P
gambujo	gambujo	O
gambujos	gambujo	P
gambusina	gambusina	O
gambusinas	gambusina	P
gambusino	gambusino	O
gambusinos	gambusino	P
gambux	gambux	O
gambuxes	gambux	P
gambuza	gambuza	O
gambuzas	gambuza	P
gamella	gamella	O
gamellas	gamella	P
gamellada	gamellada	O
gamelladas	gamellada	P
gamello	gamello	O
gamellos	gamello	P
gamellón	gamellón	O
gamellones	gamellón	P
gameto	gameto	O
gametos	gameto	P
gametofito	gametofito	O
gametofitos	gametofito	P
gametófito	gametófito	O
gametófitos	gametófito	P
gamezno	gamezno	O
gameznos	gamezno	P
gamillón	gamillón	O
gamillones	gamillón	P
gamitadera	gamitadera	O
gamitaderas	gamitadera	P
gamitido	gamitido	O
gamitidos	gamitido	P
gamma	gamma	O
gammas	gamma	P
gammaglobulina	gammaglobulina	O
gammaglobulinas	gammaglobulina	P
gammagrafía	gammagrafía	O
gammagrafías	gammagrafía	P
gamo	gamo	O
gamas	gamo	FP
gama	gamo	F
gamos	gamo	P
gamonal	gamonal	O
gamonales	gamonal	P
gamonalismo	gamonalismo	O
gamonalismos	gamonalismo	P
gamonita	gamonita	O
gamonitas	gamonita	P
gamonito	gamonito	O
gamonitos	gamonito	P
gamonoso	gamonoso	O
gamonosas	gamonoso	FP
gamonosa	gamonoso	F
gamonosos	gamonoso	P
gamopétalo	gamopétalo	O
gamopétalas	gamopétalo	FP
gamopétala	gamopétalo	F
gamopétalos	gamopétalo	P
gamosépalo	gamosépalo	O
gamosépalas	gamosépalo	FP
gamosépala	gamosépalo	F
gamosépalos	gamosépalo	P
gamuno	gamuno	O
gamunas	gamuno	FP
gamuna	gamuno	F
gamunos	gamuno	P
gamusino	gamusino	O
gamusinos	gamusino	P
gamuza	gamuza	O
gamuzas	gamuza	P
gamuzado	gamuzado	O
gamuzadas	gamuzado	FP
gamuzada	gamuzado	F
gamuzados	gamuzado	P
gamón	gamón	O
gamones	gamón	P
gámbalo	gámbalo	O
gámbalos	gámbalo	P
gámbaro	gámbaro	O
gámbaros	gámbaro	P
gamberrear	gamberrear	O
gamberreo	gamberrear	VIP1
gamberreas	gamberrear	VIP2
gamberrea	gamberrear	VIP3
gamberreamos	gamberrear	VIP4
gamberreáis	gamberrear	VIP5
gamberrean	gamberrear	VIP6
gamberreaba	gamberrear	VII1
gamberreabas	gamberrear	VII2
gamberreábamos	gamberrear	VII4
gamberreabais	gamberrear	VII5
gamberreaban	gamberrear	VII6
gamberrearé	gamberrear	VIF1
gamberrearás	gamberrear	VIF2
gamberreará	gamberrear	VIF3
gamberrearemos	gamberrear	VIF4
gamberrearéis	gamberrear	VIF5
gamberrearán	gamberrear	VIF6
gamberrearía	gamberrear	VIC1
gamberrearías	gamberrear	VIC2
gamberrearía	gamberrear	VIC3
gamberrearíamos	gamberrear	VIC4
gamberrearíais	gamberrear	VIC5
gamberrearían	gamberrear	VIC6
gamberreé	gamberrear	VIX1
gamberreaste	gamberrear	VIX2
gamberreó	gamberrear	VIX3
gamberreasteis	gamberrear	VIX5
gamberrearon	gamberrear	VIX6
gamberree	gamberrear	VSP1
gamberrees	gamberrear	VSP2
gamberreemos	gamberrear	VSP4
gamberreéis	gamberrear	VSP5
gamberreen	gamberrear	VSP6
gamberreara	gamberrear	VSX1
gamberrearas	gamberrear	VSX2
gamberreáramos	gamberrear	VSX4
gamberrearais	gamberrear	VSX5
gamberrearan	gamberrear	VSX6
gamberreare	gamberrear	VSF1
gamberreares	gamberrear	VSF2
gamberreáremos	gamberrear	VSF4
gamberreareis	gamberrear	VSF5
gamberrearen	gamberrear	VSF6
gamberrease	gamberrear	VSI1
gamberreases	gamberrear	VSI2
gamberreásemos	gamberrear	VSI4
gamberreaseis	gamberrear	VSI5
gamberreasen	gamberrear	VSI6
gamberread	gamberrear	VMP
gamberreadme	gamberrear	VMSE
gamberreadle	gamberrear	VMSE
gamberreadnos	gamberrear	VMPE
gamberreaos	gamberrear	VMPE
gamberreadles	gamberrear	VMPE
gamberreado	gamberrear	VPM
gamberreados	gamberrear	VPMP
gamberreada	gamberrear	VPF
gamberreadas	gamberrear	VPFP
gamberreando	gamberrear	VG
gamberreándome	gamberrear	VGSE
gamberreándote	gamberrear	VGSE
gamberreándole	gamberrear	VGSE
gamberreándonos	gamberrear	VGPE
gamberreándoos	gamberrear	VGPE
gambetear	gambetear	O
gambeteo	gambetear	VIP1
gambeteas	gambetear	VIP2
gambetea	gambetear	VIP3
gambeteamos	gambetear	VIP4
gambeteáis	gambetear	VIP5
gambetean	gambetear	VIP6
gambeteaba	gambetear	VII1
gambeteabas	gambetear	VII2
gambeteábamos	gambetear	VII4
gambeteabais	gambetear	VII5
gambeteaban	gambetear	VII6
gambetearé	gambetear	VIF1
gambetearás	gambetear	VIF2
gambeteará	gambetear	VIF3
gambetearemos	gambetear	VIF4
gambetearéis	gambetear	VIF5
gambetearán	gambetear	VIF6
gambetearía	gambetear	VIC1
gambetearías	gambetear	VIC2
gambetearía	gambetear	VIC3
gambetearíamos	gambetear	VIC4
gambetearíais	gambetear	VIC5
gambetearían	gambetear	VIC6
gambeteé	gambetear	VIX1
gambeteaste	gambetear	VIX2
gambeteó	gambetear	VIX3
gambeteasteis	gambetear	VIX5
gambetearon	gambetear	VIX6
gambetee	gambetear	VSP1
gambetees	gambetear	VSP2
gambeteemos	gambetear	VSP4
gambeteéis	gambetear	VSP5
gambeteen	gambetear	VSP6
gambeteara	gambetear	VSX1
gambetearas	gambetear	VSX2
gambeteáramos	gambetear	VSX4
gambetearais	gambetear	VSX5
gambetearan	gambetear	VSX6
gambeteare	gambetear	VSF1
gambeteares	gambetear	VSF2
gambeteáremos	gambetear	VSF4
gambeteareis	gambetear	VSF5
gambetearen	gambetear	VSF6
gambetease	gambetear	VSI1
gambeteases	gambetear	VSI2
gambeteásemos	gambetear	VSI4
gambeteaseis	gambetear	VSI5
gambeteasen	gambetear	VSI6
gambetead	gambetear	VMP
gambeteadme	gambetear	VMSE
gambeteadle	gambetear	VMSE
gambeteadnos	gambetear	VMPE
gambeteaos	gambetear	VMPE
gambeteadles	gambetear	VMPE
gambeteado	gambetear	VPM
gambeteados	gambetear	VPMP
gambeteada	gambetear	VPF
gambeteadas	gambetear	VPFP
gambeteando	gambetear	VG
gambeteándome	gambetear	VGSE
gambeteándote	gambetear	VGSE
gambeteándole	gambetear	VGSE
gambeteándonos	gambetear	VGPE
gambeteándoos	gambetear	VGPE
gamitar	gamitar	O
gamito	gamitar	VIP1
gamitas	gamitar	VIP2
gamita	gamitar	VIP3
gamitamos	gamitar	VIP4
gamitáis	gamitar	VIP5
gamitan	gamitar	VIP6
gamitaba	gamitar	VII1
gamitabas	gamitar	VII2
gamitábamos	gamitar	VII4
gamitabais	gamitar	VII5
gamitaban	gamitar	VII6
gamitaré	gamitar	VIF1
gamitarás	gamitar	VIF2
gamitará	gamitar	VIF3
gamitaremos	gamitar	VIF4
gamitaréis	gamitar	VIF5
gamitarán	gamitar	VIF6
gamitaría	gamitar	VIC1
gamitarías	gamitar	VIC2
gamitaría	gamitar	VIC3
gamitaríamos	gamitar	VIC4
gamitaríais	gamitar	VIC5
gamitarían	gamitar	VIC6
gamité	gamitar	VIX1
gamitaste	gamitar	VIX2
gamitó	gamitar	VIX3
gamitasteis	gamitar	VIX5
gamitaron	gamitar	VIX6
gamite	gamitar	VSP1
gamites	gamitar	VSP2
gamitemos	gamitar	VSP4
gamitéis	gamitar	VSP5
gamiten	gamitar	VSP6
gamitara	gamitar	VSX1
gamitaras	gamitar	VSX2
gamitáramos	gamitar	VSX4
gamitarais	gamitar	VSX5
gamitaran	gamitar	VSX6
gamitare	gamitar	VSF1
gamitares	gamitar	VSF2
gamitáremos	gamitar	VSF4
gamitareis	gamitar	VSF5
gamitaren	gamitar	VSF6
gamitase	gamitar	VSI1
gamitases	gamitar	VSI2
gamitásemos	gamitar	VSI4
gamitaseis	gamitar	VSI5
gamitasen	gamitar	VSI6
gamitad	gamitar	VMP
gamitadme	gamitar	VMSE
gamitadle	gamitar	VMSE
gamitadnos	gamitar	VMPE
gamitaos	gamitar	VMPE
gamitadles	gamitar	VMPE
gamitado	gamitar	VPM
gamitados	gamitar	VPMP
gamitada	gamitar	VPF
gamitadas	gamitar	VPFP
gamitando	gamitar	VG
gamitándome	gamitar	VGSE
gamitándote	gamitar	VGSE
gamitándole	gamitar	VGSE
gamitándonos	gamitar	VGPE
gamitándoos	gamitar	VGPE
