gavanza	gavanza	O
gavanzas	gavanza	P
gavanzo	gavanzo	O
gavanzos	gavanzo	P
gavera	gavera	O
gaveras	gavera	P
gaveta	gaveta	O
gavetas	gaveta	P
gavia	gavia	O
gavias	gavia	P
gavial	gavial	O
gaviales	gavial	P
gaviero	gaviero	O
gavieros	gaviero	P
gavieta	gavieta	O
gavietas	gavieta	P
gaviete	gaviete	O
gavietes	gaviete	P
gavilana	gavilana	O
gavilanas	gavilana	P
gavilancillo	gavilancillo	O
gavilancillos	gavilancillo	P
gavilla	gavilla	O
gavillas	gavilla	P
gavillero	gavillero	O
gavilleros	gavillero	P
gavilán	gavilán	O
gavilanes	gavilán	P
gavina	gavina	O
gavinas	gavina	P
gavinote	gavinote	O
gavinotes	gavinote	P
gaviota	gaviota	O
gaviotas	gaviota	P
gavión	gavión	O
gaviones	gavión	P
gavota	gavota	O
gavotas	gavota	P
gavillar	gavillar	O
gavillo	gavillar	VIP1
gavillas	gavillar	VIP2
gavilla	gavillar	VIP3
gavillamos	gavillar	VIP4
gavilláis	gavillar	VIP5
gavillan	gavillar	VIP6
gavillaba	gavillar	VII1
gavillabas	gavillar	VII2
gavillábamos	gavillar	VII4
gavillabais	gavillar	VII5
gavillaban	gavillar	VII6
gavillaré	gavillar	VIF1
gavillarás	gavillar	VIF2
gavillará	gavillar	VIF3
gavillaremos	gavillar	VIF4
gavillaréis	gavillar	VIF5
gavillarán	gavillar	VIF6
gavillaría	gavillar	VIC1
gavillarías	gavillar	VIC2
gavillaría	gavillar	VIC3
gavillaríamos	gavillar	VIC4
gavillaríais	gavillar	VIC5
gavillarían	gavillar	VIC6
gavillé	gavillar	VIX1
gavillaste	gavillar	VIX2
gavilló	gavillar	VIX3
gavillasteis	gavillar	VIX5
gavillaron	gavillar	VIX6
gaville	gavillar	VSP1
gavilles	gavillar	VSP2
gavillemos	gavillar	VSP4
gavilléis	gavillar	VSP5
gavillen	gavillar	VSP6
gavillara	gavillar	VSX1
gavillaras	gavillar	VSX2
gavilláramos	gavillar	VSX4
gavillarais	gavillar	VSX5
gavillaran	gavillar	VSX6
gavillare	gavillar	VSF1
gavillares	gavillar	VSF2
gavilláremos	gavillar	VSF4
gavillareis	gavillar	VSF5
gavillaren	gavillar	VSF6
gavillase	gavillar	VSI1
gavillases	gavillar	VSI2
gavillásemos	gavillar	VSI4
gavillaseis	gavillar	VSI5
gavillasen	gavillar	VSI6
gavillad	gavillar	VMP
gavilladme	gavillar	VMSE
gavilladle	gavillar	VMSE
gavilladnos	gavillar	VMPE
gavillaos	gavillar	VMPE
gavilladles	gavillar	VMPE
gavilladlo	gavillar	VMMSE
gavilladla	gavillar	VMFSE
gavilladlos	gavillar	VMMPE
gavilladlas	gavillar	VMFPE
gavilládmelo	gavillar	VMMSE
gavilládselo	gavillar	VMMSE
gavilládnoslo	gavillar	VMMSE
gavilláoslo	gavillar	VMMSE
gavilládmelos	gavillar	VMMPE
gavilládselos	gavillar	VMMPE
gavilládnoslos	gavillar	VMMPE
gavilláoslos	gavillar	VMMPE
gavilládmela	gavillar	VMFSE
gavilládsela	gavillar	VMFSE
gavilládnosla	gavillar	VMFSE
gavilláosla	gavillar	VMFSE
gavilládmelas	gavillar	VMFPE
gavilládselas	gavillar	VMFPE
gavilládnoslas	gavillar	VMFPE
gavilláoslas	gavillar	VMFPE
gavillado	gavillar	VPM
gavillados	gavillar	VPMP
gavillada	gavillar	VPF
gavilladas	gavillar	VPFP
gavillando	gavillar	VG
gavillándome	gavillar	VGSE
gavillándote	gavillar	VGSE
gavillándole	gavillar	VGSE
gavillándonos	gavillar	VGPE
gavillándoos	gavillar	VGPE
gavillándolo	gavillar	VGMSE
gavillándola	gavillar	VGFSE
gavillándolos	gavillar	VGMPE
gavillándolas	gavillar	VGFPE
gavillándomelo	gavillar	VGMSE
gavillándotelo	gavillar	VGMSE
gavillándoselo	gavillar	VGMSE
gavillándonoslo	gavillar	VGMSE
gavillándooslo	gavillar	VGMSE
gavillándomelos	gavillar	VGMPE
gavillándotelos	gavillar	VGMPE
gavillándoselos	gavillar	VGMPE
gavillándonoslos	gavillar	VGMPE
gavillándooslos	gavillar	VGMPE
gavillándomela	gavillar	VGFSE
gavillándotela	gavillar	VGFSE
gavillándosela	gavillar	VGFSE
gavillándonosla	gavillar	VGFSE
gavillándoosla	gavillar	VGFSE
gavillándomelas	gavillar	VGFPE
gavillándotelas	gavillar	VGFPE
gavillándoselas	gavillar	VGFPE
gavillándonoslas	gavillar	VGFPE
gavillándooslas	gavillar	VGFPE
gavillares	gavillar	P
