gonadal	gonadal	O
gonadales	gonadal	P
gonce	gonce	O
gonces	gonce	P
gonchu	gonchu	O
gonchus	gonchu	P
gondolero	gondolero	O
gondoleros	gondolero	P
gonela	gonela	O
gonelas	gonela	P
gonete	gonete	O
gonetes	gonete	P
gonfalonero	gonfalonero	O
gonfaloneros	gonfalonero	P
gonfalonier	gonfalonier	O
gonfalonieres	gonfalonier	P
gonfaloniero	gonfaloniero	O
gonfalonieros	gonfaloniero	P
gonfalón	gonfalón	O
gonfalones	gonfalón	P
gong	gong	O
gonges	gong	P
gongo	gongo	O
gongos	gongo	P
gongorino	gongorino	O
gongorinas	gongorino	FP
gongorina	gongorino	F
gongorinos	gongorino	P
gongorismo	gongorismo	O
gongorismos	gongorismo	P
gongorista	gongorista	O
gongoristas	gongorista	P
goniómetro	goniómetro	O
goniómetros	goniómetro	P
gonococia	gonococia	O
gonococias	gonococia	P
gonococo	gonococo	O
gonococos	gonococo	P
gonocócico	gonocócico	O
gonocócicas	gonocócico	FP
gonocócica	gonocócico	F
gonocócicos	gonocócico	P
gonorrea	gonorrea	O
gonorreas	gonorrea	P
gonádico	gonádico	O
gonádicas	gonádico	FP
gonádica	gonádico	F
gonádicos	gonádico	P
gónada	gónada	O
gónadas	gónada	P
góndola	góndola	O
góndolas	góndola	P
goncear	goncear	O
gonceo	goncear	VIP1
gonceas	goncear	VIP2
goncea	goncear	VIP3
gonceamos	goncear	VIP4
gonceáis	goncear	VIP5
goncean	goncear	VIP6
gonceaba	goncear	VII1
gonceabas	goncear	VII2
gonceábamos	goncear	VII4
gonceabais	goncear	VII5
gonceaban	goncear	VII6
goncearé	goncear	VIF1
goncearás	goncear	VIF2
gonceará	goncear	VIF3
goncearemos	goncear	VIF4
goncearéis	goncear	VIF5
goncearán	goncear	VIF6
goncearía	goncear	VIC1
goncearías	goncear	VIC2
goncearía	goncear	VIC3
goncearíamos	goncear	VIC4
goncearíais	goncear	VIC5
goncearían	goncear	VIC6
gonceé	goncear	VIX1
gonceaste	goncear	VIX2
gonceó	goncear	VIX3
gonceasteis	goncear	VIX5
goncearon	goncear	VIX6
goncee	goncear	VSP1
goncees	goncear	VSP2
gonceemos	goncear	VSP4
gonceéis	goncear	VSP5
gonceen	goncear	VSP6
gonceara	goncear	VSX1
goncearas	goncear	VSX2
gonceáramos	goncear	VSX4
goncearais	goncear	VSX5
goncearan	goncear	VSX6
gonceare	goncear	VSF1
gonceares	goncear	VSF2
gonceáremos	goncear	VSF4
gonceareis	goncear	VSF5
goncearen	goncear	VSF6
goncease	goncear	VSI1
gonceases	goncear	VSI2
gonceásemos	goncear	VSI4
gonceaseis	goncear	VSI5
gonceasen	goncear	VSI6
goncead	goncear	VMP
gonceadme	goncear	VMSE
gonceadle	goncear	VMSE
gonceadnos	goncear	VMPE
gonceaos	goncear	VMPE
gonceadles	goncear	VMPE
gonceadlo	goncear	VMMSE
gonceadla	goncear	VMFSE
gonceadlos	goncear	VMMPE
gonceadlas	goncear	VMFPE
gonceádmelo	goncear	VMMSE
gonceádselo	goncear	VMMSE
gonceádnoslo	goncear	VMMSE
gonceáoslo	goncear	VMMSE
gonceádmelos	goncear	VMMPE
gonceádselos	goncear	VMMPE
gonceádnoslos	goncear	VMMPE
gonceáoslos	goncear	VMMPE
gonceádmela	goncear	VMFSE
gonceádsela	goncear	VMFSE
gonceádnosla	goncear	VMFSE
gonceáosla	goncear	VMFSE
gonceádmelas	goncear	VMFPE
gonceádselas	goncear	VMFPE
gonceádnoslas	goncear	VMFPE
gonceáoslas	goncear	VMFPE
gonceado	goncear	VPM
gonceados	goncear	VPMP
gonceada	goncear	VPF
gonceadas	goncear	VPFP
gonceando	goncear	VG
gonceándome	goncear	VGSE
gonceándote	goncear	VGSE
gonceándole	goncear	VGSE
gonceándonos	goncear	VGPE
gonceándoos	goncear	VGPE
gonceándolo	goncear	VGMSE
gonceándola	goncear	VGFSE
gonceándolos	goncear	VGMPE
gonceándolas	goncear	VGFPE
gonceándomelo	goncear	VGMSE
gonceándotelo	goncear	VGMSE
gonceándoselo	goncear	VGMSE
gonceándonoslo	goncear	VGMSE
gonceándooslo	goncear	VGMSE
gonceándomelos	goncear	VGMPE
gonceándotelos	goncear	VGMPE
gonceándoselos	goncear	VGMPE
gonceándonoslos	goncear	VGMPE
gonceándooslos	goncear	VGMPE
gonceándomela	goncear	VGFSE
gonceándotela	goncear	VGFSE
gonceándosela	goncear	VGFSE
gonceándonosla	goncear	VGFSE
gonceándoosla	goncear	VGFSE
gonceándomelas	goncear	VGFPE
gonceándotelas	goncear	VGFPE
gonceándoselas	goncear	VGFPE
gonceándonoslas	goncear	VGFPE
gonceándooslas	goncear	VGFPE
gongorizar	gongorizar	O
gongorizo	gongorizar	VIP1
gongorizas	gongorizar	VIP2
gongoriza	gongorizar	VIP3
gongorizamos	gongorizar	VIP4
gongorizáis	gongorizar	VIP5
gongorizan	gongorizar	VIP6
gongorizaba	gongorizar	VII1
gongorizabas	gongorizar	VII2
gongorizábamos	gongorizar	VII4
gongorizabais	gongorizar	VII5
gongorizaban	gongorizar	VII6
gongorizaré	gongorizar	VIF1
gongorizarás	gongorizar	VIF2
gongorizará	gongorizar	VIF3
gongorizaremos	gongorizar	VIF4
gongorizaréis	gongorizar	VIF5
gongorizarán	gongorizar	VIF6
gongorizaría	gongorizar	VIC1
gongorizarías	gongorizar	VIC2
gongorizaría	gongorizar	VIC3
gongorizaríamos	gongorizar	VIC4
gongorizaríais	gongorizar	VIC5
gongorizarían	gongorizar	VIC6
gongoricé	gongorizar	VIX1
gongorizaste	gongorizar	VIX2
gongorizó	gongorizar	VIX3
gongorizasteis	gongorizar	VIX5
gongorizaron	gongorizar	VIX6
gongorice	gongorizar	VSP1
gongorices	gongorizar	VSP2
gongoricemos	gongorizar	VSP4
gongoricéis	gongorizar	VSP5
gongoricen	gongorizar	VSP6
gongorizara	gongorizar	VSX1
gongorizaras	gongorizar	VSX2
gongorizáramos	gongorizar	VSX4
gongorizarais	gongorizar	VSX5
gongorizaran	gongorizar	VSX6
gongorizare	gongorizar	VSF1
gongorizares	gongorizar	VSF2
gongorizáremos	gongorizar	VSF4
gongorizareis	gongorizar	VSF5
gongorizaren	gongorizar	VSF6
gongorizase	gongorizar	VSI1
gongorizases	gongorizar	VSI2
gongorizásemos	gongorizar	VSI4
gongorizaseis	gongorizar	VSI5
gongorizasen	gongorizar	VSI6
gongorizad	gongorizar	VMP
gongorizadme	gongorizar	VMSE
gongorizadle	gongorizar	VMSE
gongorizadnos	gongorizar	VMPE
gongorizaos	gongorizar	VMPE
gongorizadles	gongorizar	VMPE
gongorizado	gongorizar	VPM
gongorizados	gongorizar	VPMP
gongorizada	gongorizar	VPF
gongorizadas	gongorizar	VPFP
gongorizando	gongorizar	VG
gongorizándome	gongorizar	VGSE
gongorizándote	gongorizar	VGSE
gongorizándole	gongorizar	VGSE
gongorizándonos	gongorizar	VGPE
gongorizándoos	gongorizar	VGPE
