himen	himen	O
himenes	himen	P
himeneo	himeneo	O
himeneos	himeneo	P
himenóptero	himenóptero	O
himenópteros	himenóptero	P
himnario	himnario	O
himnarios	himnario	P
himno	himno	O
himnos	himno	P
himnodia	himnodia	O
himnodias	himnodia	P
himpar	himpar	O
himpo	himpar	VIP1
himpas	himpar	VIP2
himpa	himpar	VIP3
himpamos	himpar	VIP4
himpáis	himpar	VIP5
himpan	himpar	VIP6
himpaba	himpar	VII1
himpabas	himpar	VII2
himpábamos	himpar	VII4
himpabais	himpar	VII5
himpaban	himpar	VII6
himparé	himpar	VIF1
himparás	himpar	VIF2
himpará	himpar	VIF3
himparemos	himpar	VIF4
himparéis	himpar	VIF5
himparán	himpar	VIF6
himparía	himpar	VIC1
himparías	himpar	VIC2
himparía	himpar	VIC3
himparíamos	himpar	VIC4
himparíais	himpar	VIC5
himparían	himpar	VIC6
himpé	himpar	VIX1
himpaste	himpar	VIX2
himpó	himpar	VIX3
himpasteis	himpar	VIX5
himparon	himpar	VIX6
himpe	himpar	VSP1
himpes	himpar	VSP2
himpemos	himpar	VSP4
himpéis	himpar	VSP5
himpen	himpar	VSP6
himpara	himpar	VSX1
himparas	himpar	VSX2
himpáramos	himpar	VSX4
himparais	himpar	VSX5
himparan	himpar	VSX6
himpare	himpar	VSF1
himpares	himpar	VSF2
himpáremos	himpar	VSF4
himpareis	himpar	VSF5
himparen	himpar	VSF6
himpase	himpar	VSI1
himpases	himpar	VSI2
himpásemos	himpar	VSI4
himpaseis	himpar	VSI5
himpasen	himpar	VSI6
himpad	himpar	VMP
himpadme	himpar	VMSE
himpadle	himpar	VMSE
himpadnos	himpar	VMPE
himpaos	himpar	VMPE
himpadles	himpar	VMPE
himpado	himpar	VPM
himpados	himpar	VPMP
himpada	himpar	VPF
himpadas	himpar	VPFP
himpando	himpar	VG
himpándome	himpar	VGSE
himpándote	himpar	VGSE
himpándole	himpar	VGSE
himpándonos	himpar	VGPE
himpándoos	himpar	VGPE
himplar	himplar	O
himplo	himplar	VIP1
himplas	himplar	VIP2
himpla	himplar	VIP3
himplamos	himplar	VIP4
himpláis	himplar	VIP5
himplan	himplar	VIP6
himplaba	himplar	VII1
himplabas	himplar	VII2
himplábamos	himplar	VII4
himplabais	himplar	VII5
himplaban	himplar	VII6
himplaré	himplar	VIF1
himplarás	himplar	VIF2
himplará	himplar	VIF3
himplaremos	himplar	VIF4
himplaréis	himplar	VIF5
himplarán	himplar	VIF6
himplaría	himplar	VIC1
himplarías	himplar	VIC2
himplaría	himplar	VIC3
himplaríamos	himplar	VIC4
himplaríais	himplar	VIC5
himplarían	himplar	VIC6
himplé	himplar	VIX1
himplaste	himplar	VIX2
himpló	himplar	VIX3
himplasteis	himplar	VIX5
himplaron	himplar	VIX6
himple	himplar	VSP1
himples	himplar	VSP2
himplemos	himplar	VSP4
himpléis	himplar	VSP5
himplen	himplar	VSP6
himplara	himplar	VSX1
himplaras	himplar	VSX2
himpláramos	himplar	VSX4
himplarais	himplar	VSX5
himplaran	himplar	VSX6
himplare	himplar	VSF1
himplares	himplar	VSF2
himpláremos	himplar	VSF4
himplareis	himplar	VSF5
himplaren	himplar	VSF6
himplase	himplar	VSI1
himplases	himplar	VSI2
himplásemos	himplar	VSI4
himplaseis	himplar	VSI5
himplasen	himplar	VSI6
himplad	himplar	VMP
himpladme	himplar	VMSE
himpladle	himplar	VMSE
himpladnos	himplar	VMPE
himplaos	himplar	VMPE
himpladles	himplar	VMPE
himplado	himplar	VPM
himplados	himplar	VPMP
himplada	himplar	VPF
himpladas	himplar	VPFP
himplando	himplar	VG
himplándome	himplar	VGSE
himplándote	himplar	VGSE
himplándole	himplar	VGSE
himplándonos	himplar	VGPE
himplándoos	himplar	VGPE
