hiperactividad	hiperactividad	O
hiperactividades	hiperactividad	P
hiperactivo	hiperactivo	O
hiperactivas	hiperactivo	FP
hiperactiva	hiperactivo	F
hiperactivos	hiperactivo	P
hiperboloide	hiperboloide	O
hiperboloides	hiperboloide	P
hiperbático	hiperbático	O
hiperbáticas	hiperbático	FP
hiperbática	hiperbático	F
hiperbáticos	hiperbático	P
hiperbólicamente	hiperbólicamente	O
hiperbólico	hiperbólico	O
hiperbólicas	hiperbólico	FP
hiperbólica	hiperbólico	F
hiperbólicos	hiperbólico	P
hiperbóreo	hiperbóreo	O
hiperbóreas	hiperbóreo	FP
hiperbórea	hiperbóreo	F
hiperbóreos	hiperbóreo	P
hipercalcemia	hipercalcemia	O
hipercalcemias	hipercalcemia	P
hiperclorhidria	hiperclorhidria	O
hiperclorhidrias	hiperclorhidria	P
hiperclorhídrico	hiperclorhídrico	O
hiperclorhídricas	hiperclorhídrico	FP
hiperclorhídrica	hiperclorhídrico	F
hiperclorhídricos	hiperclorhídrico	P
hipercrisis	hipercrisis	O
hipercrítico	hipercrítico	O
hipercríticas	hipercrítico	FP
hipercrítica	hipercrítico	F
hipercríticos	hipercrítico	P
hiperdulía	hiperdulía	O
hiperdulías	hiperdulía	P
hiperemia	hiperemia	O
hiperemias	hiperemia	P
hiperespacio	hiperespacio	O
hiperespacios	hiperespacio	P
hiperestesia	hiperestesia	O
hiperestesias	hiperestesia	P
hiperestésico	hiperestésico	O
hiperestésicas	hiperestésico	FP
hiperestésica	hiperestésico	F
hiperestésicos	hiperestésico	P
hiperfunción	hiperfunción	O
hiperfunciones	hiperfunción	P
hiperglucemia	hiperglucemia	O
hiperglucemias	hiperglucemia	P
hiperhidrosis	hiperhidrosis	O
hipericíneo	hipericíneo	O
hipericíneas	hipericíneo	FP
hipericínea	hipericíneo	F
hipericíneos	hipericíneo	P
hiperlipidemia	hiperlipidemia	O
hiperlipidemias	hiperlipidemia	P
hipermenorrea	hipermenorrea	O
hipermenorreas	hipermenorrea	P
hipermercado	hipermercado	O
hipermercados	hipermercado	P
hipermetamorfosis	hipermetamorfosis	O
hipermetropía	hipermetropía	O
hipermetropías	hipermetropía	P
hipermetría	hipermetría	O
hipermetrías	hipermetría	P
hipermétrope	hipermétrope	O
hipermétropes	hipermétrope	P
hiperoxia	hiperoxia	O
hiperoxias	hiperoxia	P
hiperplasia	hiperplasia	O
hiperplasias	hiperplasia	P
hiperrealismo	hiperrealismo	O
hiperrealismos	hiperrealismo	P
hipersensibilidad	hipersensibilidad	O
hipersensibilidades	hipersensibilidad	P
hipersensible	hipersensible	O
hipersensibles	hipersensible	P
hipersónico	hipersónico	O
hipersónicas	hipersónico	FP
hipersónica	hipersónico	F
hipersónicos	hipersónico	P
hipertensión	hipertensión	O
hipertensiones	hipertensión	P
hipertenso	hipertenso	O
hipertensas	hipertenso	FP
hipertensa	hipertenso	F
hipertensos	hipertenso	P
hipertermia	hipertermia	O
hipertermias	hipertermia	P
hipertiroidismo	hipertiroidismo	O
hipertiroidismos	hipertiroidismo	P
hipertonía	hipertonía	O
hipertonías	hipertonía	P
hipertrofia	hipertrofia	O
hipertrofias	hipertrofia	P
hipertrófico	hipertrófico	O
hipertróficas	hipertrófico	FP
hipertrófica	hipertrófico	F
hipertróficos	hipertrófico	P
hipertónico	hipertónico	O
hipertónicas	hipertónico	FP
hipertónica	hipertónico	F
hipertónicos	hipertónico	P
hiperventilación	hiperventilación	O
hiperventilaciones	hiperventilación	P
hipervitaminosis	hipervitaminosis	O
hiperémesis	hiperémesis	O
hiperónimo	hiperónimo	O
hiperónimos	hiperónimo	P
hipido	hipido	O
hipidos	hipido	P
hipismo	hipismo	O
hipismos	hipismo	P
hipnal	hipnal	O
hipnales	hipnal	P
hipnosis	hipnosis	O
hipnotismo	hipnotismo	O
hipnotismos	hipnotismo	P
hipnotización	hipnotización	O
hipnotizaciones	hipnotización	P
hipnotizador	hipnotizador	O
hipnotizadoras	hipnotizador	FP
hipnotizadora	hipnotizador	F
hipnotizadores	hipnotizador	P
hipnótico	hipnótico	O
hipnóticas	hipnótico	FP
hipnótica	hipnótico	F
hipnóticos	hipnótico	P
hipo	hipo	O
hipos	hipo	P
hipoalergénico	hipoalergénico	O
hipoalergénicas	hipoalergénico	FP
hipoalergénica	hipoalergénico	F
hipoalergénicos	hipoalergénico	P
hipoalérgico	hipoalérgico	O
hipoalérgicas	hipoalérgico	FP
hipoalérgica	hipoalérgico	F
hipoalérgicos	hipoalérgico	P
hipocalcemia	hipocalcemia	O
hipocalcemias	hipocalcemia	P
hipocalórico	hipocalórico	O
hipocalóricas	hipocalórico	FP
hipocalórica	hipocalórico	F
hipocalóricos	hipocalórico	P
hipocampo	hipocampo	O
hipocampos	hipocampo	P
hipocastanáceo	hipocastanáceo	O
hipocastanáceas	hipocastanáceo	FP
hipocastanácea	hipocastanáceo	F
hipocastanáceos	hipocastanáceo	P
hipocastáneo	hipocastáneo	O
hipocastáneas	hipocastáneo	FP
hipocastánea	hipocastáneo	F
hipocastáneos	hipocastáneo	P
hipocausto	hipocausto	O
hipocaustos	hipocausto	P
hipocentauro	hipocentauro	O
hipocentauros	hipocentauro	P
hipocentro	hipocentro	O
hipocentros	hipocentro	P
hipocicloide	hipocicloide	O
hipocicloides	hipocicloide	P
hipoclorhidria	hipoclorhidria	O
hipoclorhidrias	hipoclorhidria	P
hipoclorhídrico	hipoclorhídrico	O
hipoclorhídricas	hipoclorhídrico	FP
hipoclorhídrica	hipoclorhídrico	F
hipoclorhídricos	hipoclorhídrico	P
hipocondriaco	hipocondriaco	O
hipocondriacas	hipocondriaco	FP
hipocondriaca	hipocondriaco	F
hipocondriacos	hipocondriaco	P
hipocondrio	hipocondrio	O
hipocondrios	hipocondrio	P
hipocondría	hipocondría	O
hipocondrías	hipocondría	P
hipocondríaco	hipocondríaco	O
hipocondríacas	hipocondríaco	FP
hipocondríaca	hipocondríaco	F
hipocondríacos	hipocondríaco	P
hipocorístico	hipocorístico	O
hipocorísticas	hipocorístico	FP
hipocorística	hipocorístico	F
hipocorísticos	hipocorístico	P
hipocresía	hipocresía	O
hipocresías	hipocresía	P
hipocrás	hipocrás	O
hipocrases	hipocrás	P
hipocrático	hipocrático	O
hipocráticas	hipocrático	FP
hipocrática	hipocrático	F
hipocráticos	hipocrático	P
hipocrénides	hipocrénides	O
hipocóndrico	hipocóndrico	O
hipocóndricas	hipocóndrico	FP
hipocóndrica	hipocóndrico	F
hipocóndricos	hipocóndrico	P
hipodérmico	hipodérmico	O
hipodérmicas	hipodérmico	FP
hipodérmica	hipodérmico	F
hipodérmicos	hipodérmico	P
hipofosfito	hipofosfito	O
hipofosfitos	hipofosfito	P
hipofosforoso	hipofosforoso	O
hipofosforosos	hipofosforoso	P
hipofunción	hipofunción	O
hipofunciones	hipofunción	P
hipogastrio	hipogastrio	O
hipogastrios	hipogastrio	P
hipogeo	hipogeo	O
hipogeas	hipogeo	FP
hipogea	hipogeo	F
hipogeos	hipogeo	P
hipogloso	hipogloso	O
hipoglosas	hipogloso	FP
hipoglosa	hipogloso	F
hipoglosos	hipogloso	P
hipoglucemia	hipoglucemia	O
hipoglucemias	hipoglucemia	P
hipogrifo	hipogrifo	O
hipogrifos	hipogrifo	P
hipogástrico	hipogástrico	O
hipogástricas	hipogástrico	FP
hipogástrica	hipogástrico	F
hipogástricos	hipogástrico	P
hipogénico	hipogénico	O
hipogénicas	hipogénico	FP
hipogénica	hipogénico	F
hipogénicos	hipogénico	P
hipología	hipología	O
hipologías	hipología	P
hipomaniaco	hipomaniaco	O
hipomaniacas	hipomaniaco	FP
hipomaniaca	hipomaniaco	F
hipomaniacos	hipomaniaco	P
hipomanía	hipomanía	O
hipomanías	hipomanía	P
hipomaníaco	hipomaníaco	O
hipomaníacas	hipomaníaco	FP
hipomaníaca	hipomaníaco	F
hipomaníacos	hipomaníaco	P
hipomoclio	hipomoclio	O
hipomoclios	hipomoclio	P
hipomoclion	hipomoclion	O
hipomocliones	hipomoclion	P
hipopótamo	hipopótamo	O
hipopótamos	hipopótamo	P
hiposo	hiposo	O
hiposas	hiposo	FP
hiposa	hiposo	F
hiposos	hiposo	P
hipostasis	hipostasis	O
hipostáticamente	hipostáticamente	O
hipostático	hipostático	O
hipostáticas	hipostático	FP
hipostática	hipostático	F
hipostáticos	hipostático	P
hiposulfito	hiposulfito	O
hiposulfitos	hiposulfito	P
hiposulfuroso	hiposulfuroso	O
hiposulfurosos	hiposulfuroso	P
hipotaxis	hipotaxis	O
hipoteca	hipoteca	O
hipotecas	hipoteca	P
hipotecable	hipotecable	O
hipotecables	hipotecable	P
hipotecario	hipotecario	O
hipotecarias	hipotecario	FP
hipotecaria	hipotecario	F
hipotecarios	hipotecario	P
hipotecnia	hipotecnia	O
hipotecnias	hipotecnia	P
hipotensión	hipotensión	O
hipotensiones	hipotensión	P
hipotenso	hipotenso	O
hipotensas	hipotenso	FP
hipotensa	hipotenso	F
hipotensos	hipotenso	P
hipotenusa	hipotenusa	O
hipotenusas	hipotenusa	P
hipotermia	hipotermia	O
hipotermias	hipotermia	P
hipotiposis	hipotiposis	O
hipotiroidismo	hipotiroidismo	O
hipotiroidismos	hipotiroidismo	P
hipotonía	hipotonía	O
hipotonías	hipotonía	P
hipotálamo	hipotálamo	O
hipotálamos	hipotálamo	P
hipotérmico	hipotérmico	O
hipotérmicas	hipotérmico	FP
hipotérmica	hipotérmico	F
hipotérmicos	hipotérmico	P
hipotéticamente	hipotéticamente	O
hipotético	hipotético	O
hipotéticas	hipotético	FP
hipotética	hipotético	F
hipotéticos	hipotético	P
hipotónico	hipotónico	O
hipotónicas	hipotónico	FP
hipotónica	hipotónico	F
hipotónicos	hipotónico	P
hipovitaminosis	hipovitaminosis	O
hipovolemia	hipovolemia	O
hipovolemias	hipovolemia	P
hipoxia	hipoxia	O
hipoxias	hipoxia	P
hippie	hippie	O
hippies	hippie	P
hippy	hippy	O
hippyes	hippy	P
hipsometría	hipsometría	O
hipsometrías	hipsometría	P
hipsométrico	hipsométrico	O
hipsométricas	hipsométrico	FP
hipsométrica	hipsométrico	F
hipsométricos	hipsométrico	P
hipsómetro	hipsómetro	O
hipsómetros	hipsómetro	P
hipálage	hipálage	O
hipálages	hipálage	P
hipérbato	hipérbato	O
hipérbatos	hipérbato	P
hipérbaton	hipérbaton	O
hipérbatones	hipérbaton	P
hipérbola	hipérbola	O
hipérbolas	hipérbola	P
hipérbole	hipérbole	O
hipérboles	hipérbole	P
hipérico	hipérico	O
hipéricos	hipérico	P
hipócrita	hipócrita	O
hipócritas	hipócrita	P
hipócritamente	hipócritamente	O
hipódromo	hipódromo	O
hipódromos	hipódromo	P
hipófisis	hipófisis	O
hipólogo	hipólogo	O
hipólogas	hipólogo	FP
hipóloga	hipólogo	F
hipólogos	hipólogo	P
hipómanes	hipómanes	O
hipónimo	hipónimo	O
hipónimos	hipónimo	P
hipóstasis	hipóstasis	O
hipótesi	hipótesi	O
hipótesis	hipótesi	P
hipótesis	hipótesis	O
híper	híper	O
híperes	híper	P
hípico	hípico	O
hípicas	hípico	FP
hípica	hípico	F
hípicos	hípico	P
hipar	hipar	O
hipo	hipar	VIP1
hipas	hipar	VIP2
hipa	hipar	VIP3
hipamos	hipar	VIP4
hipáis	hipar	VIP5
hipan	hipar	VIP6
hipaba	hipar	VII1
hipabas	hipar	VII2
hipábamos	hipar	VII4
hipabais	hipar	VII5
hipaban	hipar	VII6
hiparé	hipar	VIF1
hiparás	hipar	VIF2
hipará	hipar	VIF3
hiparemos	hipar	VIF4
hiparéis	hipar	VIF5
hiparán	hipar	VIF6
hiparía	hipar	VIC1
hiparías	hipar	VIC2
hiparía	hipar	VIC3
hiparíamos	hipar	VIC4
hiparíais	hipar	VIC5
hiparían	hipar	VIC6
hipé	hipar	VIX1
hipaste	hipar	VIX2
hipó	hipar	VIX3
hipasteis	hipar	VIX5
hiparon	hipar	VIX6
hipe	hipar	VSP1
hipes	hipar	VSP2
hipemos	hipar	VSP4
hipéis	hipar	VSP5
hipen	hipar	VSP6
hipara	hipar	VSX1
hiparas	hipar	VSX2
hipáramos	hipar	VSX4
hiparais	hipar	VSX5
hiparan	hipar	VSX6
hipare	hipar	VSF1
hipares	hipar	VSF2
hipáremos	hipar	VSF4
hipareis	hipar	VSF5
hiparen	hipar	VSF6
hipase	hipar	VSI1
hipases	hipar	VSI2
hipásemos	hipar	VSI4
hipaseis	hipar	VSI5
hipasen	hipar	VSI6
hipad	hipar	VMP
hipadme	hipar	VMSE
hipadle	hipar	VMSE
hipadnos	hipar	VMPE
hipaos	hipar	VMPE
hipadles	hipar	VMPE
hipado	hipar	VPM
hipados	hipar	VPMP
hipada	hipar	VPF
hipadas	hipar	VPFP
hipando	hipar	VG
hipándome	hipar	VGSE
hipándote	hipar	VGSE
hipándole	hipar	VGSE
hipándonos	hipar	VGPE
hipándoos	hipar	VGPE
hiperbolizar	hiperbolizar	O
hiperbolizo	hiperbolizar	VIP1
hiperbolizas	hiperbolizar	VIP2
hiperboliza	hiperbolizar	VIP3
hiperbolizamos	hiperbolizar	VIP4
hiperbolizáis	hiperbolizar	VIP5
hiperbolizan	hiperbolizar	VIP6
hiperbolizaba	hiperbolizar	VII1
hiperbolizabas	hiperbolizar	VII2
hiperbolizábamos	hiperbolizar	VII4
hiperbolizabais	hiperbolizar	VII5
hiperbolizaban	hiperbolizar	VII6
hiperbolizaré	hiperbolizar	VIF1
hiperbolizarás	hiperbolizar	VIF2
hiperbolizará	hiperbolizar	VIF3
hiperbolizaremos	hiperbolizar	VIF4
hiperbolizaréis	hiperbolizar	VIF5
hiperbolizarán	hiperbolizar	VIF6
hiperbolizaría	hiperbolizar	VIC1
hiperbolizarías	hiperbolizar	VIC2
hiperbolizaría	hiperbolizar	VIC3
hiperbolizaríamos	hiperbolizar	VIC4
hiperbolizaríais	hiperbolizar	VIC5
hiperbolizarían	hiperbolizar	VIC6
hiperbolicé	hiperbolizar	VIX1
hiperbolizaste	hiperbolizar	VIX2
hiperbolizó	hiperbolizar	VIX3
hiperbolizasteis	hiperbolizar	VIX5
hiperbolizaron	hiperbolizar	VIX6
hiperbolice	hiperbolizar	VSP1
hiperbolices	hiperbolizar	VSP2
hiperbolicemos	hiperbolizar	VSP4
hiperbolicéis	hiperbolizar	VSP5
hiperbolicen	hiperbolizar	VSP6
hiperbolizara	hiperbolizar	VSX1
hiperbolizaras	hiperbolizar	VSX2
hiperbolizáramos	hiperbolizar	VSX4
hiperbolizarais	hiperbolizar	VSX5
hiperbolizaran	hiperbolizar	VSX6
hiperbolizare	hiperbolizar	VSF1
hiperbolizares	hiperbolizar	VSF2
hiperbolizáremos	hiperbolizar	VSF4
hiperbolizareis	hiperbolizar	VSF5
hiperbolizaren	hiperbolizar	VSF6
hiperbolizase	hiperbolizar	VSI1
hiperbolizases	hiperbolizar	VSI2
hiperbolizásemos	hiperbolizar	VSI4
hiperbolizaseis	hiperbolizar	VSI5
hiperbolizasen	hiperbolizar	VSI6
hiperbolizad	hiperbolizar	VMP
hiperbolizadme	hiperbolizar	VMSE
hiperbolizadle	hiperbolizar	VMSE
hiperbolizadnos	hiperbolizar	VMPE
hiperbolizaos	hiperbolizar	VMPE
hiperbolizadles	hiperbolizar	VMPE
hiperbolizado	hiperbolizar	VPM
hiperbolizados	hiperbolizar	VPMP
hiperbolizada	hiperbolizar	VPF
hiperbolizadas	hiperbolizar	VPFP
hiperbolizando	hiperbolizar	VG
hiperbolizándome	hiperbolizar	VGSE
hiperbolizándote	hiperbolizar	VGSE
hiperbolizándole	hiperbolizar	VGSE
hiperbolizándonos	hiperbolizar	VGPE
hiperbolizándoos	hiperbolizar	VGPE
hiperestesiar	hiperestesiar	O
hiperestesio	hiperestesiar	VIP1
hiperestesias	hiperestesiar	VIP2
hiperestesia	hiperestesiar	VIP3
hiperestesiamos	hiperestesiar	VIP4
hiperestesiáis	hiperestesiar	VIP5
hiperestesian	hiperestesiar	VIP6
hiperestesiaba	hiperestesiar	VII1
hiperestesiabas	hiperestesiar	VII2
hiperestesiábamos	hiperestesiar	VII4
hiperestesiabais	hiperestesiar	VII5
hiperestesiaban	hiperestesiar	VII6
hiperestesiaré	hiperestesiar	VIF1
hiperestesiarás	hiperestesiar	VIF2
hiperestesiará	hiperestesiar	VIF3
hiperestesiaremos	hiperestesiar	VIF4
hiperestesiaréis	hiperestesiar	VIF5
hiperestesiarán	hiperestesiar	VIF6
hiperestesiaría	hiperestesiar	VIC1
hiperestesiarías	hiperestesiar	VIC2
hiperestesiaría	hiperestesiar	VIC3
hiperestesiaríamos	hiperestesiar	VIC4
hiperestesiaríais	hiperestesiar	VIC5
hiperestesiarían	hiperestesiar	VIC6
hiperestesié	hiperestesiar	VIX1
hiperestesiaste	hiperestesiar	VIX2
hiperestesió	hiperestesiar	VIX3
hiperestesiasteis	hiperestesiar	VIX5
hiperestesiaron	hiperestesiar	VIX6
hiperestesie	hiperestesiar	VSP1
hiperestesies	hiperestesiar	VSP2
hiperestesiemos	hiperestesiar	VSP4
hiperestesiéis	hiperestesiar	VSP5
hiperestesien	hiperestesiar	VSP6
hiperestesiara	hiperestesiar	VSX1
hiperestesiaras	hiperestesiar	VSX2
hiperestesiáramos	hiperestesiar	VSX4
hiperestesiarais	hiperestesiar	VSX5
hiperestesiaran	hiperestesiar	VSX6
hiperestesiare	hiperestesiar	VSF1
hiperestesiares	hiperestesiar	VSF2
hiperestesiáremos	hiperestesiar	VSF4
hiperestesiareis	hiperestesiar	VSF5
hiperestesiaren	hiperestesiar	VSF6
hiperestesiase	hiperestesiar	VSI1
hiperestesiases	hiperestesiar	VSI2
hiperestesiásemos	hiperestesiar	VSI4
hiperestesiaseis	hiperestesiar	VSI5
hiperestesiasen	hiperestesiar	VSI6
hiperestesiad	hiperestesiar	VMP
hiperestesiadme	hiperestesiar	VMSE
hiperestesiadle	hiperestesiar	VMSE
hiperestesiadnos	hiperestesiar	VMPE
hiperestesiaos	hiperestesiar	VMPE
hiperestesiadles	hiperestesiar	VMPE
hiperestesiadlo	hiperestesiar	VMMSE
hiperestesiadla	hiperestesiar	VMFSE
hiperestesiadlos	hiperestesiar	VMMPE
hiperestesiadlas	hiperestesiar	VMFPE
hiperestesiádmelo	hiperestesiar	VMMSE
hiperestesiádselo	hiperestesiar	VMMSE
hiperestesiádnoslo	hiperestesiar	VMMSE
hiperestesiáoslo	hiperestesiar	VMMSE
hiperestesiádmelos	hiperestesiar	VMMPE
hiperestesiádselos	hiperestesiar	VMMPE
hiperestesiádnoslos	hiperestesiar	VMMPE
hiperestesiáoslos	hiperestesiar	VMMPE
hiperestesiádmela	hiperestesiar	VMFSE
hiperestesiádsela	hiperestesiar	VMFSE
hiperestesiádnosla	hiperestesiar	VMFSE
hiperestesiáosla	hiperestesiar	VMFSE
hiperestesiádmelas	hiperestesiar	VMFPE
hiperestesiádselas	hiperestesiar	VMFPE
hiperestesiádnoslas	hiperestesiar	VMFPE
hiperestesiáoslas	hiperestesiar	VMFPE
hiperestesiado	hiperestesiar	VPM
hiperestesiados	hiperestesiar	VPMP
hiperestesiada	hiperestesiar	VPF
hiperestesiadas	hiperestesiar	VPFP
hiperestesiando	hiperestesiar	VG
hiperestesiándome	hiperestesiar	VGSE
hiperestesiándote	hiperestesiar	VGSE
hiperestesiándole	hiperestesiar	VGSE
hiperestesiándonos	hiperestesiar	VGPE
hiperestesiándoos	hiperestesiar	VGPE
hiperestesiándolo	hiperestesiar	VGMSE
hiperestesiándola	hiperestesiar	VGFSE
hiperestesiándolos	hiperestesiar	VGMPE
hiperestesiándolas	hiperestesiar	VGFPE
hiperestesiándomelo	hiperestesiar	VGMSE
hiperestesiándotelo	hiperestesiar	VGMSE
hiperestesiándoselo	hiperestesiar	VGMSE
hiperestesiándonoslo	hiperestesiar	VGMSE
hiperestesiándooslo	hiperestesiar	VGMSE
hiperestesiándomelos	hiperestesiar	VGMPE
hiperestesiándotelos	hiperestesiar	VGMPE
hiperestesiándoselos	hiperestesiar	VGMPE
hiperestesiándonoslos	hiperestesiar	VGMPE
hiperestesiándooslos	hiperestesiar	VGMPE
hiperestesiándomela	hiperestesiar	VGFSE
hiperestesiándotela	hiperestesiar	VGFSE
hiperestesiándosela	hiperestesiar	VGFSE
hiperestesiándonosla	hiperestesiar	VGFSE
hiperestesiándoosla	hiperestesiar	VGFSE
hiperestesiándomelas	hiperestesiar	VGFPE
hiperestesiándotelas	hiperestesiar	VGFPE
hiperestesiándoselas	hiperestesiar	VGFPE
hiperestesiándonoslas	hiperestesiar	VGFPE
hiperestesiándooslas	hiperestesiar	VGFPE
hipertrofiar	hipertrofiar	O
hipertrofio	hipertrofiar	VIP1
hipertrofias	hipertrofiar	VIP2
hipertrofia	hipertrofiar	VIP3
hipertrofiamos	hipertrofiar	VIP4
hipertrofiáis	hipertrofiar	VIP5
hipertrofian	hipertrofiar	VIP6
hipertrofiaba	hipertrofiar	VII1
hipertrofiabas	hipertrofiar	VII2
hipertrofiábamos	hipertrofiar	VII4
hipertrofiabais	hipertrofiar	VII5
hipertrofiaban	hipertrofiar	VII6
hipertrofiaré	hipertrofiar	VIF1
hipertrofiarás	hipertrofiar	VIF2
hipertrofiará	hipertrofiar	VIF3
hipertrofiaremos	hipertrofiar	VIF4
hipertrofiaréis	hipertrofiar	VIF5
hipertrofiarán	hipertrofiar	VIF6
hipertrofiaría	hipertrofiar	VIC1
hipertrofiarías	hipertrofiar	VIC2
hipertrofiaría	hipertrofiar	VIC3
hipertrofiaríamos	hipertrofiar	VIC4
hipertrofiaríais	hipertrofiar	VIC5
hipertrofiarían	hipertrofiar	VIC6
hipertrofié	hipertrofiar	VIX1
hipertrofiaste	hipertrofiar	VIX2
hipertrofió	hipertrofiar	VIX3
hipertrofiasteis	hipertrofiar	VIX5
hipertrofiaron	hipertrofiar	VIX6
hipertrofie	hipertrofiar	VSP1
hipertrofies	hipertrofiar	VSP2
hipertrofiemos	hipertrofiar	VSP4
hipertrofiéis	hipertrofiar	VSP5
hipertrofien	hipertrofiar	VSP6
hipertrofiara	hipertrofiar	VSX1
hipertrofiaras	hipertrofiar	VSX2
hipertrofiáramos	hipertrofiar	VSX4
hipertrofiarais	hipertrofiar	VSX5
hipertrofiaran	hipertrofiar	VSX6
hipertrofiare	hipertrofiar	VSF1
hipertrofiares	hipertrofiar	VSF2
hipertrofiáremos	hipertrofiar	VSF4
hipertrofiareis	hipertrofiar	VSF5
hipertrofiaren	hipertrofiar	VSF6
hipertrofiase	hipertrofiar	VSI1
hipertrofiases	hipertrofiar	VSI2
hipertrofiásemos	hipertrofiar	VSI4
hipertrofiaseis	hipertrofiar	VSI5
hipertrofiasen	hipertrofiar	VSI6
hipertrofiad	hipertrofiar	VMP
hipertrofiadme	hipertrofiar	VMSE
hipertrofiadle	hipertrofiar	VMSE
hipertrofiadnos	hipertrofiar	VMPE
hipertrofiaos	hipertrofiar	VMPE
hipertrofiadles	hipertrofiar	VMPE
hipertrofiado	hipertrofiar	VPM
hipertrofiados	hipertrofiar	VPMP
hipertrofiada	hipertrofiar	VPF
hipertrofiadas	hipertrofiar	VPFP
hipertrofiando	hipertrofiar	VG
hipertrofiándome	hipertrofiar	VGSE
hipertrofiándote	hipertrofiar	VGSE
hipertrofiándole	hipertrofiar	VGSE
hipertrofiándonos	hipertrofiar	VGPE
hipertrofiándoos	hipertrofiar	VGPE
hipnotizar	hipnotizar	O
hipnotizo	hipnotizar	VIP1
hipnotizas	hipnotizar	VIP2
hipnotiza	hipnotizar	VIP3
hipnotizamos	hipnotizar	VIP4
hipnotizáis	hipnotizar	VIP5
hipnotizan	hipnotizar	VIP6
hipnotizaba	hipnotizar	VII1
hipnotizabas	hipnotizar	VII2
hipnotizábamos	hipnotizar	VII4
hipnotizabais	hipnotizar	VII5
hipnotizaban	hipnotizar	VII6
hipnotizaré	hipnotizar	VIF1
hipnotizarás	hipnotizar	VIF2
hipnotizará	hipnotizar	VIF3
hipnotizaremos	hipnotizar	VIF4
hipnotizaréis	hipnotizar	VIF5
hipnotizarán	hipnotizar	VIF6
hipnotizaría	hipnotizar	VIC1
hipnotizarías	hipnotizar	VIC2
hipnotizaría	hipnotizar	VIC3
hipnotizaríamos	hipnotizar	VIC4
hipnotizaríais	hipnotizar	VIC5
hipnotizarían	hipnotizar	VIC6
hipnoticé	hipnotizar	VIX1
hipnotizaste	hipnotizar	VIX2
hipnotizó	hipnotizar	VIX3
hipnotizasteis	hipnotizar	VIX5
hipnotizaron	hipnotizar	VIX6
hipnotice	hipnotizar	VSP1
hipnotices	hipnotizar	VSP2
hipnoticemos	hipnotizar	VSP4
hipnoticéis	hipnotizar	VSP5
hipnoticen	hipnotizar	VSP6
hipnotizara	hipnotizar	VSX1
hipnotizaras	hipnotizar	VSX2
hipnotizáramos	hipnotizar	VSX4
hipnotizarais	hipnotizar	VSX5
hipnotizaran	hipnotizar	VSX6
hipnotizare	hipnotizar	VSF1
hipnotizares	hipnotizar	VSF2
hipnotizáremos	hipnotizar	VSF4
hipnotizareis	hipnotizar	VSF5
hipnotizaren	hipnotizar	VSF6
hipnotizase	hipnotizar	VSI1
hipnotizases	hipnotizar	VSI2
hipnotizásemos	hipnotizar	VSI4
hipnotizaseis	hipnotizar	VSI5
hipnotizasen	hipnotizar	VSI6
hipnotizad	hipnotizar	VMP
hipnotizadme	hipnotizar	VMSE
hipnotizadle	hipnotizar	VMSE
hipnotizadnos	hipnotizar	VMPE
hipnotizaos	hipnotizar	VMPE
hipnotizadles	hipnotizar	VMPE
hipnotizadlo	hipnotizar	VMMSE
hipnotizadla	hipnotizar	VMFSE
hipnotizadlos	hipnotizar	VMMPE
hipnotizadlas	hipnotizar	VMFPE
hipnotizádmelo	hipnotizar	VMMSE
hipnotizádselo	hipnotizar	VMMSE
hipnotizádnoslo	hipnotizar	VMMSE
hipnotizáoslo	hipnotizar	VMMSE
hipnotizádmelos	hipnotizar	VMMPE
hipnotizádselos	hipnotizar	VMMPE
hipnotizádnoslos	hipnotizar	VMMPE
hipnotizáoslos	hipnotizar	VMMPE
hipnotizádmela	hipnotizar	VMFSE
hipnotizádsela	hipnotizar	VMFSE
hipnotizádnosla	hipnotizar	VMFSE
hipnotizáosla	hipnotizar	VMFSE
hipnotizádmelas	hipnotizar	VMFPE
hipnotizádselas	hipnotizar	VMFPE
hipnotizádnoslas	hipnotizar	VMFPE
hipnotizáoslas	hipnotizar	VMFPE
hipnotizado	hipnotizar	VPM
hipnotizados	hipnotizar	VPMP
hipnotizada	hipnotizar	VPF
hipnotizadas	hipnotizar	VPFP
hipnotizando	hipnotizar	VG
hipnotizándome	hipnotizar	VGSE
hipnotizándote	hipnotizar	VGSE
hipnotizándole	hipnotizar	VGSE
hipnotizándonos	hipnotizar	VGPE
hipnotizándoos	hipnotizar	VGPE
hipnotizándolo	hipnotizar	VGMSE
hipnotizándola	hipnotizar	VGFSE
hipnotizándolos	hipnotizar	VGMPE
hipnotizándolas	hipnotizar	VGFPE
hipnotizándomelo	hipnotizar	VGMSE
hipnotizándotelo	hipnotizar	VGMSE
hipnotizándoselo	hipnotizar	VGMSE
hipnotizándonoslo	hipnotizar	VGMSE
hipnotizándooslo	hipnotizar	VGMSE
hipnotizándomelos	hipnotizar	VGMPE
hipnotizándotelos	hipnotizar	VGMPE
hipnotizándoselos	hipnotizar	VGMPE
hipnotizándonoslos	hipnotizar	VGMPE
hipnotizándooslos	hipnotizar	VGMPE
hipnotizándomela	hipnotizar	VGFSE
hipnotizándotela	hipnotizar	VGFSE
hipnotizándosela	hipnotizar	VGFSE
hipnotizándonosla	hipnotizar	VGFSE
hipnotizándoosla	hipnotizar	VGFSE
hipnotizándomelas	hipnotizar	VGFPE
hipnotizándotelas	hipnotizar	VGFPE
hipnotizándoselas	hipnotizar	VGFPE
hipnotizándonoslas	hipnotizar	VGFPE
hipnotizándooslas	hipnotizar	VGFPE
hipotecar	hipotecar	O
hipoteco	hipotecar	VIP1
hipotecas	hipotecar	VIP2
hipoteca	hipotecar	VIP3
hipotecamos	hipotecar	VIP4
hipotecáis	hipotecar	VIP5
hipotecan	hipotecar	VIP6
hipotecaba	hipotecar	VII1
hipotecabas	hipotecar	VII2
hipotecábamos	hipotecar	VII4
hipotecabais	hipotecar	VII5
hipotecaban	hipotecar	VII6
hipotecaré	hipotecar	VIF1
hipotecarás	hipotecar	VIF2
hipotecará	hipotecar	VIF3
hipotecaremos	hipotecar	VIF4
hipotecaréis	hipotecar	VIF5
hipotecarán	hipotecar	VIF6
hipotecaría	hipotecar	VIC1
hipotecarías	hipotecar	VIC2
hipotecaría	hipotecar	VIC3
hipotecaríamos	hipotecar	VIC4
hipotecaríais	hipotecar	VIC5
hipotecarían	hipotecar	VIC6
hipotequé	hipotecar	VIX1
hipotecaste	hipotecar	VIX2
hipotecó	hipotecar	VIX3
hipotecasteis	hipotecar	VIX5
hipotecaron	hipotecar	VIX6
hipoteque	hipotecar	VSP1
hipoteques	hipotecar	VSP2
hipotequemos	hipotecar	VSP4
hipotequéis	hipotecar	VSP5
hipotequen	hipotecar	VSP6
hipotecara	hipotecar	VSX1
hipotecaras	hipotecar	VSX2
hipotecáramos	hipotecar	VSX4
hipotecarais	hipotecar	VSX5
hipotecaran	hipotecar	VSX6
hipotecare	hipotecar	VSF1
hipotecares	hipotecar	VSF2
hipotecáremos	hipotecar	VSF4
hipotecareis	hipotecar	VSF5
hipotecaren	hipotecar	VSF6
hipotecase	hipotecar	VSI1
hipotecases	hipotecar	VSI2
hipotecásemos	hipotecar	VSI4
hipotecaseis	hipotecar	VSI5
hipotecasen	hipotecar	VSI6
hipotecad	hipotecar	VMP
hipotecadme	hipotecar	VMSE
hipotecadle	hipotecar	VMSE
hipotecadnos	hipotecar	VMPE
hipotecaos	hipotecar	VMPE
hipotecadles	hipotecar	VMPE
hipotecadlo	hipotecar	VMMSE
hipotecadla	hipotecar	VMFSE
hipotecadlos	hipotecar	VMMPE
hipotecadlas	hipotecar	VMFPE
hipotecádmelo	hipotecar	VMMSE
hipotecádselo	hipotecar	VMMSE
hipotecádnoslo	hipotecar	VMMSE
hipotecáoslo	hipotecar	VMMSE
hipotecádmelos	hipotecar	VMMPE
hipotecádselos	hipotecar	VMMPE
hipotecádnoslos	hipotecar	VMMPE
hipotecáoslos	hipotecar	VMMPE
hipotecádmela	hipotecar	VMFSE
hipotecádsela	hipotecar	VMFSE
hipotecádnosla	hipotecar	VMFSE
hipotecáosla	hipotecar	VMFSE
hipotecádmelas	hipotecar	VMFPE
hipotecádselas	hipotecar	VMFPE
hipotecádnoslas	hipotecar	VMFPE
hipotecáoslas	hipotecar	VMFPE
hipotecado	hipotecar	VPM
hipotecados	hipotecar	VPMP
hipotecada	hipotecar	VPF
hipotecadas	hipotecar	VPFP
hipotecando	hipotecar	VG
hipotecándome	hipotecar	VGSE
hipotecándote	hipotecar	VGSE
hipotecándole	hipotecar	VGSE
hipotecándonos	hipotecar	VGPE
hipotecándoos	hipotecar	VGPE
hipotecándolo	hipotecar	VGMSE
hipotecándola	hipotecar	VGFSE
hipotecándolos	hipotecar	VGMPE
hipotecándolas	hipotecar	VGFPE
hipotecándomelo	hipotecar	VGMSE
hipotecándotelo	hipotecar	VGMSE
hipotecándoselo	hipotecar	VGMSE
hipotecándonoslo	hipotecar	VGMSE
hipotecándooslo	hipotecar	VGMSE
hipotecándomelos	hipotecar	VGMPE
hipotecándotelos	hipotecar	VGMPE
hipotecándoselos	hipotecar	VGMPE
hipotecándonoslos	hipotecar	VGMPE
hipotecándooslos	hipotecar	VGMPE
hipotecándomela	hipotecar	VGFSE
hipotecándotela	hipotecar	VGFSE
hipotecándosela	hipotecar	VGFSE
hipotecándonosla	hipotecar	VGFSE
hipotecándoosla	hipotecar	VGFSE
hipotecándomelas	hipotecar	VGFPE
hipotecándotelas	hipotecar	VGFPE
hipotecándoselas	hipotecar	VGFPE
hipotecándonoslas	hipotecar	VGFPE
hipotecándooslas	hipotecar	VGFPE
