higa	higa	O
higas	higa	P
higadilla	higadilla	O
higadillas	higadilla	P
higadillo	higadillo	O
higadillos	higadillo	P
higaja	higaja	O
higajas	higaja	P
higate	higate	O
higates	higate	P
higiene	higiene	O
higienes	higiene	P
higienista	higienista	O
higienistas	higienista	P
higienización	higienización	O
higienizaciones	higienización	P
higiénico	higiénico	O
higiénicas	higiénico	FP
higiénica	higiénico	F
higiénicos	higiénico	P
higo	higo	O
higos	higo	P
higroma	higroma	O
higromas	higroma	P
higrometría	higrometría	O
higrometrías	higrometría	P
higrométrico	higrométrico	O
higrométricas	higrométrico	FP
higrométrica	higrométrico	F
higrométricos	higrométrico	P
higroscopia	higroscopia	O
higroscopias	higroscopia	P
higroscopicidad	higroscopicidad	O
higroscopicidades	higroscopicidad	P
higroscopio	higroscopio	O
higroscopios	higroscopio	P
higroscópico	higroscópico	O
higroscópicas	higroscópico	FP
higroscópica	higroscópico	F
higroscópicos	higroscópico	P
higrómetro	higrómetro	O
higrómetros	higrómetro	P
higuana	higuana	O
higuanas	higuana	P
higuela	higuela	O
higuelas	higuela	P
higuera	higuera	O
higueras	higuera	P
higueral	higueral	O
higuerales	higueral	P
higuereta	higuereta	O
higueretas	higuereta	P
higuerilla	higuerilla	O
higuerillas	higuerilla	P
higuerote	higuerote	O
higuerotes	higuerote	P
higueruela	higueruela	O
higueruelas	higueruela	P
higuerón	higuerón	O
higuerones	higuerón	P
higuillo	higuillo	O
higuillos	higuillo	P
higuí	higuí	O
higuíes	higuí	P
higüela	higüela	O
higüelas	higüela	P
higüera	higüera	O
higüeras	higüera	P
higüero	higüero	O
higüeros	higüero	P
hígado	hígado	O
hígados	hígado	P
higienizar	higienizar	O
higienizo	higienizar	VIP1
higienizas	higienizar	VIP2
higieniza	higienizar	VIP3
higienizamos	higienizar	VIP4
higienizáis	higienizar	VIP5
higienizan	higienizar	VIP6
higienizaba	higienizar	VII1
higienizabas	higienizar	VII2
higienizábamos	higienizar	VII4
higienizabais	higienizar	VII5
higienizaban	higienizar	VII6
higienizaré	higienizar	VIF1
higienizarás	higienizar	VIF2
higienizará	higienizar	VIF3
higienizaremos	higienizar	VIF4
higienizaréis	higienizar	VIF5
higienizarán	higienizar	VIF6
higienizaría	higienizar	VIC1
higienizarías	higienizar	VIC2
higienizaría	higienizar	VIC3
higienizaríamos	higienizar	VIC4
higienizaríais	higienizar	VIC5
higienizarían	higienizar	VIC6
higienicé	higienizar	VIX1
higienizaste	higienizar	VIX2
higienizó	higienizar	VIX3
higienizasteis	higienizar	VIX5
higienizaron	higienizar	VIX6
higienice	higienizar	VSP1
higienices	higienizar	VSP2
higienicemos	higienizar	VSP4
higienicéis	higienizar	VSP5
higienicen	higienizar	VSP6
higienizara	higienizar	VSX1
higienizaras	higienizar	VSX2
higienizáramos	higienizar	VSX4
higienizarais	higienizar	VSX5
higienizaran	higienizar	VSX6
higienizare	higienizar	VSF1
higienizares	higienizar	VSF2
higienizáremos	higienizar	VSF4
higienizareis	higienizar	VSF5
higienizaren	higienizar	VSF6
higienizase	higienizar	VSI1
higienizases	higienizar	VSI2
higienizásemos	higienizar	VSI4
higienizaseis	higienizar	VSI5
higienizasen	higienizar	VSI6
higienizad	higienizar	VMP
higienizadme	higienizar	VMSE
higienizadle	higienizar	VMSE
higienizadnos	higienizar	VMPE
higienizaos	higienizar	VMPE
higienizadles	higienizar	VMPE
higienizadlo	higienizar	VMMSE
higienizadla	higienizar	VMFSE
higienizadlos	higienizar	VMMPE
higienizadlas	higienizar	VMFPE
higienizádmelo	higienizar	VMMSE
higienizádselo	higienizar	VMMSE
higienizádnoslo	higienizar	VMMSE
higienizáoslo	higienizar	VMMSE
higienizádmelos	higienizar	VMMPE
higienizádselos	higienizar	VMMPE
higienizádnoslos	higienizar	VMMPE
higienizáoslos	higienizar	VMMPE
higienizádmela	higienizar	VMFSE
higienizádsela	higienizar	VMFSE
higienizádnosla	higienizar	VMFSE
higienizáosla	higienizar	VMFSE
higienizádmelas	higienizar	VMFPE
higienizádselas	higienizar	VMFPE
higienizádnoslas	higienizar	VMFPE
higienizáoslas	higienizar	VMFPE
higienizado	higienizar	VPM
higienizados	higienizar	VPMP
higienizada	higienizar	VPF
higienizadas	higienizar	VPFP
higienizando	higienizar	VG
higienizándome	higienizar	VGSE
higienizándote	higienizar	VGSE
higienizándole	higienizar	VGSE
higienizándonos	higienizar	VGPE
higienizándoos	higienizar	VGPE
higienizándolo	higienizar	VGMSE
higienizándola	higienizar	VGFSE
higienizándolos	higienizar	VGMPE
higienizándolas	higienizar	VGFPE
higienizándomelo	higienizar	VGMSE
higienizándotelo	higienizar	VGMSE
higienizándoselo	higienizar	VGMSE
higienizándonoslo	higienizar	VGMSE
higienizándooslo	higienizar	VGMSE
higienizándomelos	higienizar	VGMPE
higienizándotelos	higienizar	VGMPE
higienizándoselos	higienizar	VGMPE
higienizándonoslos	higienizar	VGMPE
higienizándooslos	higienizar	VGMPE
higienizándomela	higienizar	VGFSE
higienizándotela	higienizar	VGFSE
higienizándosela	higienizar	VGFSE
higienizándonosla	higienizar	VGFSE
higienizándoosla	higienizar	VGFSE
higienizándomelas	higienizar	VGFPE
higienizándotelas	higienizar	VGFPE
higienizándoselas	higienizar	VGFPE
higienizándonoslas	higienizar	VGFPE
higienizándooslas	higienizar	VGFPE
