homarrache	homarrache	O
homarraches	homarrache	P
hombracho	hombracho	O
hombrachos	hombracho	P
hombrada	hombrada	O
hombradas	hombrada	P
hombradía	hombradía	O
hombradías	hombradía	P
hombre	hombre	O
hombres	hombre	P
hombrecillo	hombrecillo	O
hombrecillos	hombrecillo	P
hombredad	hombredad	O
hombredades	hombredad	P
hombrera	hombrera	O
hombreras	hombrera	P
hombrillo	hombrillo	O
hombrillos	hombrillo	P
hombro	hombro	O
hombros	hombro	P
hombruno	hombruno	O
hombrunas	hombruno	FP
hombruna	hombruno	F
hombrunos	hombruno	P
hombría	hombría	O
hombrías	hombría	P
home	home	O
homes	home	P
homecillo	homecillo	O
homecillos	homecillo	P
homenaje	homenaje	O
homenajes	homenaje	P
homenajeado	homenajeado	O
homenajeadas	homenajeado	FP
homenajeada	homenajeado	F
homenajeados	homenajeado	P
homeopatía	homeopatía	O
homeopatías	homeopatía	P
homeopáticamente	homeopáticamente	O
homeopático	homeopático	O
homeopáticas	homeopático	FP
homeopática	homeopático	F
homeopáticos	homeopático	P
homeostasis	homeostasis	O
homeostático	homeostático	O
homeostáticas	homeostático	FP
homeostática	homeostático	F
homeostáticos	homeostático	P
homeotermia	homeotermia	O
homeotermias	homeotermia	P
homeotermo	homeotermo	O
homeotermas	homeotermo	FP
homeoterma	homeotermo	F
homeotermos	homeotermo	P
homeotérmico	homeotérmico	O
homeotérmicas	homeotérmico	FP
homeotérmica	homeotérmico	F
homeotérmicos	homeotérmico	P
homeópata	homeópata	O
homeópatas	homeópata	P
homeóstasis	homeóstasis	O
homiciano	homiciano	O
homicianos	homiciano	P
homicida	homicida	O
homicidas	homicida	P
homicidio	homicidio	O
homicidios	homicidio	P
homiciero	homiciero	O
homicieros	homiciero	P
homicillo	homicillo	O
homicillos	homicillo	P
homiliario	homiliario	O
homiliarios	homiliario	P
homilía	homilía	O
homilías	homilía	P
hominal	hominal	O
hominales	hominal	P
hominicaco	hominicaco	O
hominicacos	hominicaco	P
homo	homo	O
homos	homo	P
homocerca	homocerca	O
homocercas	homocerca	P
homoclamídeo	homoclamídeo	O
homoclamídeas	homoclamídeo	FP
homoclamídea	homoclamídeo	F
homoclamídeos	homoclamídeo	P
homofonía	homofonía	O
homofonías	homofonía	P
homogeneidad	homogeneidad	O
homogeneidades	homogeneidad	P
homogeneización	homogeneización	O
homogeneizaciones	homogeneización	P
homografía	homografía	O
homografías	homografía	P
homogéneamente	homogéneamente	O
homogéneo	homogéneo	O
homogéneas	homogéneo	FP
homogénea	homogéneo	F
homogéneos	homogéneo	P
homologable	homologable	O
homologables	homologable	P
homologación	homologación	O
homologaciones	homologación	P
homología	homología	O
homologías	homología	P
homomorfismo	homomorfismo	O
homomorfismos	homomorfismo	P
homonimia	homonimia	O
homonimias	homonimia	P
homoplastia	homoplastia	O
homoplastias	homoplastia	P
homosexual	homosexual	O
homosexuales	homosexual	P
homosexualidad	homosexualidad	O
homosexualidades	homosexualidad	P
homosfera	homosfera	O
homosferas	homosfera	P
homérico	homérico	O
homéricas	homérico	FP
homérica	homérico	F
homéricos	homérico	P
homínido	homínido	O
homínidos	homínido	P
homófono	homófono	O
homófonas	homófono	FP
homófona	homófono	F
homófonos	homófono	P
homógrafo	homógrafo	O
homógrafas	homógrafo	FP
homógrafa	homógrafo	F
homógrafos	homógrafo	P
homólogo	homólogo	O
homólogas	homólogo	FP
homóloga	homólogo	F
homólogos	homólogo	P
homónimo	homónimo	O
homónimas	homónimo	FP
homónima	homónimo	F
homónimos	homónimo	P
homóptero	homóptero	O
homópteros	homóptero	P
homúnculo	homúnculo	O
homúnculos	homúnculo	P
hombrear	hombrear	O
hombreo	hombrear	VIP1
hombreas	hombrear	VIP2
hombrea	hombrear	VIP3
hombreamos	hombrear	VIP4
hombreáis	hombrear	VIP5
hombrean	hombrear	VIP6
hombreaba	hombrear	VII1
hombreabas	hombrear	VII2
hombreábamos	hombrear	VII4
hombreabais	hombrear	VII5
hombreaban	hombrear	VII6
hombrearé	hombrear	VIF1
hombrearás	hombrear	VIF2
hombreará	hombrear	VIF3
hombrearemos	hombrear	VIF4
hombrearéis	hombrear	VIF5
hombrearán	hombrear	VIF6
hombrearía	hombrear	VIC1
hombrearías	hombrear	VIC2
hombrearía	hombrear	VIC3
hombrearíamos	hombrear	VIC4
hombrearíais	hombrear	VIC5
hombrearían	hombrear	VIC6
hombreé	hombrear	VIX1
hombreaste	hombrear	VIX2
hombreó	hombrear	VIX3
hombreasteis	hombrear	VIX5
hombrearon	hombrear	VIX6
hombree	hombrear	VSP1
hombrees	hombrear	VSP2
hombreemos	hombrear	VSP4
hombreéis	hombrear	VSP5
hombreen	hombrear	VSP6
hombreara	hombrear	VSX1
hombrearas	hombrear	VSX2
hombreáramos	hombrear	VSX4
hombrearais	hombrear	VSX5
hombrearan	hombrear	VSX6
hombreare	hombrear	VSF1
hombreares	hombrear	VSF2
hombreáremos	hombrear	VSF4
hombreareis	hombrear	VSF5
hombrearen	hombrear	VSF6
hombrease	hombrear	VSI1
hombreases	hombrear	VSI2
hombreásemos	hombrear	VSI4
hombreaseis	hombrear	VSI5
hombreasen	hombrear	VSI6
hombread	hombrear	VMP
hombreadme	hombrear	VMSE
hombreadle	hombrear	VMSE
hombreadnos	hombrear	VMPE
hombreaos	hombrear	VMPE
hombreadles	hombrear	VMPE
hombreado	hombrear	VPM
hombreados	hombrear	VPMP
hombreada	hombrear	VPF
hombreadas	hombrear	VPFP
hombreando	hombrear	VG
hombreándome	hombrear	VGSE
hombreándote	hombrear	VGSE
hombreándole	hombrear	VGSE
hombreándonos	hombrear	VGPE
hombreándoos	hombrear	VGPE
homenajear	homenajear	O
homenajeo	homenajear	VIP1
homenajeas	homenajear	VIP2
homenajea	homenajear	VIP3
homenajeamos	homenajear	VIP4
homenajeáis	homenajear	VIP5
homenajean	homenajear	VIP6
homenajeaba	homenajear	VII1
homenajeabas	homenajear	VII2
homenajeábamos	homenajear	VII4
homenajeabais	homenajear	VII5
homenajeaban	homenajear	VII6
homenajearé	homenajear	VIF1
homenajearás	homenajear	VIF2
homenajeará	homenajear	VIF3
homenajearemos	homenajear	VIF4
homenajearéis	homenajear	VIF5
homenajearán	homenajear	VIF6
homenajearía	homenajear	VIC1
homenajearías	homenajear	VIC2
homenajearía	homenajear	VIC3
homenajearíamos	homenajear	VIC4
homenajearíais	homenajear	VIC5
homenajearían	homenajear	VIC6
homenajeé	homenajear	VIX1
homenajeaste	homenajear	VIX2
homenajeó	homenajear	VIX3
homenajeasteis	homenajear	VIX5
homenajearon	homenajear	VIX6
homenajee	homenajear	VSP1
homenajees	homenajear	VSP2
homenajeemos	homenajear	VSP4
homenajeéis	homenajear	VSP5
homenajeen	homenajear	VSP6
homenajeara	homenajear	VSX1
homenajearas	homenajear	VSX2
homenajeáramos	homenajear	VSX4
homenajearais	homenajear	VSX5
homenajearan	homenajear	VSX6
homenajeare	homenajear	VSF1
homenajeares	homenajear	VSF2
homenajeáremos	homenajear	VSF4
homenajeareis	homenajear	VSF5
homenajearen	homenajear	VSF6
homenajease	homenajear	VSI1
homenajeases	homenajear	VSI2
homenajeásemos	homenajear	VSI4
homenajeaseis	homenajear	VSI5
homenajeasen	homenajear	VSI6
homenajead	homenajear	VMP
homenajeadme	homenajear	VMSE
homenajeadle	homenajear	VMSE
homenajeadnos	homenajear	VMPE
homenajeaos	homenajear	VMPE
homenajeadles	homenajear	VMPE
homenajeadlo	homenajear	VMMSE
homenajeadla	homenajear	VMFSE
homenajeadlos	homenajear	VMMPE
homenajeadlas	homenajear	VMFPE
homenajeádmelo	homenajear	VMMSE
homenajeádselo	homenajear	VMMSE
homenajeádnoslo	homenajear	VMMSE
homenajeáoslo	homenajear	VMMSE
homenajeádmelos	homenajear	VMMPE
homenajeádselos	homenajear	VMMPE
homenajeádnoslos	homenajear	VMMPE
homenajeáoslos	homenajear	VMMPE
homenajeádmela	homenajear	VMFSE
homenajeádsela	homenajear	VMFSE
homenajeádnosla	homenajear	VMFSE
homenajeáosla	homenajear	VMFSE
homenajeádmelas	homenajear	VMFPE
homenajeádselas	homenajear	VMFPE
homenajeádnoslas	homenajear	VMFPE
homenajeáoslas	homenajear	VMFPE
homenajeado	homenajear	VPM
homenajeados	homenajear	VPMP
homenajeada	homenajear	VPF
homenajeadas	homenajear	VPFP
homenajeando	homenajear	VG
homenajeándome	homenajear	VGSE
homenajeándote	homenajear	VGSE
homenajeándole	homenajear	VGSE
homenajeándonos	homenajear	VGPE
homenajeándoos	homenajear	VGPE
homenajeándolo	homenajear	VGMSE
homenajeándola	homenajear	VGFSE
homenajeándolos	homenajear	VGMPE
homenajeándolas	homenajear	VGFPE
homenajeándomelo	homenajear	VGMSE
homenajeándotelo	homenajear	VGMSE
homenajeándoselo	homenajear	VGMSE
homenajeándonoslo	homenajear	VGMSE
homenajeándooslo	homenajear	VGMSE
homenajeándomelos	homenajear	VGMPE
homenajeándotelos	homenajear	VGMPE
homenajeándoselos	homenajear	VGMPE
homenajeándonoslos	homenajear	VGMPE
homenajeándooslos	homenajear	VGMPE
homenajeándomela	homenajear	VGFSE
homenajeándotela	homenajear	VGFSE
homenajeándosela	homenajear	VGFSE
homenajeándonosla	homenajear	VGFSE
homenajeándoosla	homenajear	VGFSE
homenajeándomelas	homenajear	VGFPE
homenajeándotelas	homenajear	VGFPE
homenajeándoselas	homenajear	VGFPE
homenajeándonoslas	homenajear	VGFPE
homenajeándooslas	homenajear	VGFPE
homiciar	homiciar	O
homicio	homiciar	VIP1
homicias	homiciar	VIP2
homicia	homiciar	VIP3
homiciamos	homiciar	VIP4
homiciáis	homiciar	VIP5
homician	homiciar	VIP6
homiciaba	homiciar	VII1
homiciabas	homiciar	VII2
homiciábamos	homiciar	VII4
homiciabais	homiciar	VII5
homiciaban	homiciar	VII6
homiciaré	homiciar	VIF1
homiciarás	homiciar	VIF2
homiciará	homiciar	VIF3
homiciaremos	homiciar	VIF4
homiciaréis	homiciar	VIF5
homiciarán	homiciar	VIF6
homiciaría	homiciar	VIC1
homiciarías	homiciar	VIC2
homiciaría	homiciar	VIC3
homiciaríamos	homiciar	VIC4
homiciaríais	homiciar	VIC5
homiciarían	homiciar	VIC6
homicié	homiciar	VIX1
homiciaste	homiciar	VIX2
homició	homiciar	VIX3
homiciasteis	homiciar	VIX5
homiciaron	homiciar	VIX6
homicie	homiciar	VSP1
homicies	homiciar	VSP2
homiciemos	homiciar	VSP4
homiciéis	homiciar	VSP5
homicien	homiciar	VSP6
homiciara	homiciar	VSX1
homiciaras	homiciar	VSX2
homiciáramos	homiciar	VSX4
homiciarais	homiciar	VSX5
homiciaran	homiciar	VSX6
homiciare	homiciar	VSF1
homiciares	homiciar	VSF2
homiciáremos	homiciar	VSF4
homiciareis	homiciar	VSF5
homiciaren	homiciar	VSF6
homiciase	homiciar	VSI1
homiciases	homiciar	VSI2
homiciásemos	homiciar	VSI4
homiciaseis	homiciar	VSI5
homiciasen	homiciar	VSI6
homiciad	homiciar	VMP
homiciadme	homiciar	VMSE
homiciadle	homiciar	VMSE
homiciadnos	homiciar	VMPE
homiciaos	homiciar	VMPE
homiciadles	homiciar	VMPE
homiciado	homiciar	VPM
homiciados	homiciar	VPMP
homiciada	homiciar	VPF
homiciadas	homiciar	VPFP
homiciando	homiciar	VG
homiciándome	homiciar	VGSE
homiciándote	homiciar	VGSE
homiciándole	homiciar	VGSE
homiciándonos	homiciar	VGPE
homiciándoos	homiciar	VGPE
homogeneizar	homogeneizar	O
homogeneizo	homogeneizar	VIP1
homogeneizas	homogeneizar	VIP2
homogeneiza	homogeneizar	VIP3
homogeneizamos	homogeneizar	VIP4
homogeneizáis	homogeneizar	VIP5
homogeneizan	homogeneizar	VIP6
homogeneizaba	homogeneizar	VII1
homogeneizabas	homogeneizar	VII2
homogeneizábamos	homogeneizar	VII4
homogeneizabais	homogeneizar	VII5
homogeneizaban	homogeneizar	VII6
homogeneizaré	homogeneizar	VIF1
homogeneizarás	homogeneizar	VIF2
homogeneizará	homogeneizar	VIF3
homogeneizaremos	homogeneizar	VIF4
homogeneizaréis	homogeneizar	VIF5
homogeneizarán	homogeneizar	VIF6
homogeneizaría	homogeneizar	VIC1
homogeneizarías	homogeneizar	VIC2
homogeneizaría	homogeneizar	VIC3
homogeneizaríamos	homogeneizar	VIC4
homogeneizaríais	homogeneizar	VIC5
homogeneizarían	homogeneizar	VIC6
homogeneicé	homogeneizar	VIX1
homogeneizaste	homogeneizar	VIX2
homogeneizó	homogeneizar	VIX3
homogeneizasteis	homogeneizar	VIX5
homogeneizaron	homogeneizar	VIX6
homogeneice	homogeneizar	VSP1
homogeneices	homogeneizar	VSP2
homogeneicemos	homogeneizar	VSP4
homogeneicéis	homogeneizar	VSP5
homogeneicen	homogeneizar	VSP6
homogeneizara	homogeneizar	VSX1
homogeneizaras	homogeneizar	VSX2
homogeneizáramos	homogeneizar	VSX4
homogeneizarais	homogeneizar	VSX5
homogeneizaran	homogeneizar	VSX6
homogeneizare	homogeneizar	VSF1
homogeneizares	homogeneizar	VSF2
homogeneizáremos	homogeneizar	VSF4
homogeneizareis	homogeneizar	VSF5
homogeneizaren	homogeneizar	VSF6
homogeneizase	homogeneizar	VSI1
homogeneizases	homogeneizar	VSI2
homogeneizásemos	homogeneizar	VSI4
homogeneizaseis	homogeneizar	VSI5
homogeneizasen	homogeneizar	VSI6
homogeneizad	homogeneizar	VMP
homogeneizadme	homogeneizar	VMSE
homogeneizadle	homogeneizar	VMSE
homogeneizadnos	homogeneizar	VMPE
homogeneizaos	homogeneizar	VMPE
homogeneizadles	homogeneizar	VMPE
homogeneizadlo	homogeneizar	VMMSE
homogeneizadla	homogeneizar	VMFSE
homogeneizadlos	homogeneizar	VMMPE
homogeneizadlas	homogeneizar	VMFPE
homogeneizádmelo	homogeneizar	VMMSE
homogeneizádselo	homogeneizar	VMMSE
homogeneizádnoslo	homogeneizar	VMMSE
homogeneizáoslo	homogeneizar	VMMSE
homogeneizádmelos	homogeneizar	VMMPE
homogeneizádselos	homogeneizar	VMMPE
homogeneizádnoslos	homogeneizar	VMMPE
homogeneizáoslos	homogeneizar	VMMPE
homogeneizádmela	homogeneizar	VMFSE
homogeneizádsela	homogeneizar	VMFSE
homogeneizádnosla	homogeneizar	VMFSE
homogeneizáosla	homogeneizar	VMFSE
homogeneizádmelas	homogeneizar	VMFPE
homogeneizádselas	homogeneizar	VMFPE
homogeneizádnoslas	homogeneizar	VMFPE
homogeneizáoslas	homogeneizar	VMFPE
homogeneizado	homogeneizar	VPM
homogeneizados	homogeneizar	VPMP
homogeneizada	homogeneizar	VPF
homogeneizadas	homogeneizar	VPFP
homogeneizando	homogeneizar	VG
homogeneizándome	homogeneizar	VGSE
homogeneizándote	homogeneizar	VGSE
homogeneizándole	homogeneizar	VGSE
homogeneizándonos	homogeneizar	VGPE
homogeneizándoos	homogeneizar	VGPE
homogeneizándolo	homogeneizar	VGMSE
homogeneizándola	homogeneizar	VGFSE
homogeneizándolos	homogeneizar	VGMPE
homogeneizándolas	homogeneizar	VGFPE
homogeneizándomelo	homogeneizar	VGMSE
homogeneizándotelo	homogeneizar	VGMSE
homogeneizándoselo	homogeneizar	VGMSE
homogeneizándonoslo	homogeneizar	VGMSE
homogeneizándooslo	homogeneizar	VGMSE
homogeneizándomelos	homogeneizar	VGMPE
homogeneizándotelos	homogeneizar	VGMPE
homogeneizándoselos	homogeneizar	VGMPE
homogeneizándonoslos	homogeneizar	VGMPE
homogeneizándooslos	homogeneizar	VGMPE
homogeneizándomela	homogeneizar	VGFSE
homogeneizándotela	homogeneizar	VGFSE
homogeneizándosela	homogeneizar	VGFSE
homogeneizándonosla	homogeneizar	VGFSE
homogeneizándoosla	homogeneizar	VGFSE
homogeneizándomelas	homogeneizar	VGFPE
homogeneizándotelas	homogeneizar	VGFPE
homogeneizándoselas	homogeneizar	VGFPE
homogeneizándonoslas	homogeneizar	VGFPE
homogeneizándooslas	homogeneizar	VGFPE
homologar	homologar	O
homologo	homologar	VIP1
homologas	homologar	VIP2
homologa	homologar	VIP3
homologamos	homologar	VIP4
homologáis	homologar	VIP5
homologan	homologar	VIP6
homologaba	homologar	VII1
homologabas	homologar	VII2
homologábamos	homologar	VII4
homologabais	homologar	VII5
homologaban	homologar	VII6
homologaré	homologar	VIF1
homologarás	homologar	VIF2
homologará	homologar	VIF3
homologaremos	homologar	VIF4
homologaréis	homologar	VIF5
homologarán	homologar	VIF6
homologaría	homologar	VIC1
homologarías	homologar	VIC2
homologaría	homologar	VIC3
homologaríamos	homologar	VIC4
homologaríais	homologar	VIC5
homologarían	homologar	VIC6
homologé	homologar	VIX1
homologaste	homologar	VIX2
homologó	homologar	VIX3
homologasteis	homologar	VIX5
homologaron	homologar	VIX6
homologue	homologar	VSP1
homologues	homologar	VSP2
homologuemos	homologar	VSP4
homologuéis	homologar	VSP5
homologuen	homologar	VSP6
homologara	homologar	VSX1
homologaras	homologar	VSX2
homologáramos	homologar	VSX4
homologarais	homologar	VSX5
homologaran	homologar	VSX6
homologare	homologar	VSF1
homologares	homologar	VSF2
homologáremos	homologar	VSF4
homologareis	homologar	VSF5
homologaren	homologar	VSF6
homologase	homologar	VSI1
homologases	homologar	VSI2
homologásemos	homologar	VSI4
homologaseis	homologar	VSI5
homologasen	homologar	VSI6
homologad	homologar	VMP
homologadme	homologar	VMSE
homologadle	homologar	VMSE
homologadnos	homologar	VMPE
homologaos	homologar	VMPE
homologadles	homologar	VMPE
homologadlo	homologar	VMMSE
homologadla	homologar	VMFSE
homologadlos	homologar	VMMPE
homologadlas	homologar	VMFPE
homologádmelo	homologar	VMMSE
homologádselo	homologar	VMMSE
homologádnoslo	homologar	VMMSE
homologáoslo	homologar	VMMSE
homologádmelos	homologar	VMMPE
homologádselos	homologar	VMMPE
homologádnoslos	homologar	VMMPE
homologáoslos	homologar	VMMPE
homologádmela	homologar	VMFSE
homologádsela	homologar	VMFSE
homologádnosla	homologar	VMFSE
homologáosla	homologar	VMFSE
homologádmelas	homologar	VMFPE
homologádselas	homologar	VMFPE
homologádnoslas	homologar	VMFPE
homologáoslas	homologar	VMFPE
homologado	homologar	VPM
homologados	homologar	VPMP
homologada	homologar	VPF
homologadas	homologar	VPFP
homologando	homologar	VG
homologándome	homologar	VGSE
homologándote	homologar	VGSE
homologándole	homologar	VGSE
homologándonos	homologar	VGPE
homologándoos	homologar	VGPE
homologándolo	homologar	VGMSE
homologándola	homologar	VGFSE
homologándolos	homologar	VGMPE
homologándolas	homologar	VGFPE
homologándomelo	homologar	VGMSE
homologándotelo	homologar	VGMSE
homologándoselo	homologar	VGMSE
homologándonoslo	homologar	VGMSE
homologándooslo	homologar	VGMSE
homologándomelos	homologar	VGMPE
homologándotelos	homologar	VGMPE
homologándoselos	homologar	VGMPE
homologándonoslos	homologar	VGMPE
homologándooslos	homologar	VGMPE
homologándomela	homologar	VGFSE
homologándotela	homologar	VGFSE
homologándosela	homologar	VGFSE
homologándonosla	homologar	VGFSE
homologándoosla	homologar	VGFSE
homologándomelas	homologar	VGFPE
homologándotelas	homologar	VGFPE
homologándoselas	homologar	VGFPE
homologándonoslas	homologar	VGFPE
homologándooslas	homologar	VGFPE
