inabarcable	inabarcable	O
inabarcables	inabarcable	P
inabordable	inabordable	O
inabordables	inabordable	P
inacabable	inacabable	O
inacabables	inacabable	P
inacabado	inacabado	O
inacabadas	inacabado	FP
inacabada	inacabado	F
inacabados	inacabado	P
inaccesibilidad	inaccesibilidad	O
inaccesibilidades	inaccesibilidad	P
inaccesible	inaccesible	O
inaccesibles	inaccesible	P
inaccesiblemente	inaccesiblemente	O
inacceso	inacceso	O
inaccesas	inacceso	FP
inaccesa	inacceso	F
inaccesos	inacceso	P
inacción	inacción	O
inacciones	inacción	P
inacentuado	inacentuado	O
inacentuadas	inacentuado	FP
inacentuada	inacentuado	F
inacentuados	inacentuado	P
inaceptable	inaceptable	O
inaceptables	inaceptable	P
inactividad	inactividad	O
inactividades	inactividad	P
inactivo	inactivo	O
inactivas	inactivo	FP
inactiva	inactivo	F
inactivos	inactivo	P
inactual	inactual	O
inactuales	inactual	P
inadaptabilidad	inadaptabilidad	O
inadaptabilidades	inadaptabilidad	P
inadaptable	inadaptable	O
inadaptables	inadaptable	P
inadaptación	inadaptación	O
inadaptaciones	inadaptación	P
inadaptado	inadaptado	O
inadaptadas	inadaptado	FP
inadaptada	inadaptado	F
inadaptados	inadaptado	P
inadecuación	inadecuación	O
inadecuaciones	inadecuación	P
inadecuado	inadecuado	O
inadecuadas	inadecuado	FP
inadecuada	inadecuado	F
inadecuados	inadecuado	P
inadmisible	inadmisible	O
inadmisibles	inadmisible	P
inadoptable	inadoptable	O
inadoptables	inadoptable	P
inadvertencia	inadvertencia	O
inadvertencias	inadvertencia	P
inadvertidamente	inadvertidamente	O
inadvertido	inadvertido	O
inadvertidas	inadvertido	FP
inadvertida	inadvertido	F
inadvertidos	inadvertido	P
inafectado	inafectado	O
inafectadas	inafectado	FP
inafectada	inafectado	F
inafectados	inafectado	P
inagotable	inagotable	O
inagotables	inagotable	P
inaguantable	inaguantable	O
inaguantables	inaguantable	P
inalcanzable	inalcanzable	O
inalcanzables	inalcanzable	P
inalienabilidad	inalienabilidad	O
inalienabilidades	inalienabilidad	P
inalienable	inalienable	O
inalienables	inalienable	P
inalterabilidad	inalterabilidad	O
inalterabilidades	inalterabilidad	P
inalterable	inalterable	O
inalterables	inalterable	P
inalterablemente	inalterablemente	O
inalterado	inalterado	O
inalteradas	inalterado	FP
inalterada	inalterado	F
inalterados	inalterado	P
inalámbrico	inalámbrico	O
inalámbricas	inalámbrico	FP
inalámbrica	inalámbrico	F
inalámbricos	inalámbrico	P
inameno	inameno	O
inamenas	inameno	FP
inamena	inameno	F
inamenos	inameno	P
inamisible	inamisible	O
inamisibles	inamisible	P
inamovible	inamovible	O
inamovibles	inamovible	P
inamovilidad	inamovilidad	O
inamovilidades	inamovilidad	P
inanalizable	inanalizable	O
inanalizables	inanalizable	P
inane	inane	O
inanes	inane	P
inanición	inanición	O
inaniciones	inanición	P
inanidad	inanidad	O
inanidades	inanidad	P
inanimado	inanimado	O
inanimadas	inanimado	FP
inanimada	inanimado	F
inanimados	inanimado	P
inapagable	inapagable	O
inapagables	inapagable	P
inapeable	inapeable	O
inapeables	inapeable	P
inapelable	inapelable	O
inapelables	inapelable	P
inapetencia	inapetencia	O
inapetencias	inapetencia	P
inapetente	inapetente	O
inapetentes	inapetente	P
inaplazable	inaplazable	O
inaplazables	inaplazable	P
inaplicable	inaplicable	O
inaplicables	inaplicable	P
inaplicación	inaplicación	O
inaplicaciones	inaplicación	P
inaplicado	inaplicado	O
inaplicadas	inaplicado	FP
inaplicada	inaplicado	F
inaplicados	inaplicado	P
inapreciable	inapreciable	O
inapreciables	inapreciable	P
inaprensible	inaprensible	O
inaprensibles	inaprensible	P
inaprensivo	inaprensivo	O
inaprensivas	inaprensivo	FP
inaprensiva	inaprensivo	F
inaprensivos	inaprensivo	P
inapropiable	inapropiable	O
inapropiables	inapropiable	P
inaprovechado	inaprovechado	O
inaprovechadas	inaprovechado	FP
inaprovechada	inaprovechado	F
inaprovechados	inaprovechado	P
inarmónico	inarmónico	O
inarmónicas	inarmónico	FP
inarmónica	inarmónico	F
inarmónicos	inarmónico	P
inarrugable	inarrugable	O
inarrugables	inarrugable	P
inarticulable	inarticulable	O
inarticulables	inarticulable	P
inarticulado	inarticulado	O
inarticuladas	inarticulado	FP
inarticulada	inarticulado	F
inarticulados	inarticulado	P
inartificioso	inartificioso	O
inartificiosas	inartificioso	FP
inartificiosa	inartificioso	F
inartificiosos	inartificioso	P
inasequible	inasequible	O
inasequibles	inasequible	P
inasible	inasible	O
inasibles	inasible	P
inasistencia	inasistencia	O
inasistencias	inasistencia	P
inasistente	inasistente	O
inasistentes	inasistente	P
inastillable	inastillable	O
inastillables	inastillable	P
inatacable	inatacable	O
inatacables	inatacable	P
inatención	inatención	O
inatenciones	inatención	P
inatento	inatento	O
inatentas	inatento	FP
inatenta	inatento	F
inatentos	inatento	P
inaudible	inaudible	O
inaudibles	inaudible	P
inaudito	inaudito	O
inauditas	inaudito	FP
inaudita	inaudito	F
inauditos	inaudito	P
inauguración	inauguración	O
inauguraciones	inauguración	P
inaugurador	inaugurador	O
inauguradoras	inaugurador	FP
inauguradora	inaugurador	F
inauguradores	inaugurador	P
inaugural	inaugural	O
inaugurales	inaugural	P
inaveriguable	inaveriguable	O
inaveriguables	inaveriguable	P
inaveriguado	inaveriguado	O
inaveriguadas	inaveriguado	FP
inaveriguada	inaveriguado	F
inaveriguados	inaveriguado	P
inánime	inánime	O
inánimes	inánime	P
inaugurar	inaugurar	O
inauguro	inaugurar	VIP1
inauguras	inaugurar	VIP2
inaugura	inaugurar	VIP3
inauguramos	inaugurar	VIP4
inauguráis	inaugurar	VIP5
inauguran	inaugurar	VIP6
inauguraba	inaugurar	VII1
inaugurabas	inaugurar	VII2
inaugurábamos	inaugurar	VII4
inaugurabais	inaugurar	VII5
inauguraban	inaugurar	VII6
inauguraré	inaugurar	VIF1
inaugurarás	inaugurar	VIF2
inaugurará	inaugurar	VIF3
inauguraremos	inaugurar	VIF4
inauguraréis	inaugurar	VIF5
inaugurarán	inaugurar	VIF6
inauguraría	inaugurar	VIC1
inaugurarías	inaugurar	VIC2
inauguraría	inaugurar	VIC3
inauguraríamos	inaugurar	VIC4
inauguraríais	inaugurar	VIC5
inaugurarían	inaugurar	VIC6
inauguré	inaugurar	VIX1
inauguraste	inaugurar	VIX2
inauguró	inaugurar	VIX3
inaugurasteis	inaugurar	VIX5
inauguraron	inaugurar	VIX6
inaugure	inaugurar	VSP1
inaugures	inaugurar	VSP2
inauguremos	inaugurar	VSP4
inauguréis	inaugurar	VSP5
inauguren	inaugurar	VSP6
inaugurara	inaugurar	VSX1
inauguraras	inaugurar	VSX2
inauguráramos	inaugurar	VSX4
inaugurarais	inaugurar	VSX5
inauguraran	inaugurar	VSX6
inaugurare	inaugurar	VSF1
inaugurares	inaugurar	VSF2
inauguráremos	inaugurar	VSF4
inaugurareis	inaugurar	VSF5
inauguraren	inaugurar	VSF6
inaugurase	inaugurar	VSI1
inaugurases	inaugurar	VSI2
inaugurásemos	inaugurar	VSI4
inauguraseis	inaugurar	VSI5
inaugurasen	inaugurar	VSI6
inaugurad	inaugurar	VMP
inauguradme	inaugurar	VMSE
inauguradle	inaugurar	VMSE
inauguradnos	inaugurar	VMPE
inauguraos	inaugurar	VMPE
inauguradles	inaugurar	VMPE
inauguradlo	inaugurar	VMMSE
inauguradla	inaugurar	VMFSE
inauguradlos	inaugurar	VMMPE
inauguradlas	inaugurar	VMFPE
inaugurádmelo	inaugurar	VMMSE
inaugurádselo	inaugurar	VMMSE
inaugurádnoslo	inaugurar	VMMSE
inauguráoslo	inaugurar	VMMSE
inaugurádmelos	inaugurar	VMMPE
inaugurádselos	inaugurar	VMMPE
inaugurádnoslos	inaugurar	VMMPE
inauguráoslos	inaugurar	VMMPE
inaugurádmela	inaugurar	VMFSE
inaugurádsela	inaugurar	VMFSE
inaugurádnosla	inaugurar	VMFSE
inauguráosla	inaugurar	VMFSE
inaugurádmelas	inaugurar	VMFPE
inaugurádselas	inaugurar	VMFPE
inaugurádnoslas	inaugurar	VMFPE
inauguráoslas	inaugurar	VMFPE
inaugurado	inaugurar	VPM
inaugurados	inaugurar	VPMP
inaugurada	inaugurar	VPF
inauguradas	inaugurar	VPFP
inaugurando	inaugurar	VG
inaugurándome	inaugurar	VGSE
inaugurándote	inaugurar	VGSE
inaugurándole	inaugurar	VGSE
inaugurándonos	inaugurar	VGPE
inaugurándoos	inaugurar	VGPE
inaugurándolo	inaugurar	VGMSE
inaugurándola	inaugurar	VGFSE
inaugurándolos	inaugurar	VGMPE
inaugurándolas	inaugurar	VGFPE
inaugurándomelo	inaugurar	VGMSE
inaugurándotelo	inaugurar	VGMSE
inaugurándoselo	inaugurar	VGMSE
inaugurándonoslo	inaugurar	VGMSE
inaugurándooslo	inaugurar	VGMSE
inaugurándomelos	inaugurar	VGMPE
inaugurándotelos	inaugurar	VGMPE
inaugurándoselos	inaugurar	VGMPE
inaugurándonoslos	inaugurar	VGMPE
inaugurándooslos	inaugurar	VGMPE
inaugurándomela	inaugurar	VGFSE
inaugurándotela	inaugurar	VGFSE
inaugurándosela	inaugurar	VGFSE
inaugurándonosla	inaugurar	VGFSE
inaugurándoosla	inaugurar	VGFSE
inaugurándomelas	inaugurar	VGFPE
inaugurándotelas	inaugurar	VGFPE
inaugurándoselas	inaugurar	VGFPE
inaugurándonoslas	inaugurar	VGFPE
inaugurándooslas	inaugurar	VGFPE
