las	la	P
las	las	O
lasaña	lasaña	O
lasañas	lasaña	P
lasca	lasca	O
lascas	lasca	P
lascivamente	lascivamente	O
lascivia	lascivia	O
lascivias	lascivia	P
lascivo	lascivo	O
lascivas	lascivo	FP
lasciva	lascivo	F
lascivos	lascivo	P
laserpicio	laserpicio	O
laserpicios	laserpicio	P
lasitud	lasitud	O
lasitudes	lasitud	P
laso	laso	O
lasas	laso	FP
lasa	laso	F
lasos	laso	P
lastimada	lastimada	O
lastimadas	lastimada	P
lastimador	lastimador	O
lastimadoras	lastimador	FP
lastimadora	lastimador	F
lastimadores	lastimador	P
lastimadura	lastimadura	O
lastimaduras	lastimadura	P
lastimeramente	lastimeramente	O
lastimero	lastimero	O
lastimeras	lastimero	FP
lastimera	lastimero	F
lastimeros	lastimero	P
lastimosamente	lastimosamente	O
lastimoso	lastimoso	O
lastimosas	lastimoso	FP
lastimosa	lastimoso	F
lastimosos	lastimoso	P
lasto	lasto	O
lastos	lasto	P
lastra	lastra	O
lastras	lastra	P
lastre	lastre	O
lastres	lastre	P
lastón	lastón	O
lastones	lastón	P
lasún	lasún	O
lasunes	lasún	P
las	lo	FP
láser	láser	O
láseres	láser	P
lástima	lástima	O
lástimas	lástima	P
lasar	lasar	O
laso	lasar	VIP1
lasas	lasar	VIP2
lasa	lasar	VIP3
lasamos	lasar	VIP4
lasáis	lasar	VIP5
lasan	lasar	VIP6
lasaba	lasar	VII1
lasabas	lasar	VII2
lasábamos	lasar	VII4
lasabais	lasar	VII5
lasaban	lasar	VII6
lasaré	lasar	VIF1
lasarás	lasar	VIF2
lasará	lasar	VIF3
lasaremos	lasar	VIF4
lasaréis	lasar	VIF5
lasarán	lasar	VIF6
lasaría	lasar	VIC1
lasarías	lasar	VIC2
lasaría	lasar	VIC3
lasaríamos	lasar	VIC4
lasaríais	lasar	VIC5
lasarían	lasar	VIC6
lasé	lasar	VIX1
lasaste	lasar	VIX2
lasó	lasar	VIX3
lasasteis	lasar	VIX5
lasaron	lasar	VIX6
lase	lasar	VSP1
lases	lasar	VSP2
lasemos	lasar	VSP4
laséis	lasar	VSP5
lasen	lasar	VSP6
lasara	lasar	VSX1
lasaras	lasar	VSX2
lasáramos	lasar	VSX4
lasarais	lasar	VSX5
lasaran	lasar	VSX6
lasare	lasar	VSF1
lasares	lasar	VSF2
lasáremos	lasar	VSF4
lasareis	lasar	VSF5
lasaren	lasar	VSF6
lasase	lasar	VSI1
lasases	lasar	VSI2
lasásemos	lasar	VSI4
lasaseis	lasar	VSI5
lasasen	lasar	VSI6
lasad	lasar	VMP
lasadme	lasar	VMSE
lasadle	lasar	VMSE
lasadnos	lasar	VMPE
lasaos	lasar	VMPE
lasadles	lasar	VMPE
lasado	lasar	VPM
lasados	lasar	VPMP
lasada	lasar	VPF
lasadas	lasar	VPFP
lasando	lasar	VG
lasándome	lasar	VGSE
lasándote	lasar	VGSE
lasándole	lasar	VGSE
lasándonos	lasar	VGPE
lasándoos	lasar	VGPE
lascar	lascar	O
lasco	lascar	VIP1
lascas	lascar	VIP2
lasca	lascar	VIP3
lascamos	lascar	VIP4
lascáis	lascar	VIP5
lascan	lascar	VIP6
lascaba	lascar	VII1
lascabas	lascar	VII2
lascábamos	lascar	VII4
lascabais	lascar	VII5
lascaban	lascar	VII6
lascaré	lascar	VIF1
lascarás	lascar	VIF2
lascará	lascar	VIF3
lascaremos	lascar	VIF4
lascaréis	lascar	VIF5
lascarán	lascar	VIF6
lascaría	lascar	VIC1
lascarías	lascar	VIC2
lascaría	lascar	VIC3
lascaríamos	lascar	VIC4
lascaríais	lascar	VIC5
lascarían	lascar	VIC6
lasqué	lascar	VIX1
lascaste	lascar	VIX2
lascó	lascar	VIX3
lascasteis	lascar	VIX5
lascaron	lascar	VIX6
lasque	lascar	VSP1
lasques	lascar	VSP2
lasquemos	lascar	VSP4
lasquéis	lascar	VSP5
lasquen	lascar	VSP6
lascara	lascar	VSX1
lascaras	lascar	VSX2
lascáramos	lascar	VSX4
lascarais	lascar	VSX5
lascaran	lascar	VSX6
lascare	lascar	VSF1
lascares	lascar	VSF2
lascáremos	lascar	VSF4
lascareis	lascar	VSF5
lascaren	lascar	VSF6
lascase	lascar	VSI1
lascases	lascar	VSI2
lascásemos	lascar	VSI4
lascaseis	lascar	VSI5
lascasen	lascar	VSI6
lascad	lascar	VMP
lascadme	lascar	VMSE
lascadle	lascar	VMSE
lascadnos	lascar	VMPE
lascaos	lascar	VMPE
lascadles	lascar	VMPE
lascadlo	lascar	VMMSE
lascadla	lascar	VMFSE
lascadlos	lascar	VMMPE
lascadlas	lascar	VMFPE
lascádmelo	lascar	VMMSE
lascádselo	lascar	VMMSE
lascádnoslo	lascar	VMMSE
lascáoslo	lascar	VMMSE
lascádmelos	lascar	VMMPE
lascádselos	lascar	VMMPE
lascádnoslos	lascar	VMMPE
lascáoslos	lascar	VMMPE
lascádmela	lascar	VMFSE
lascádsela	lascar	VMFSE
lascádnosla	lascar	VMFSE
lascáosla	lascar	VMFSE
lascádmelas	lascar	VMFPE
lascádselas	lascar	VMFPE
lascádnoslas	lascar	VMFPE
lascáoslas	lascar	VMFPE
lascado	lascar	VPM
lascados	lascar	VPMP
lascada	lascar	VPF
lascadas	lascar	VPFP
lascando	lascar	VG
lascándome	lascar	VGSE
lascándote	lascar	VGSE
lascándole	lascar	VGSE
lascándonos	lascar	VGPE
lascándoos	lascar	VGPE
lascándolo	lascar	VGMSE
lascándola	lascar	VGFSE
lascándolos	lascar	VGMPE
lascándolas	lascar	VGFPE
lascándomelo	lascar	VGMSE
lascándotelo	lascar	VGMSE
lascándoselo	lascar	VGMSE
lascándonoslo	lascar	VGMSE
lascándooslo	lascar	VGMSE
lascándomelos	lascar	VGMPE
lascándotelos	lascar	VGMPE
lascándoselos	lascar	VGMPE
lascándonoslos	lascar	VGMPE
lascándooslos	lascar	VGMPE
lascándomela	lascar	VGFSE
lascándotela	lascar	VGFSE
lascándosela	lascar	VGFSE
lascándonosla	lascar	VGFSE
lascándoosla	lascar	VGFSE
lascándomelas	lascar	VGFPE
lascándotelas	lascar	VGFPE
lascándoselas	lascar	VGFPE
lascándonoslas	lascar	VGFPE
lascándooslas	lascar	VGFPE
lastar	lastar	O
lasto	lastar	VIP1
lastas	lastar	VIP2
lasta	lastar	VIP3
lastamos	lastar	VIP4
lastáis	lastar	VIP5
lastan	lastar	VIP6
lastaba	lastar	VII1
lastabas	lastar	VII2
lastábamos	lastar	VII4
lastabais	lastar	VII5
lastaban	lastar	VII6
lastaré	lastar	VIF1
lastarás	lastar	VIF2
lastará	lastar	VIF3
lastaremos	lastar	VIF4
lastaréis	lastar	VIF5
lastarán	lastar	VIF6
lastaría	lastar	VIC1
lastarías	lastar	VIC2
lastaría	lastar	VIC3
lastaríamos	lastar	VIC4
lastaríais	lastar	VIC5
lastarían	lastar	VIC6
lasté	lastar	VIX1
lastaste	lastar	VIX2
lastó	lastar	VIX3
lastasteis	lastar	VIX5
lastaron	lastar	VIX6
laste	lastar	VSP1
lastes	lastar	VSP2
lastemos	lastar	VSP4
lastéis	lastar	VSP5
lasten	lastar	VSP6
lastara	lastar	VSX1
lastaras	lastar	VSX2
lastáramos	lastar	VSX4
lastarais	lastar	VSX5
lastaran	lastar	VSX6
lastare	lastar	VSF1
lastares	lastar	VSF2
lastáremos	lastar	VSF4
lastareis	lastar	VSF5
lastaren	lastar	VSF6
lastase	lastar	VSI1
lastases	lastar	VSI2
lastásemos	lastar	VSI4
lastaseis	lastar	VSI5
lastasen	lastar	VSI6
lastad	lastar	VMP
lastadme	lastar	VMSE
lastadle	lastar	VMSE
lastadnos	lastar	VMPE
lastaos	lastar	VMPE
lastadles	lastar	VMPE
lastadlo	lastar	VMMSE
lastadla	lastar	VMFSE
lastadlos	lastar	VMMPE
lastadlas	lastar	VMFPE
lastádmelo	lastar	VMMSE
lastádselo	lastar	VMMSE
lastádnoslo	lastar	VMMSE
lastáoslo	lastar	VMMSE
lastádmelos	lastar	VMMPE
lastádselos	lastar	VMMPE
lastádnoslos	lastar	VMMPE
lastáoslos	lastar	VMMPE
lastádmela	lastar	VMFSE
lastádsela	lastar	VMFSE
lastádnosla	lastar	VMFSE
lastáosla	lastar	VMFSE
lastádmelas	lastar	VMFPE
lastádselas	lastar	VMFPE
lastádnoslas	lastar	VMFPE
lastáoslas	lastar	VMFPE
lastado	lastar	VPM
lastados	lastar	VPMP
lastada	lastar	VPF
lastadas	lastar	VPFP
lastando	lastar	VG
lastándome	lastar	VGSE
lastándote	lastar	VGSE
lastándole	lastar	VGSE
lastándonos	lastar	VGPE
lastándoos	lastar	VGPE
lastándolo	lastar	VGMSE
lastándola	lastar	VGFSE
lastándolos	lastar	VGMPE
lastándolas	lastar	VGFPE
lastándomelo	lastar	VGMSE
lastándotelo	lastar	VGMSE
lastándoselo	lastar	VGMSE
lastándonoslo	lastar	VGMSE
lastándooslo	lastar	VGMSE
lastándomelos	lastar	VGMPE
lastándotelos	lastar	VGMPE
lastándoselos	lastar	VGMPE
lastándonoslos	lastar	VGMPE
lastándooslos	lastar	VGMPE
lastándomela	lastar	VGFSE
lastándotela	lastar	VGFSE
lastándosela	lastar	VGFSE
lastándonosla	lastar	VGFSE
lastándoosla	lastar	VGFSE
lastándomelas	lastar	VGFPE
lastándotelas	lastar	VGFPE
lastándoselas	lastar	VGFPE
lastándonoslas	lastar	VGFPE
lastándooslas	lastar	VGFPE
lastimar	lastimar	O
lastimo	lastimar	VIP1
lastimas	lastimar	VIP2
lastima	lastimar	VIP3
lastimamos	lastimar	VIP4
lastimáis	lastimar	VIP5
lastiman	lastimar	VIP6
lastimaba	lastimar	VII1
lastimabas	lastimar	VII2
lastimábamos	lastimar	VII4
lastimabais	lastimar	VII5
lastimaban	lastimar	VII6
lastimaré	lastimar	VIF1
lastimarás	lastimar	VIF2
lastimará	lastimar	VIF3
lastimaremos	lastimar	VIF4
lastimaréis	lastimar	VIF5
lastimarán	lastimar	VIF6
lastimaría	lastimar	VIC1
lastimarías	lastimar	VIC2
lastimaría	lastimar	VIC3
lastimaríamos	lastimar	VIC4
lastimaríais	lastimar	VIC5
lastimarían	lastimar	VIC6
lastimé	lastimar	VIX1
lastimaste	lastimar	VIX2
lastimó	lastimar	VIX3
lastimasteis	lastimar	VIX5
lastimaron	lastimar	VIX6
lastime	lastimar	VSP1
lastimes	lastimar	VSP2
lastimemos	lastimar	VSP4
lastiméis	lastimar	VSP5
lastimen	lastimar	VSP6
lastimara	lastimar	VSX1
lastimaras	lastimar	VSX2
lastimáramos	lastimar	VSX4
lastimarais	lastimar	VSX5
lastimaran	lastimar	VSX6
lastimare	lastimar	VSF1
lastimares	lastimar	VSF2
lastimáremos	lastimar	VSF4
lastimareis	lastimar	VSF5
lastimaren	lastimar	VSF6
lastimase	lastimar	VSI1
lastimases	lastimar	VSI2
lastimásemos	lastimar	VSI4
lastimaseis	lastimar	VSI5
lastimasen	lastimar	VSI6
lastimad	lastimar	VMP
lastimadme	lastimar	VMSE
lastimadle	lastimar	VMSE
lastimadnos	lastimar	VMPE
lastimaos	lastimar	VMPE
lastimadles	lastimar	VMPE
lastimadlo	lastimar	VMMSE
lastimadla	lastimar	VMFSE
lastimadlos	lastimar	VMMPE
lastimadlas	lastimar	VMFPE
lastimádmelo	lastimar	VMMSE
lastimádselo	lastimar	VMMSE
lastimádnoslo	lastimar	VMMSE
lastimáoslo	lastimar	VMMSE
lastimádmelos	lastimar	VMMPE
lastimádselos	lastimar	VMMPE
lastimádnoslos	lastimar	VMMPE
lastimáoslos	lastimar	VMMPE
lastimádmela	lastimar	VMFSE
lastimádsela	lastimar	VMFSE
lastimádnosla	lastimar	VMFSE
lastimáosla	lastimar	VMFSE
lastimádmelas	lastimar	VMFPE
lastimádselas	lastimar	VMFPE
lastimádnoslas	lastimar	VMFPE
lastimáoslas	lastimar	VMFPE
lastimado	lastimar	VPM
lastimados	lastimar	VPMP
lastimada	lastimar	VPF
lastimadas	lastimar	VPFP
lastimando	lastimar	VG
lastimándome	lastimar	VGSE
lastimándote	lastimar	VGSE
lastimándole	lastimar	VGSE
lastimándonos	lastimar	VGPE
lastimándoos	lastimar	VGPE
lastimándolo	lastimar	VGMSE
lastimándola	lastimar	VGFSE
lastimándolos	lastimar	VGMPE
lastimándolas	lastimar	VGFPE
lastimándomelo	lastimar	VGMSE
lastimándotelo	lastimar	VGMSE
lastimándoselo	lastimar	VGMSE
lastimándonoslo	lastimar	VGMSE
lastimándooslo	lastimar	VGMSE
lastimándomelos	lastimar	VGMPE
lastimándotelos	lastimar	VGMPE
lastimándoselos	lastimar	VGMPE
lastimándonoslos	lastimar	VGMPE
lastimándooslos	lastimar	VGMPE
lastimándomela	lastimar	VGFSE
lastimándotela	lastimar	VGFSE
lastimándosela	lastimar	VGFSE
lastimándonosla	lastimar	VGFSE
lastimándoosla	lastimar	VGFSE
lastimándomelas	lastimar	VGFPE
lastimándotelas	lastimar	VGFPE
lastimándoselas	lastimar	VGFPE
lastimándonoslas	lastimar	VGFPE
lastimándooslas	lastimar	VGFPE
lastrar	lastrar	O
lastro	lastrar	VIP1
lastras	lastrar	VIP2
lastra	lastrar	VIP3
lastramos	lastrar	VIP4
lastráis	lastrar	VIP5
lastran	lastrar	VIP6
lastraba	lastrar	VII1
lastrabas	lastrar	VII2
lastrábamos	lastrar	VII4
lastrabais	lastrar	VII5
lastraban	lastrar	VII6
lastraré	lastrar	VIF1
lastrarás	lastrar	VIF2
lastrará	lastrar	VIF3
lastraremos	lastrar	VIF4
lastraréis	lastrar	VIF5
lastrarán	lastrar	VIF6
lastraría	lastrar	VIC1
lastrarías	lastrar	VIC2
lastraría	lastrar	VIC3
lastraríamos	lastrar	VIC4
lastraríais	lastrar	VIC5
lastrarían	lastrar	VIC6
lastré	lastrar	VIX1
lastraste	lastrar	VIX2
lastró	lastrar	VIX3
lastrasteis	lastrar	VIX5
lastraron	lastrar	VIX6
lastre	lastrar	VSP1
lastres	lastrar	VSP2
lastremos	lastrar	VSP4
lastréis	lastrar	VSP5
lastren	lastrar	VSP6
lastrara	lastrar	VSX1
lastraras	lastrar	VSX2
lastráramos	lastrar	VSX4
lastrarais	lastrar	VSX5
lastraran	lastrar	VSX6
lastrare	lastrar	VSF1
lastrares	lastrar	VSF2
lastráremos	lastrar	VSF4
lastrareis	lastrar	VSF5
lastraren	lastrar	VSF6
lastrase	lastrar	VSI1
lastrases	lastrar	VSI2
lastrásemos	lastrar	VSI4
lastraseis	lastrar	VSI5
lastrasen	lastrar	VSI6
lastrad	lastrar	VMP
lastradme	lastrar	VMSE
lastradle	lastrar	VMSE
lastradnos	lastrar	VMPE
lastraos	lastrar	VMPE
lastradles	lastrar	VMPE
lastradlo	lastrar	VMMSE
lastradla	lastrar	VMFSE
lastradlos	lastrar	VMMPE
lastradlas	lastrar	VMFPE
lastrádmelo	lastrar	VMMSE
lastrádselo	lastrar	VMMSE
lastrádnoslo	lastrar	VMMSE
lastráoslo	lastrar	VMMSE
lastrádmelos	lastrar	VMMPE
lastrádselos	lastrar	VMMPE
lastrádnoslos	lastrar	VMMPE
lastráoslos	lastrar	VMMPE
lastrádmela	lastrar	VMFSE
lastrádsela	lastrar	VMFSE
lastrádnosla	lastrar	VMFSE
lastráosla	lastrar	VMFSE
lastrádmelas	lastrar	VMFPE
lastrádselas	lastrar	VMFPE
lastrádnoslas	lastrar	VMFPE
lastráoslas	lastrar	VMFPE
lastrado	lastrar	VPM
lastrados	lastrar	VPMP
lastrada	lastrar	VPF
lastradas	lastrar	VPFP
lastrando	lastrar	VG
lastrándome	lastrar	VGSE
lastrándote	lastrar	VGSE
lastrándole	lastrar	VGSE
lastrándonos	lastrar	VGPE
lastrándoos	lastrar	VGPE
lastrándolo	lastrar	VGMSE
lastrándola	lastrar	VGFSE
lastrándolos	lastrar	VGMPE
lastrándolas	lastrar	VGFPE
lastrándomelo	lastrar	VGMSE
lastrándotelo	lastrar	VGMSE
lastrándoselo	lastrar	VGMSE
lastrándonoslo	lastrar	VGMSE
lastrándooslo	lastrar	VGMSE
lastrándomelos	lastrar	VGMPE
lastrándotelos	lastrar	VGMPE
lastrándoselos	lastrar	VGMPE
lastrándonoslos	lastrar	VGMPE
lastrándooslos	lastrar	VGMPE
lastrándomela	lastrar	VGFSE
lastrándotela	lastrar	VGFSE
lastrándosela	lastrar	VGFSE
lastrándonosla	lastrar	VGFSE
lastrándoosla	lastrar	VGFSE
lastrándomelas	lastrar	VGFPE
lastrándotelas	lastrar	VGFPE
lastrándoselas	lastrar	VGFPE
lastrándonoslas	lastrar	VGFPE
lastrándooslas	lastrar	VGFPE
lastrear	lastrear	O
lastreo	lastrear	VIP1
lastreas	lastrear	VIP2
lastrea	lastrear	VIP3
lastreamos	lastrear	VIP4
lastreáis	lastrear	VIP5
lastrean	lastrear	VIP6
lastreaba	lastrear	VII1
lastreabas	lastrear	VII2
lastreábamos	lastrear	VII4
lastreabais	lastrear	VII5
lastreaban	lastrear	VII6
lastrearé	lastrear	VIF1
lastrearás	lastrear	VIF2
lastreará	lastrear	VIF3
lastrearemos	lastrear	VIF4
lastrearéis	lastrear	VIF5
lastrearán	lastrear	VIF6
lastrearía	lastrear	VIC1
lastrearías	lastrear	VIC2
lastrearía	lastrear	VIC3
lastrearíamos	lastrear	VIC4
lastrearíais	lastrear	VIC5
lastrearían	lastrear	VIC6
lastreé	lastrear	VIX1
lastreaste	lastrear	VIX2
lastreó	lastrear	VIX3
lastreasteis	lastrear	VIX5
lastrearon	lastrear	VIX6
lastree	lastrear	VSP1
lastrees	lastrear	VSP2
lastreemos	lastrear	VSP4
lastreéis	lastrear	VSP5
lastreen	lastrear	VSP6
lastreara	lastrear	VSX1
lastrearas	lastrear	VSX2
lastreáramos	lastrear	VSX4
lastrearais	lastrear	VSX5
lastrearan	lastrear	VSX6
lastreare	lastrear	VSF1
lastreares	lastrear	VSF2
lastreáremos	lastrear	VSF4
lastreareis	lastrear	VSF5
lastrearen	lastrear	VSF6
lastrease	lastrear	VSI1
lastreases	lastrear	VSI2
lastreásemos	lastrear	VSI4
lastreaseis	lastrear	VSI5
lastreasen	lastrear	VSI6
lastread	lastrear	VMP
lastreadme	lastrear	VMSE
lastreadle	lastrear	VMSE
lastreadnos	lastrear	VMPE
lastreaos	lastrear	VMPE
lastreadles	lastrear	VMPE
lastreadlo	lastrear	VMMSE
lastreadla	lastrear	VMFSE
lastreadlos	lastrear	VMMPE
lastreadlas	lastrear	VMFPE
lastreádmelo	lastrear	VMMSE
lastreádselo	lastrear	VMMSE
lastreádnoslo	lastrear	VMMSE
lastreáoslo	lastrear	VMMSE
lastreádmelos	lastrear	VMMPE
lastreádselos	lastrear	VMMPE
lastreádnoslos	lastrear	VMMPE
lastreáoslos	lastrear	VMMPE
lastreádmela	lastrear	VMFSE
lastreádsela	lastrear	VMFSE
lastreádnosla	lastrear	VMFSE
lastreáosla	lastrear	VMFSE
lastreádmelas	lastrear	VMFPE
lastreádselas	lastrear	VMFPE
lastreádnoslas	lastrear	VMFPE
lastreáoslas	lastrear	VMFPE
lastreado	lastrear	VPM
lastreados	lastrear	VPMP
lastreada	lastrear	VPF
lastreadas	lastrear	VPFP
lastreando	lastrear	VG
lastreándome	lastrear	VGSE
lastreándote	lastrear	VGSE
lastreándole	lastrear	VGSE
lastreándonos	lastrear	VGPE
lastreándoos	lastrear	VGPE
lastreándolo	lastrear	VGMSE
lastreándola	lastrear	VGFSE
lastreándolos	lastrear	VGMPE
lastreándolas	lastrear	VGFPE
lastreándomelo	lastrear	VGMSE
lastreándotelo	lastrear	VGMSE
lastreándoselo	lastrear	VGMSE
lastreándonoslo	lastrear	VGMSE
lastreándooslo	lastrear	VGMSE
lastreándomelos	lastrear	VGMPE
lastreándotelos	lastrear	VGMPE
lastreándoselos	lastrear	VGMPE
lastreándonoslos	lastrear	VGMPE
lastreándooslos	lastrear	VGMPE
lastreándomela	lastrear	VGFSE
lastreándotela	lastrear	VGFSE
lastreándosela	lastrear	VGFSE
lastreándonosla	lastrear	VGFSE
lastreándoosla	lastrear	VGFSE
lastreándomelas	lastrear	VGFPE
lastreándotelas	lastrear	VGFPE
lastreándoselas	lastrear	VGFPE
lastreándonoslas	lastrear	VGFPE
lastreándooslas	lastrear	VGFPE
