maja	maja	O
majas	maja	P
majada	majada	O
majadas	majada	P
majadal	majadal	O
majadales	majadal	P
majaderico	majaderico	O
majadericos	majaderico	P
majaderillo	majaderillo	O
majaderillos	majaderillo	P
majaderito	majaderito	O
majaderitos	majaderito	P
majadero	majadero	O
majaderas	majadero	FP
majadera	majadero	F
majaderos	majadero	P
majadería	majadería	O
majaderías	majadería	P
majado	majado	O
majados	majado	P
majador	majador	O
majadoras	majador	FP
majadora	majador	F
majadores	majador	P
majadura	majadura	O
majaduras	majadura	P
majagranzas	majagranzas	O
majagua	majagua	O
majaguas	majagua	P
majagual	majagual	O
majaguales	majagual	P
majagüero	majagüero	O
majagüeros	majagüero	P
majal	majal	O
majales	majal	P
majamama	majamama	O
majamamas	majamama	P
majamiento	majamiento	O
majamientos	majamiento	P
majano	majano	O
majanos	majano	P
majara	majara	O
majaras	majara	P
majareta	majareta	O
majaretas	majareta	P
majarete	majarete	O
majaretes	majarete	P
maje	maje	O
majes	maje	P
majencia	majencia	O
majencias	majencia	P
majería	majería	O
majerías	majería	P
majestad	majestad	O
majestades	majestad	P
majestoso	majestoso	O
majestosas	majestoso	FP
majestosa	majestoso	F
majestosos	majestoso	P
majestuosamente	majestuosamente	O
majestuosidad	majestuosidad	O
majestuosidades	majestuosidad	P
majestuoso	majestuoso	O
majestuosas	majestuoso	FP
majestuosa	majestuoso	F
majestuosos	majestuoso	P
majeza	majeza	O
majezas	majeza	P
majo	majo	O
majas	majo	FP
maja	majo	F
majos	majo	P
majoleta	majoleta	O
majoletas	majoleta	P
majoleto	majoleto	O
majoletos	majoleto	P
majorana	majorana	O
majoranas	majorana	P
majorca	majorca	O
majorcas	majorca	P
majorero	majorero	O
majoreras	majorero	FP
majorera	majorero	F
majoreros	majorero	P
majorette	majorette	O
majorettes	majorette	P
majuela	majuela	O
majuelas	majuela	P
majuelo	majuelo	O
majuelos	majuelo	P
majzén	majzén	O
majzenes	majzén	P
majá	majá	O
majás	majá	P
majadear	majadear	O
majadeo	majadear	VIP1
majadeas	majadear	VIP2
majadea	majadear	VIP3
majadeamos	majadear	VIP4
majadeáis	majadear	VIP5
majadean	majadear	VIP6
majadeaba	majadear	VII1
majadeabas	majadear	VII2
majadeábamos	majadear	VII4
majadeabais	majadear	VII5
majadeaban	majadear	VII6
majadearé	majadear	VIF1
majadearás	majadear	VIF2
majadeará	majadear	VIF3
majadearemos	majadear	VIF4
majadearéis	majadear	VIF5
majadearán	majadear	VIF6
majadearía	majadear	VIC1
majadearías	majadear	VIC2
majadearía	majadear	VIC3
majadearíamos	majadear	VIC4
majadearíais	majadear	VIC5
majadearían	majadear	VIC6
majadeé	majadear	VIX1
majadeaste	majadear	VIX2
majadeó	majadear	VIX3
majadeasteis	majadear	VIX5
majadearon	majadear	VIX6
majadee	majadear	VSP1
majadees	majadear	VSP2
majadeemos	majadear	VSP4
majadeéis	majadear	VSP5
majadeen	majadear	VSP6
majadeara	majadear	VSX1
majadearas	majadear	VSX2
majadeáramos	majadear	VSX4
majadearais	majadear	VSX5
majadearan	majadear	VSX6
majadeare	majadear	VSF1
majadeares	majadear	VSF2
majadeáremos	majadear	VSF4
majadeareis	majadear	VSF5
majadearen	majadear	VSF6
majadease	majadear	VSI1
majadeases	majadear	VSI2
majadeásemos	majadear	VSI4
majadeaseis	majadear	VSI5
majadeasen	majadear	VSI6
majadead	majadear	VMP
majadeadme	majadear	VMSE
majadeadle	majadear	VMSE
majadeadnos	majadear	VMPE
majadeaos	majadear	VMPE
majadeadles	majadear	VMPE
majadeado	majadear	VPM
majadeados	majadear	VPMP
majadeada	majadear	VPF
majadeadas	majadear	VPFP
majadeando	majadear	VG
majadeándome	majadear	VGSE
majadeándote	majadear	VGSE
majadeándole	majadear	VGSE
majadeándonos	majadear	VGPE
majadeándoos	majadear	VGPE
majaderear	majaderear	O
majadereo	majaderear	VIP1
majadereas	majaderear	VIP2
majaderea	majaderear	VIP3
majadereamos	majaderear	VIP4
majadereáis	majaderear	VIP5
majaderean	majaderear	VIP6
majadereaba	majaderear	VII1
majadereabas	majaderear	VII2
majadereábamos	majaderear	VII4
majadereabais	majaderear	VII5
majadereaban	majaderear	VII6
majaderearé	majaderear	VIF1
majaderearás	majaderear	VIF2
majadereará	majaderear	VIF3
majaderearemos	majaderear	VIF4
majaderearéis	majaderear	VIF5
majaderearán	majaderear	VIF6
majaderearía	majaderear	VIC1
majaderearías	majaderear	VIC2
majaderearía	majaderear	VIC3
majaderearíamos	majaderear	VIC4
majaderearíais	majaderear	VIC5
majaderearían	majaderear	VIC6
majadereé	majaderear	VIX1
majadereaste	majaderear	VIX2
majadereó	majaderear	VIX3
majadereasteis	majaderear	VIX5
majaderearon	majaderear	VIX6
majaderee	majaderear	VSP1
majaderees	majaderear	VSP2
majadereemos	majaderear	VSP4
majadereéis	majaderear	VSP5
majadereen	majaderear	VSP6
majadereara	majaderear	VSX1
majaderearas	majaderear	VSX2
majadereáramos	majaderear	VSX4
majaderearais	majaderear	VSX5
majaderearan	majaderear	VSX6
majadereare	majaderear	VSF1
majadereares	majaderear	VSF2
majadereáremos	majaderear	VSF4
majadereareis	majaderear	VSF5
majaderearen	majaderear	VSF6
majaderease	majaderear	VSI1
majadereases	majaderear	VSI2
majadereásemos	majaderear	VSI4
majadereaseis	majaderear	VSI5
majadereasen	majaderear	VSI6
majaderead	majaderear	VMP
majadereadme	majaderear	VMSE
majadereadle	majaderear	VMSE
majadereadnos	majaderear	VMPE
majadereaos	majaderear	VMPE
majadereadles	majaderear	VMPE
majadereadlo	majaderear	VMMSE
majadereadla	majaderear	VMFSE
majadereadlos	majaderear	VMMPE
majadereadlas	majaderear	VMFPE
majadereádmelo	majaderear	VMMSE
majadereádselo	majaderear	VMMSE
majadereádnoslo	majaderear	VMMSE
majadereáoslo	majaderear	VMMSE
majadereádmelos	majaderear	VMMPE
majadereádselos	majaderear	VMMPE
majadereádnoslos	majaderear	VMMPE
majadereáoslos	majaderear	VMMPE
majadereádmela	majaderear	VMFSE
majadereádsela	majaderear	VMFSE
majadereádnosla	majaderear	VMFSE
majadereáosla	majaderear	VMFSE
majadereádmelas	majaderear	VMFPE
majadereádselas	majaderear	VMFPE
majadereádnoslas	majaderear	VMFPE
majadereáoslas	majaderear	VMFPE
majadereado	majaderear	VPM
majadereados	majaderear	VPMP
majadereada	majaderear	VPF
majadereadas	majaderear	VPFP
majadereando	majaderear	VG
majadereándome	majaderear	VGSE
majadereándote	majaderear	VGSE
majadereándole	majaderear	VGSE
majadereándonos	majaderear	VGPE
majadereándoos	majaderear	VGPE
majadereándolo	majaderear	VGMSE
majadereándola	majaderear	VGFSE
majadereándolos	majaderear	VGMPE
majadereándolas	majaderear	VGFPE
majadereándomelo	majaderear	VGMSE
majadereándotelo	majaderear	VGMSE
majadereándoselo	majaderear	VGMSE
majadereándonoslo	majaderear	VGMSE
majadereándooslo	majaderear	VGMSE
majadereándomelos	majaderear	VGMPE
majadereándotelos	majaderear	VGMPE
majadereándoselos	majaderear	VGMPE
majadereándonoslos	majaderear	VGMPE
majadereándooslos	majaderear	VGMPE
majadereándomela	majaderear	VGFSE
majadereándotela	majaderear	VGFSE
majadereándosela	majaderear	VGFSE
majadereándonosla	majaderear	VGFSE
majadereándoosla	majaderear	VGFSE
majadereándomelas	majaderear	VGFPE
majadereándotelas	majaderear	VGFPE
majadereándoselas	majaderear	VGFPE
majadereándonoslas	majaderear	VGFPE
majadereándooslas	majaderear	VGFPE
majar	majar	O
majo	majar	VIP1
majas	majar	VIP2
maja	majar	VIP3
majamos	majar	VIP4
majáis	majar	VIP5
majan	majar	VIP6
majaba	majar	VII1
majabas	majar	VII2
majábamos	majar	VII4
majabais	majar	VII5
majaban	majar	VII6
majaré	majar	VIF1
majarás	majar	VIF2
majará	majar	VIF3
majaremos	majar	VIF4
majaréis	majar	VIF5
majarán	majar	VIF6
majaría	majar	VIC1
majarías	majar	VIC2
majaría	majar	VIC3
majaríamos	majar	VIC4
majaríais	majar	VIC5
majarían	majar	VIC6
majé	majar	VIX1
majaste	majar	VIX2
majó	majar	VIX3
majasteis	majar	VIX5
majaron	majar	VIX6
maje	majar	VSP1
majes	majar	VSP2
majemos	majar	VSP4
majéis	majar	VSP5
majen	majar	VSP6
majara	majar	VSX1
majaras	majar	VSX2
majáramos	majar	VSX4
majarais	majar	VSX5
majaran	majar	VSX6
majare	majar	VSF1
majares	majar	VSF2
majáremos	majar	VSF4
majareis	majar	VSF5
majaren	majar	VSF6
majase	majar	VSI1
majases	majar	VSI2
majásemos	majar	VSI4
majaseis	majar	VSI5
majasen	majar	VSI6
majad	majar	VMP
majadme	majar	VMSE
majadle	majar	VMSE
majadnos	majar	VMPE
majaos	majar	VMPE
majadles	majar	VMPE
majadlo	majar	VMMSE
majadla	majar	VMFSE
majadlos	majar	VMMPE
majadlas	majar	VMFPE
majádmelo	majar	VMMSE
majádselo	majar	VMMSE
majádnoslo	majar	VMMSE
majáoslo	majar	VMMSE
majádmelos	majar	VMMPE
majádselos	majar	VMMPE
majádnoslos	majar	VMMPE
majáoslos	majar	VMMPE
majádmela	majar	VMFSE
majádsela	majar	VMFSE
majádnosla	majar	VMFSE
majáosla	majar	VMFSE
majádmelas	majar	VMFPE
majádselas	majar	VMFPE
majádnoslas	majar	VMFPE
majáoslas	majar	VMFPE
majado	majar	VPM
majados	majar	VPMP
majada	majar	VPF
majadas	majar	VPFP
majando	majar	VG
majándome	majar	VGSE
majándote	majar	VGSE
majándole	majar	VGSE
majándonos	majar	VGPE
majándoos	majar	VGPE
majándolo	majar	VGMSE
majándola	majar	VGFSE
majándolos	majar	VGMPE
majándolas	majar	VGFPE
majándomelo	majar	VGMSE
majándotelo	majar	VGMSE
majándoselo	majar	VGMSE
majándonoslo	majar	VGMSE
majándooslo	majar	VGMSE
majándomelos	majar	VGMPE
majándotelos	majar	VGMPE
majándoselos	majar	VGMPE
majándonoslos	majar	VGMPE
majándooslos	majar	VGMPE
majándomela	majar	VGFSE
majándotela	majar	VGFSE
majándosela	majar	VGFSE
majándonosla	majar	VGFSE
majándoosla	majar	VGFSE
majándomelas	majar	VGFPE
majándotelas	majar	VGFPE
majándoselas	majar	VGFPE
majándonoslas	majar	VGFPE
majándooslas	majar	VGFPE
majasear	majasear	O
majaseo	majasear	VIP1
majaseas	majasear	VIP2
majasea	majasear	VIP3
majaseamos	majasear	VIP4
majaseáis	majasear	VIP5
majasean	majasear	VIP6
majaseaba	majasear	VII1
majaseabas	majasear	VII2
majaseábamos	majasear	VII4
majaseabais	majasear	VII5
majaseaban	majasear	VII6
majasearé	majasear	VIF1
majasearás	majasear	VIF2
majaseará	majasear	VIF3
majasearemos	majasear	VIF4
majasearéis	majasear	VIF5
majasearán	majasear	VIF6
majasearía	majasear	VIC1
majasearías	majasear	VIC2
majasearía	majasear	VIC3
majasearíamos	majasear	VIC4
majasearíais	majasear	VIC5
majasearían	majasear	VIC6
majaseé	majasear	VIX1
majaseaste	majasear	VIX2
majaseó	majasear	VIX3
majaseasteis	majasear	VIX5
majasearon	majasear	VIX6
majasee	majasear	VSP1
majasees	majasear	VSP2
majaseemos	majasear	VSP4
majaseéis	majasear	VSP5
majaseen	majasear	VSP6
majaseara	majasear	VSX1
majasearas	majasear	VSX2
majaseáramos	majasear	VSX4
majasearais	majasear	VSX5
majasearan	majasear	VSX6
majaseare	majasear	VSF1
majaseares	majasear	VSF2
majaseáremos	majasear	VSF4
majaseareis	majasear	VSF5
majasearen	majasear	VSF6
majasease	majasear	VSI1
majaseases	majasear	VSI2
majaseásemos	majasear	VSI4
majaseaseis	majasear	VSI5
majaseasen	majasear	VSI6
majasead	majasear	VMP
majaseadme	majasear	VMSE
majaseadle	majasear	VMSE
majaseadnos	majasear	VMPE
majaseaos	majasear	VMPE
majaseadles	majasear	VMPE
majaseado	majasear	VPM
majaseados	majasear	VPMP
majaseada	majasear	VPF
majaseadas	majasear	VPFP
majaseando	majasear	VG
majaseándome	majasear	VGSE
majaseándote	majasear	VGSE
majaseándole	majasear	VGSE
majaseándonos	majasear	VGPE
majaseándoos	majasear	VGPE
majear	majear	O
majeo	majear	VIP1
majeas	majear	VIP2
majea	majear	VIP3
majeamos	majear	VIP4
majeáis	majear	VIP5
majean	majear	VIP6
majeaba	majear	VII1
majeabas	majear	VII2
majeábamos	majear	VII4
majeabais	majear	VII5
majeaban	majear	VII6
majearé	majear	VIF1
majearás	majear	VIF2
majeará	majear	VIF3
majearemos	majear	VIF4
majearéis	majear	VIF5
majearán	majear	VIF6
majearía	majear	VIC1
majearías	majear	VIC2
majearía	majear	VIC3
majearíamos	majear	VIC4
majearíais	majear	VIC5
majearían	majear	VIC6
majeé	majear	VIX1
majeaste	majear	VIX2
majeó	majear	VIX3
majeasteis	majear	VIX5
majearon	majear	VIX6
majee	majear	VSP1
majees	majear	VSP2
majeemos	majear	VSP4
majeéis	majear	VSP5
majeen	majear	VSP6
majeara	majear	VSX1
majearas	majear	VSX2
majeáramos	majear	VSX4
majearais	majear	VSX5
majearan	majear	VSX6
majeare	majear	VSF1
majeares	majear	VSF2
majeáremos	majear	VSF4
majeareis	majear	VSF5
majearen	majear	VSF6
majease	majear	VSI1
majeases	majear	VSI2
majeásemos	majear	VSI4
majeaseis	majear	VSI5
majeasen	majear	VSI6
majead	majear	VMP
majeadme	majear	VMSE
majeadle	majear	VMSE
majeadnos	majear	VMPE
majeaos	majear	VMPE
majeadles	majear	VMPE
majeadlo	majear	VMMSE
majeadla	majear	VMFSE
majeadlos	majear	VMMPE
majeadlas	majear	VMFPE
majeádmelo	majear	VMMSE
majeádselo	majear	VMMSE
majeádnoslo	majear	VMMSE
majeáoslo	majear	VMMSE
majeádmelos	majear	VMMPE
majeádselos	majear	VMMPE
majeádnoslos	majear	VMMPE
majeáoslos	majear	VMMPE
majeádmela	majear	VMFSE
majeádsela	majear	VMFSE
majeádnosla	majear	VMFSE
majeáosla	majear	VMFSE
majeádmelas	majear	VMFPE
majeádselas	majear	VMFPE
majeádnoslas	majear	VMFPE
majeáoslas	majear	VMFPE
majeado	majear	VPM
majeados	majear	VPMP
majeada	majear	VPF
majeadas	majear	VPFP
majeando	majear	VG
majeándome	majear	VGSE
majeándote	majear	VGSE
majeándole	majear	VGSE
majeándonos	majear	VGPE
majeándoos	majear	VGPE
majeándolo	majear	VGMSE
majeándola	majear	VGFSE
majeándolos	majear	VGMPE
majeándolas	majear	VGFPE
majeándomelo	majear	VGMSE
majeándotelo	majear	VGMSE
majeándoselo	majear	VGMSE
majeándonoslo	majear	VGMSE
majeándooslo	majear	VGMSE
majeándomelos	majear	VGMPE
majeándotelos	majear	VGMPE
majeándoselos	majear	VGMPE
majeándonoslos	majear	VGMPE
majeándooslos	majear	VGMPE
majeándomela	majear	VGFSE
majeándotela	majear	VGFSE
majeándosela	majear	VGFSE
majeándonosla	majear	VGFSE
majeándoosla	majear	VGFSE
majeándomelas	majear	VGFPE
majeándotelas	majear	VGFPE
majeándoselas	majear	VGFPE
majeándonoslas	majear	VGFPE
majeándooslas	majear	VGFPE
majolar	majolar	O
majolo	majolar	VIP1
majolas	majolar	VIP2
majola	majolar	VIP3
majolamos	majolar	VIP4
majoláis	majolar	VIP5
majolan	majolar	VIP6
majolaba	majolar	VII1
majolabas	majolar	VII2
majolábamos	majolar	VII4
majolabais	majolar	VII5
majolaban	majolar	VII6
majolaré	majolar	VIF1
majolarás	majolar	VIF2
majolará	majolar	VIF3
majolaremos	majolar	VIF4
majolaréis	majolar	VIF5
majolarán	majolar	VIF6
majolaría	majolar	VIC1
majolarías	majolar	VIC2
majolaría	majolar	VIC3
majolaríamos	majolar	VIC4
majolaríais	majolar	VIC5
majolarían	majolar	VIC6
majolé	majolar	VIX1
majolaste	majolar	VIX2
majoló	majolar	VIX3
majolasteis	majolar	VIX5
majolaron	majolar	VIX6
majole	majolar	VSP1
majoles	majolar	VSP2
majolemos	majolar	VSP4
majoléis	majolar	VSP5
majolen	majolar	VSP6
majolara	majolar	VSX1
majolaras	majolar	VSX2
majoláramos	majolar	VSX4
majolarais	majolar	VSX5
majolaran	majolar	VSX6
majolare	majolar	VSF1
majolares	majolar	VSF2
majoláremos	majolar	VSF4
majolareis	majolar	VSF5
majolaren	majolar	VSF6
majolase	majolar	VSI1
majolases	majolar	VSI2
majolásemos	majolar	VSI4
majolaseis	majolar	VSI5
majolasen	majolar	VSI6
majolad	majolar	VMP
majoladme	majolar	VMSE
majoladle	majolar	VMSE
majoladnos	majolar	VMPE
majolaos	majolar	VMPE
majoladles	majolar	VMPE
majoladlo	majolar	VMMSE
majoladla	majolar	VMFSE
majoladlos	majolar	VMMPE
majoladlas	majolar	VMFPE
majoládmelo	majolar	VMMSE
majoládselo	majolar	VMMSE
majoládnoslo	majolar	VMMSE
majoláoslo	majolar	VMMSE
majoládmelos	majolar	VMMPE
majoládselos	majolar	VMMPE
majoládnoslos	majolar	VMMPE
majoláoslos	majolar	VMMPE
majoládmela	majolar	VMFSE
majoládsela	majolar	VMFSE
majoládnosla	majolar	VMFSE
majoláosla	majolar	VMFSE
majoládmelas	majolar	VMFPE
majoládselas	majolar	VMFPE
majoládnoslas	majolar	VMFPE
majoláoslas	majolar	VMFPE
majolado	majolar	VPM
majolados	majolar	VPMP
majolada	majolar	VPF
majoladas	majolar	VPFP
majolando	majolar	VG
majolándome	majolar	VGSE
majolándote	majolar	VGSE
majolándole	majolar	VGSE
majolándonos	majolar	VGPE
majolándoos	majolar	VGPE
majolándolo	majolar	VGMSE
majolándola	majolar	VGFSE
majolándolos	majolar	VGMPE
majolándolas	majolar	VGFPE
majolándomelo	majolar	VGMSE
majolándotelo	majolar	VGMSE
majolándoselo	majolar	VGMSE
majolándonoslo	majolar	VGMSE
majolándooslo	majolar	VGMSE
majolándomelos	majolar	VGMPE
majolándotelos	majolar	VGMPE
majolándoselos	majolar	VGMPE
majolándonoslos	majolar	VGMPE
majolándooslos	majolar	VGMPE
majolándomela	majolar	VGFSE
majolándotela	majolar	VGFSE
majolándosela	majolar	VGFSE
majolándonosla	majolar	VGFSE
majolándoosla	majolar	VGFSE
majolándomelas	majolar	VGFPE
majolándotelas	majolar	VGFPE
majolándoselas	majolar	VGFPE
majolándonoslas	majolar	VGFPE
majolándooslas	majolar	VGFPE
majolares	majolar	P
