mina	mina	O
minas	mina	P
minada	minada	O
minadas	minada	P
minado	minado	O
minados	minado	P
minador	minador	O
minadoras	minador	FP
minadora	minador	F
minadores	minador	P
minal	minal	O
minales	minal	P
minarete	minarete	O
minaretes	minarete	P
minaz	minaz	O
minaces	minaz	P
minción	minción	O
minciones	minción	P
mindango	mindango	O
mindangas	mindango	FP
mindanga	mindango	F
mindangos	mindango	P
mindoniense	mindoniense	O
mindonienses	mindoniense	P
minera	minera	O
mineras	minera	P
mineraje	mineraje	O
minerajes	mineraje	P
mineral	mineral	O
minerales	mineral	P
mineralización	mineralización	O
mineralizaciones	mineralización	P
mineralogista	mineralogista	O
mineralogistas	mineralogista	P
mineralogía	mineralogía	O
mineralogías	mineralogía	P
mineralógico	mineralógico	O
mineralógicas	mineralógico	FP
mineralógica	mineralógico	F
mineralógicos	mineralógico	P
minerista	minerista	O
mineristas	minerista	P
minero	minero	O
mineras	minero	FP
minera	minero	F
mineros	minero	P
mineromedicinal	mineromedicinal	O
mineromedicinales	mineromedicinal	P
minerva	minerva	O
minervas	minerva	P
minervista	minervista	O
minervistas	minervista	P
minería	minería	O
minerías	minería	P
minga	minga	O
mingas	minga	P
mingaco	mingaco	O
mingacos	mingaco	P
mingitorio	mingitorio	O
mingitorias	mingitorio	FP
mingitoria	mingitorio	F
mingitorios	mingitorio	P
mingo	mingo	O
mingos	mingo	P
miniatura	miniatura	O
miniaturas	miniatura	P
miniaturista	miniaturista	O
miniaturistas	miniaturista	P
miniaturización	miniaturización	O
miniaturizaciones	miniaturización	P
minibar	minibar	O
minibares	minibar	P
minifalda	minifalda	O
minifaldas	minifalda	P
minifaldero	minifaldero	O
minifalderas	minifaldero	FP
minifaldera	minifaldero	F
minifalderos	minifaldero	P
minifundio	minifundio	O
minifundios	minifundio	P
minifundismo	minifundismo	O
minifundismos	minifundismo	P
minifundista	minifundista	O
minifundistas	minifundista	P
minigolf	minigolf	O
minigolfes	minigolf	P
minimalismo	minimalismo	O
minimalismos	minimalismo	P
minimalista	minimalista	O
minimalistas	minimalista	P
minimista	minimista	O
minimistas	minimista	P
minimización	minimización	O
minimizaciones	minimización	P
minimizador	minimizador	O
minimizadoras	minimizador	FP
minimizadora	minimizador	F
minimizadores	minimizador	P
minina	minina	O
mininas	minina	P
minino	minino	O
mininos	minino	P
minio	minio	O
minios	minio	P
ministerial	ministerial	O
ministeriales	ministerial	P
ministerialismo	ministerialismo	O
ministerialismos	ministerialismo	P
ministerialmente	ministerialmente	O
ministerio	ministerio	O
ministerios	ministerio	P
ministrable	ministrable	O
ministrables	ministrable	P
ministración	ministración	O
ministraciones	ministración	P
ministrador	ministrador	O
ministradoras	ministrador	FP
ministradora	ministrador	F
ministradores	ministrador	P
ministrante	ministrante	O
ministrantes	ministrante	P
ministril	ministril	O
ministriles	ministril	P
ministro	ministro	O
ministras	ministro	FP
ministra	ministro	F
ministros	ministro	P
mino	mino	O
minos	mino	P
minoico	minoico	O
minoicas	minoico	FP
minoica	minoico	F
minoicos	minoico	P
minoración	minoración	O
minoraciones	minoración	P
minorativo	minorativo	O
minorativas	minorativo	FP
minorativa	minorativo	F
minorativos	minorativo	P
minoridad	minoridad	O
minoridades	minoridad	P
minorista	minorista	O
minoristas	minorista	P
minorita	minorita	O
minoritas	minorita	P
minoritario	minoritario	O
minoritarias	minoritario	FP
minoritaria	minoritario	F
minoritarios	minoritario	P
minoría	minoría	O
minorías	minoría	P
mintroso	mintroso	O
mintrosas	mintroso	FP
mintrosa	mintroso	F
mintrosos	mintroso	P
minuano	minuano	O
minuanas	minuano	FP
minuana	minuano	F
minuanos	minuano	P
minucia	minucia	O
minucias	minucia	P
minuciosamente	minuciosamente	O
minuciosidad	minuciosidad	O
minuciosidades	minuciosidad	P
minucioso	minucioso	O
minuciosas	minucioso	FP
minuciosa	minucioso	F
minuciosos	minucioso	P
minuendo	minuendo	O
minuendos	minuendo	P
minuete	minuete	O
minuetes	minuete	P
minueto	minueto	O
minuetos	minueto	P
minusvalidez	minusvalidez	O
minusvalideces	minusvalidez	P
minusvalía	minusvalía	O
minusvalías	minusvalía	P
minusválido	minusválido	O
minusválidas	minusválido	FP
minusválida	minusválido	F
minusválidos	minusválido	P
minuta	minuta	O
minutas	minuta	P
minutación	minutación	O
minutaciones	minutación	P
minutario	minutario	O
minutarios	minutario	P
minutero	minutero	O
minuteros	minutero	P
minutisa	minutisa	O
minutisas	minutisa	P
minuto	minuto	O
minutas	minuto	FP
minuta	minuto	F
minutos	minuto	P
minué	minué	O
minués	minué	P
minúsculo	minúsculo	O
minúsculas	minúsculo	FP
minúscula	minúsculo	F
minúsculos	minúsculo	P
miñambre	miñambre	O
miñambres	miñambre	P
miñona	miñona	O
miñonas	miñona	P
miñosa	miñosa	O
miñosas	miñosa	P
miñón	miñón	O
miñones	miñón	P
mínima	mínima	O
mínimas	mínima	P
mínimo	mínimo	O
mínimas	mínimo	FP
mínima	mínimo	F
mínimos	mínimo	P
mínimum	mínimum	O
mínimumes	mínimum	P
mintió	mentir	VIX3
mintieron	mentir	VIX6
mintamos	mentir	VSP4
mintáis	mentir	VSP5
mintiera	mentir	VSX1
mintieras	mentir	VSX2
mintiéramos	mentir	VSX4
mintierais	mentir	VSX5
mintieran	mentir	VSX6
mintiere	mentir	VSF1
mintieres	mentir	VSF2
mintiéremos	mentir	VSF4
mintiereis	mentir	VSF5
mintieren	mentir	VSF6
mintiese	mentir	VSI1
mintieses	mentir	VSI2
mintiésemos	mentir	VSI4
mintieseis	mentir	VSI5
mintiesen	mentir	VSI6
mintiendo	mentir	VG
mintiéndome	mentir	VGSE
mintiéndote	mentir	VGSE
mintiéndole	mentir	VGSE
mintiéndonos	mentir	VGPE
mintiéndoos	mentir	VGPE
mintiéndolo	mentir	VGMSE
mintiéndola	mentir	VGFSE
mintiéndolos	mentir	VGMPE
mintiéndolas	mentir	VGFPE
mintiéndomelo	mentir	VGMSE
mintiéndotelo	mentir	VGMSE
mintiéndoselo	mentir	VGMSE
mintiéndonoslo	mentir	VGMSE
mintiéndooslo	mentir	VGMSE
mintiéndomelos	mentir	VGMPE
mintiéndotelos	mentir	VGMPE
mintiéndoselos	mentir	VGMPE
mintiéndonoslos	mentir	VGMPE
mintiéndooslos	mentir	VGMPE
mintiéndomela	mentir	VGFSE
mintiéndotela	mentir	VGFSE
mintiéndosela	mentir	VGFSE
mintiéndonosla	mentir	VGFSE
mintiéndoosla	mentir	VGFSE
mintiéndomelas	mentir	VGFPE
mintiéndotelas	mentir	VGFPE
mintiéndoselas	mentir	VGFPE
mintiéndonoslas	mentir	VGFPE
mintiéndooslas	mentir	VGFPE
minar	minar	O
mino	minar	VIP1
minas	minar	VIP2
mina	minar	VIP3
minamos	minar	VIP4
mináis	minar	VIP5
minan	minar	VIP6
minaba	minar	VII1
minabas	minar	VII2
minábamos	minar	VII4
minabais	minar	VII5
minaban	minar	VII6
minaré	minar	VIF1
minarás	minar	VIF2
minará	minar	VIF3
minaremos	minar	VIF4
minaréis	minar	VIF5
minarán	minar	VIF6
minaría	minar	VIC1
minarías	minar	VIC2
minaría	minar	VIC3
minaríamos	minar	VIC4
minaríais	minar	VIC5
minarían	minar	VIC6
miné	minar	VIX1
minaste	minar	VIX2
minó	minar	VIX3
minasteis	minar	VIX5
minaron	minar	VIX6
mine	minar	VSP1
mines	minar	VSP2
minemos	minar	VSP4
minéis	minar	VSP5
minen	minar	VSP6
minara	minar	VSX1
minaras	minar	VSX2
mináramos	minar	VSX4
minarais	minar	VSX5
minaran	minar	VSX6
minare	minar	VSF1
minares	minar	VSF2
mináremos	minar	VSF4
minareis	minar	VSF5
minaren	minar	VSF6
minase	minar	VSI1
minases	minar	VSI2
minásemos	minar	VSI4
minaseis	minar	VSI5
minasen	minar	VSI6
minad	minar	VMP
minadme	minar	VMSE
minadle	minar	VMSE
minadnos	minar	VMPE
minaos	minar	VMPE
minadles	minar	VMPE
minadlo	minar	VMMSE
minadla	minar	VMFSE
minadlos	minar	VMMPE
minadlas	minar	VMFPE
minádmelo	minar	VMMSE
minádselo	minar	VMMSE
minádnoslo	minar	VMMSE
mináoslo	minar	VMMSE
minádmelos	minar	VMMPE
minádselos	minar	VMMPE
minádnoslos	minar	VMMPE
mináoslos	minar	VMMPE
minádmela	minar	VMFSE
minádsela	minar	VMFSE
minádnosla	minar	VMFSE
mináosla	minar	VMFSE
minádmelas	minar	VMFPE
minádselas	minar	VMFPE
minádnoslas	minar	VMFPE
mináoslas	minar	VMFPE
minado	minar	VPM
minados	minar	VPMP
minada	minar	VPF
minadas	minar	VPFP
minando	minar	VG
minándome	minar	VGSE
minándote	minar	VGSE
minándole	minar	VGSE
minándonos	minar	VGPE
minándoos	minar	VGPE
minándolo	minar	VGMSE
minándola	minar	VGFSE
minándolos	minar	VGMPE
minándolas	minar	VGFPE
minándomelo	minar	VGMSE
minándotelo	minar	VGMSE
minándoselo	minar	VGMSE
minándonoslo	minar	VGMSE
minándooslo	minar	VGMSE
minándomelos	minar	VGMPE
minándotelos	minar	VGMPE
minándoselos	minar	VGMPE
minándonoslos	minar	VGMPE
minándooslos	minar	VGMPE
minándomela	minar	VGFSE
minándotela	minar	VGFSE
minándosela	minar	VGFSE
minándonosla	minar	VGFSE
minándoosla	minar	VGFSE
minándomelas	minar	VGFPE
minándotelas	minar	VGFPE
minándoselas	minar	VGFPE
minándonoslas	minar	VGFPE
minándooslas	minar	VGFPE
mindanguear	mindanguear	O
mindangueo	mindanguear	VIP1
mindangueas	mindanguear	VIP2
mindanguea	mindanguear	VIP3
mindangueamos	mindanguear	VIP4
mindangueáis	mindanguear	VIP5
mindanguean	mindanguear	VIP6
mindangueaba	mindanguear	VII1
mindangueabas	mindanguear	VII2
mindangueábamos	mindanguear	VII4
mindangueabais	mindanguear	VII5
mindangueaban	mindanguear	VII6
mindanguearé	mindanguear	VIF1
mindanguearás	mindanguear	VIF2
mindangueará	mindanguear	VIF3
mindanguearemos	mindanguear	VIF4
mindanguearéis	mindanguear	VIF5
mindanguearán	mindanguear	VIF6
mindanguearía	mindanguear	VIC1
mindanguearías	mindanguear	VIC2
mindanguearía	mindanguear	VIC3
mindanguearíamos	mindanguear	VIC4
mindanguearíais	mindanguear	VIC5
mindanguearían	mindanguear	VIC6
mindangueé	mindanguear	VIX1
mindangueaste	mindanguear	VIX2
mindangueó	mindanguear	VIX3
mindangueasteis	mindanguear	VIX5
mindanguearon	mindanguear	VIX6
mindanguee	mindanguear	VSP1
mindanguees	mindanguear	VSP2
mindangueemos	mindanguear	VSP4
mindangueéis	mindanguear	VSP5
mindangueen	mindanguear	VSP6
mindangueara	mindanguear	VSX1
mindanguearas	mindanguear	VSX2
mindangueáramos	mindanguear	VSX4
mindanguearais	mindanguear	VSX5
mindanguearan	mindanguear	VSX6
mindangueare	mindanguear	VSF1
mindangueares	mindanguear	VSF2
mindangueáremos	mindanguear	VSF4
mindangueareis	mindanguear	VSF5
mindanguearen	mindanguear	VSF6
mindanguease	mindanguear	VSI1
mindangueases	mindanguear	VSI2
mindangueásemos	mindanguear	VSI4
mindangueaseis	mindanguear	VSI5
mindangueasen	mindanguear	VSI6
mindanguead	mindanguear	VMP
mindangueadme	mindanguear	VMSE
mindangueadle	mindanguear	VMSE
mindangueadnos	mindanguear	VMPE
mindangueaos	mindanguear	VMPE
mindangueadles	mindanguear	VMPE
mindangueado	mindanguear	VPM
mindangueados	mindanguear	VPMP
mindangueada	mindanguear	VPF
mindangueadas	mindanguear	VPFP
mindangueando	mindanguear	VG
mindangueándome	mindanguear	VGSE
mindangueándote	mindanguear	VGSE
mindangueándole	mindanguear	VGSE
mindangueándonos	mindanguear	VGPE
mindangueándoos	mindanguear	VGPE
mineralizar	mineralizar	O
mineralizo	mineralizar	VIP1
mineralizas	mineralizar	VIP2
mineraliza	mineralizar	VIP3
mineralizamos	mineralizar	VIP4
mineralizáis	mineralizar	VIP5
mineralizan	mineralizar	VIP6
mineralizaba	mineralizar	VII1
mineralizabas	mineralizar	VII2
mineralizábamos	mineralizar	VII4
mineralizabais	mineralizar	VII5
mineralizaban	mineralizar	VII6
mineralizaré	mineralizar	VIF1
mineralizarás	mineralizar	VIF2
mineralizará	mineralizar	VIF3
mineralizaremos	mineralizar	VIF4
mineralizaréis	mineralizar	VIF5
mineralizarán	mineralizar	VIF6
mineralizaría	mineralizar	VIC1
mineralizarías	mineralizar	VIC2
mineralizaría	mineralizar	VIC3
mineralizaríamos	mineralizar	VIC4
mineralizaríais	mineralizar	VIC5
mineralizarían	mineralizar	VIC6
mineralicé	mineralizar	VIX1
mineralizaste	mineralizar	VIX2
mineralizó	mineralizar	VIX3
mineralizasteis	mineralizar	VIX5
mineralizaron	mineralizar	VIX6
mineralice	mineralizar	VSP1
mineralices	mineralizar	VSP2
mineralicemos	mineralizar	VSP4
mineralicéis	mineralizar	VSP5
mineralicen	mineralizar	VSP6
mineralizara	mineralizar	VSX1
mineralizaras	mineralizar	VSX2
mineralizáramos	mineralizar	VSX4
mineralizarais	mineralizar	VSX5
mineralizaran	mineralizar	VSX6
mineralizare	mineralizar	VSF1
mineralizares	mineralizar	VSF2
mineralizáremos	mineralizar	VSF4
mineralizareis	mineralizar	VSF5
mineralizaren	mineralizar	VSF6
mineralizase	mineralizar	VSI1
mineralizases	mineralizar	VSI2
mineralizásemos	mineralizar	VSI4
mineralizaseis	mineralizar	VSI5
mineralizasen	mineralizar	VSI6
mineralizad	mineralizar	VMP
mineralizadme	mineralizar	VMSE
mineralizadle	mineralizar	VMSE
mineralizadnos	mineralizar	VMPE
mineralizaos	mineralizar	VMPE
mineralizadles	mineralizar	VMPE
mineralizadlo	mineralizar	VMMSE
mineralizadla	mineralizar	VMFSE
mineralizadlos	mineralizar	VMMPE
mineralizadlas	mineralizar	VMFPE
mineralizádmelo	mineralizar	VMMSE
mineralizádselo	mineralizar	VMMSE
mineralizádnoslo	mineralizar	VMMSE
mineralizáoslo	mineralizar	VMMSE
mineralizádmelos	mineralizar	VMMPE
mineralizádselos	mineralizar	VMMPE
mineralizádnoslos	mineralizar	VMMPE
mineralizáoslos	mineralizar	VMMPE
mineralizádmela	mineralizar	VMFSE
mineralizádsela	mineralizar	VMFSE
mineralizádnosla	mineralizar	VMFSE
mineralizáosla	mineralizar	VMFSE
mineralizádmelas	mineralizar	VMFPE
mineralizádselas	mineralizar	VMFPE
mineralizádnoslas	mineralizar	VMFPE
mineralizáoslas	mineralizar	VMFPE
mineralizado	mineralizar	VPM
mineralizados	mineralizar	VPMP
mineralizada	mineralizar	VPF
mineralizadas	mineralizar	VPFP
mineralizando	mineralizar	VG
mineralizándome	mineralizar	VGSE
mineralizándote	mineralizar	VGSE
mineralizándole	mineralizar	VGSE
mineralizándonos	mineralizar	VGPE
mineralizándoos	mineralizar	VGPE
mineralizándolo	mineralizar	VGMSE
mineralizándola	mineralizar	VGFSE
mineralizándolos	mineralizar	VGMPE
mineralizándolas	mineralizar	VGFPE
mineralizándomelo	mineralizar	VGMSE
mineralizándotelo	mineralizar	VGMSE
mineralizándoselo	mineralizar	VGMSE
mineralizándonoslo	mineralizar	VGMSE
mineralizándooslo	mineralizar	VGMSE
mineralizándomelos	mineralizar	VGMPE
mineralizándotelos	mineralizar	VGMPE
mineralizándoselos	mineralizar	VGMPE
mineralizándonoslos	mineralizar	VGMPE
mineralizándooslos	mineralizar	VGMPE
mineralizándomela	mineralizar	VGFSE
mineralizándotela	mineralizar	VGFSE
mineralizándosela	mineralizar	VGFSE
mineralizándonosla	mineralizar	VGFSE
mineralizándoosla	mineralizar	VGFSE
mineralizándomelas	mineralizar	VGFPE
mineralizándotelas	mineralizar	VGFPE
mineralizándoselas	mineralizar	VGFPE
mineralizándonoslas	mineralizar	VGFPE
mineralizándooslas	mineralizar	VGFPE
mingar	mingar	O
mingo	mingar	VIP1
mingas	mingar	VIP2
minga	mingar	VIP3
mingamos	mingar	VIP4
mingáis	mingar	VIP5
mingan	mingar	VIP6
mingaba	mingar	VII1
mingabas	mingar	VII2
mingábamos	mingar	VII4
mingabais	mingar	VII5
mingaban	mingar	VII6
mingaré	mingar	VIF1
mingarás	mingar	VIF2
mingará	mingar	VIF3
mingaremos	mingar	VIF4
mingaréis	mingar	VIF5
mingarán	mingar	VIF6
mingaría	mingar	VIC1
mingarías	mingar	VIC2
mingaría	mingar	VIC3
mingaríamos	mingar	VIC4
mingaríais	mingar	VIC5
mingarían	mingar	VIC6
mingé	mingar	VIX1
mingaste	mingar	VIX2
mingó	mingar	VIX3
mingasteis	mingar	VIX5
mingaron	mingar	VIX6
mingue	mingar	VSP1
mingues	mingar	VSP2
minguemos	mingar	VSP4
minguéis	mingar	VSP5
minguen	mingar	VSP6
mingara	mingar	VSX1
mingaras	mingar	VSX2
mingáramos	mingar	VSX4
mingarais	mingar	VSX5
mingaran	mingar	VSX6
mingare	mingar	VSF1
mingares	mingar	VSF2
mingáremos	mingar	VSF4
mingareis	mingar	VSF5
mingaren	mingar	VSF6
mingase	mingar	VSI1
mingases	mingar	VSI2
mingásemos	mingar	VSI4
mingaseis	mingar	VSI5
mingasen	mingar	VSI6
mingad	mingar	VMP
mingadme	mingar	VMSE
mingadle	mingar	VMSE
mingadnos	mingar	VMPE
mingaos	mingar	VMPE
mingadles	mingar	VMPE
mingado	mingar	VPM
mingados	mingar	VPMP
mingada	mingar	VPF
mingadas	mingar	VPFP
mingando	mingar	VG
mingándome	mingar	VGSE
mingándote	mingar	VGSE
mingándole	mingar	VGSE
mingándonos	mingar	VGPE
mingándoos	mingar	VGPE
miniar	miniar	O
minio	miniar	VIP1
minias	miniar	VIP2
minia	miniar	VIP3
miniamos	miniar	VIP4
miniáis	miniar	VIP5
minian	miniar	VIP6
miniaba	miniar	VII1
miniabas	miniar	VII2
miniábamos	miniar	VII4
miniabais	miniar	VII5
miniaban	miniar	VII6
miniaré	miniar	VIF1
miniarás	miniar	VIF2
miniará	miniar	VIF3
miniaremos	miniar	VIF4
miniaréis	miniar	VIF5
miniarán	miniar	VIF6
miniaría	miniar	VIC1
miniarías	miniar	VIC2
miniaría	miniar	VIC3
miniaríamos	miniar	VIC4
miniaríais	miniar	VIC5
miniarían	miniar	VIC6
minié	miniar	VIX1
miniaste	miniar	VIX2
minió	miniar	VIX3
miniasteis	miniar	VIX5
miniaron	miniar	VIX6
minie	miniar	VSP1
minies	miniar	VSP2
miniemos	miniar	VSP4
miniéis	miniar	VSP5
minien	miniar	VSP6
miniara	miniar	VSX1
miniaras	miniar	VSX2
miniáramos	miniar	VSX4
miniarais	miniar	VSX5
miniaran	miniar	VSX6
miniare	miniar	VSF1
miniares	miniar	VSF2
miniáremos	miniar	VSF4
miniareis	miniar	VSF5
miniaren	miniar	VSF6
miniase	miniar	VSI1
miniases	miniar	VSI2
miniásemos	miniar	VSI4
miniaseis	miniar	VSI5
miniasen	miniar	VSI6
miniad	miniar	VMP
miniadme	miniar	VMSE
miniadle	miniar	VMSE
miniadnos	miniar	VMPE
miniaos	miniar	VMPE
miniadles	miniar	VMPE
miniadlo	miniar	VMMSE
miniadla	miniar	VMFSE
miniadlos	miniar	VMMPE
miniadlas	miniar	VMFPE
miniádmelo	miniar	VMMSE
miniádselo	miniar	VMMSE
miniádnoslo	miniar	VMMSE
miniáoslo	miniar	VMMSE
miniádmelos	miniar	VMMPE
miniádselos	miniar	VMMPE
miniádnoslos	miniar	VMMPE
miniáoslos	miniar	VMMPE
miniádmela	miniar	VMFSE
miniádsela	miniar	VMFSE
miniádnosla	miniar	VMFSE
miniáosla	miniar	VMFSE
miniádmelas	miniar	VMFPE
miniádselas	miniar	VMFPE
miniádnoslas	miniar	VMFPE
miniáoslas	miniar	VMFPE
miniado	miniar	VPM
miniados	miniar	VPMP
miniada	miniar	VPF
miniadas	miniar	VPFP
miniando	miniar	VG
miniándome	miniar	VGSE
miniándote	miniar	VGSE
miniándole	miniar	VGSE
miniándonos	miniar	VGPE
miniándoos	miniar	VGPE
miniándolo	miniar	VGMSE
miniándola	miniar	VGFSE
miniándolos	miniar	VGMPE
miniándolas	miniar	VGFPE
miniándomelo	miniar	VGMSE
miniándotelo	miniar	VGMSE
miniándoselo	miniar	VGMSE
miniándonoslo	miniar	VGMSE
miniándooslo	miniar	VGMSE
miniándomelos	miniar	VGMPE
miniándotelos	miniar	VGMPE
miniándoselos	miniar	VGMPE
miniándonoslos	miniar	VGMPE
miniándooslos	miniar	VGMPE
miniándomela	miniar	VGFSE
miniándotela	miniar	VGFSE
miniándosela	miniar	VGFSE
miniándonosla	miniar	VGFSE
miniándoosla	miniar	VGFSE
miniándomelas	miniar	VGFPE
miniándotelas	miniar	VGFPE
miniándoselas	miniar	VGFPE
miniándonoslas	miniar	VGFPE
miniándooslas	miniar	VGFPE
miniaturizar	miniaturizar	O
miniaturizo	miniaturizar	VIP1
miniaturizas	miniaturizar	VIP2
miniaturiza	miniaturizar	VIP3
miniaturizamos	miniaturizar	VIP4
miniaturizáis	miniaturizar	VIP5
miniaturizan	miniaturizar	VIP6
miniaturizaba	miniaturizar	VII1
miniaturizabas	miniaturizar	VII2
miniaturizábamos	miniaturizar	VII4
miniaturizabais	miniaturizar	VII5
miniaturizaban	miniaturizar	VII6
miniaturizaré	miniaturizar	VIF1
miniaturizarás	miniaturizar	VIF2
miniaturizará	miniaturizar	VIF3
miniaturizaremos	miniaturizar	VIF4
miniaturizaréis	miniaturizar	VIF5
miniaturizarán	miniaturizar	VIF6
miniaturizaría	miniaturizar	VIC1
miniaturizarías	miniaturizar	VIC2
miniaturizaría	miniaturizar	VIC3
miniaturizaríamos	miniaturizar	VIC4
miniaturizaríais	miniaturizar	VIC5
miniaturizarían	miniaturizar	VIC6
miniaturicé	miniaturizar	VIX1
miniaturizaste	miniaturizar	VIX2
miniaturizó	miniaturizar	VIX3
miniaturizasteis	miniaturizar	VIX5
miniaturizaron	miniaturizar	VIX6
miniaturice	miniaturizar	VSP1
miniaturices	miniaturizar	VSP2
miniaturicemos	miniaturizar	VSP4
miniaturicéis	miniaturizar	VSP5
miniaturicen	miniaturizar	VSP6
miniaturizara	miniaturizar	VSX1
miniaturizaras	miniaturizar	VSX2
miniaturizáramos	miniaturizar	VSX4
miniaturizarais	miniaturizar	VSX5
miniaturizaran	miniaturizar	VSX6
miniaturizare	miniaturizar	VSF1
miniaturizares	miniaturizar	VSF2
miniaturizáremos	miniaturizar	VSF4
miniaturizareis	miniaturizar	VSF5
miniaturizaren	miniaturizar	VSF6
miniaturizase	miniaturizar	VSI1
miniaturizases	miniaturizar	VSI2
miniaturizásemos	miniaturizar	VSI4
miniaturizaseis	miniaturizar	VSI5
miniaturizasen	miniaturizar	VSI6
miniaturizad	miniaturizar	VMP
miniaturizadme	miniaturizar	VMSE
miniaturizadle	miniaturizar	VMSE
miniaturizadnos	miniaturizar	VMPE
miniaturizaos	miniaturizar	VMPE
miniaturizadles	miniaturizar	VMPE
miniaturizadlo	miniaturizar	VMMSE
miniaturizadla	miniaturizar	VMFSE
miniaturizadlos	miniaturizar	VMMPE
miniaturizadlas	miniaturizar	VMFPE
miniaturizádmelo	miniaturizar	VMMSE
miniaturizádselo	miniaturizar	VMMSE
miniaturizádnoslo	miniaturizar	VMMSE
miniaturizáoslo	miniaturizar	VMMSE
miniaturizádmelos	miniaturizar	VMMPE
miniaturizádselos	miniaturizar	VMMPE
miniaturizádnoslos	miniaturizar	VMMPE
miniaturizáoslos	miniaturizar	VMMPE
miniaturizádmela	miniaturizar	VMFSE
miniaturizádsela	miniaturizar	VMFSE
miniaturizádnosla	miniaturizar	VMFSE
miniaturizáosla	miniaturizar	VMFSE
miniaturizádmelas	miniaturizar	VMFPE
miniaturizádselas	miniaturizar	VMFPE
miniaturizádnoslas	miniaturizar	VMFPE
miniaturizáoslas	miniaturizar	VMFPE
miniaturizado	miniaturizar	VPM
miniaturizados	miniaturizar	VPMP
miniaturizada	miniaturizar	VPF
miniaturizadas	miniaturizar	VPFP
miniaturizando	miniaturizar	VG
miniaturizándome	miniaturizar	VGSE
miniaturizándote	miniaturizar	VGSE
miniaturizándole	miniaturizar	VGSE
miniaturizándonos	miniaturizar	VGPE
miniaturizándoos	miniaturizar	VGPE
miniaturizándolo	miniaturizar	VGMSE
miniaturizándola	miniaturizar	VGFSE
miniaturizándolos	miniaturizar	VGMPE
miniaturizándolas	miniaturizar	VGFPE
miniaturizándomelo	miniaturizar	VGMSE
miniaturizándotelo	miniaturizar	VGMSE
miniaturizándoselo	miniaturizar	VGMSE
miniaturizándonoslo	miniaturizar	VGMSE
miniaturizándooslo	miniaturizar	VGMSE
miniaturizándomelos	miniaturizar	VGMPE
miniaturizándotelos	miniaturizar	VGMPE
miniaturizándoselos	miniaturizar	VGMPE
miniaturizándonoslos	miniaturizar	VGMPE
miniaturizándooslos	miniaturizar	VGMPE
miniaturizándomela	miniaturizar	VGFSE
miniaturizándotela	miniaturizar	VGFSE
miniaturizándosela	miniaturizar	VGFSE
miniaturizándonosla	miniaturizar	VGFSE
miniaturizándoosla	miniaturizar	VGFSE
miniaturizándomelas	miniaturizar	VGFPE
miniaturizándotelas	miniaturizar	VGFPE
miniaturizándoselas	miniaturizar	VGFPE
miniaturizándonoslas	miniaturizar	VGFPE
miniaturizándooslas	miniaturizar	VGFPE
minimizar	minimizar	O
minimizo	minimizar	VIP1
minimizas	minimizar	VIP2
minimiza	minimizar	VIP3
minimizamos	minimizar	VIP4
minimizáis	minimizar	VIP5
minimizan	minimizar	VIP6
minimizaba	minimizar	VII1
minimizabas	minimizar	VII2
minimizábamos	minimizar	VII4
minimizabais	minimizar	VII5
minimizaban	minimizar	VII6
minimizaré	minimizar	VIF1
minimizarás	minimizar	VIF2
minimizará	minimizar	VIF3
minimizaremos	minimizar	VIF4
minimizaréis	minimizar	VIF5
minimizarán	minimizar	VIF6
minimizaría	minimizar	VIC1
minimizarías	minimizar	VIC2
minimizaría	minimizar	VIC3
minimizaríamos	minimizar	VIC4
minimizaríais	minimizar	VIC5
minimizarían	minimizar	VIC6
minimicé	minimizar	VIX1
minimizaste	minimizar	VIX2
minimizó	minimizar	VIX3
minimizasteis	minimizar	VIX5
minimizaron	minimizar	VIX6
minimice	minimizar	VSP1
minimices	minimizar	VSP2
minimicemos	minimizar	VSP4
minimicéis	minimizar	VSP5
minimicen	minimizar	VSP6
minimizara	minimizar	VSX1
minimizaras	minimizar	VSX2
minimizáramos	minimizar	VSX4
minimizarais	minimizar	VSX5
minimizaran	minimizar	VSX6
minimizare	minimizar	VSF1
minimizares	minimizar	VSF2
minimizáremos	minimizar	VSF4
minimizareis	minimizar	VSF5
minimizaren	minimizar	VSF6
minimizase	minimizar	VSI1
minimizases	minimizar	VSI2
minimizásemos	minimizar	VSI4
minimizaseis	minimizar	VSI5
minimizasen	minimizar	VSI6
minimizad	minimizar	VMP
minimizadme	minimizar	VMSE
minimizadle	minimizar	VMSE
minimizadnos	minimizar	VMPE
minimizaos	minimizar	VMPE
minimizadles	minimizar	VMPE
minimizadlo	minimizar	VMMSE
minimizadla	minimizar	VMFSE
minimizadlos	minimizar	VMMPE
minimizadlas	minimizar	VMFPE
minimizádmelo	minimizar	VMMSE
minimizádselo	minimizar	VMMSE
minimizádnoslo	minimizar	VMMSE
minimizáoslo	minimizar	VMMSE
minimizádmelos	minimizar	VMMPE
minimizádselos	minimizar	VMMPE
minimizádnoslos	minimizar	VMMPE
minimizáoslos	minimizar	VMMPE
minimizádmela	minimizar	VMFSE
minimizádsela	minimizar	VMFSE
minimizádnosla	minimizar	VMFSE
minimizáosla	minimizar	VMFSE
minimizádmelas	minimizar	VMFPE
minimizádselas	minimizar	VMFPE
minimizádnoslas	minimizar	VMFPE
minimizáoslas	minimizar	VMFPE
minimizado	minimizar	VPM
minimizados	minimizar	VPMP
minimizada	minimizar	VPF
minimizadas	minimizar	VPFP
minimizando	minimizar	VG
minimizándome	minimizar	VGSE
minimizándote	minimizar	VGSE
minimizándole	minimizar	VGSE
minimizándonos	minimizar	VGPE
minimizándoos	minimizar	VGPE
minimizándolo	minimizar	VGMSE
minimizándola	minimizar	VGFSE
minimizándolos	minimizar	VGMPE
minimizándolas	minimizar	VGFPE
minimizándomelo	minimizar	VGMSE
minimizándotelo	minimizar	VGMSE
minimizándoselo	minimizar	VGMSE
minimizándonoslo	minimizar	VGMSE
minimizándooslo	minimizar	VGMSE
minimizándomelos	minimizar	VGMPE
minimizándotelos	minimizar	VGMPE
minimizándoselos	minimizar	VGMPE
minimizándonoslos	minimizar	VGMPE
minimizándooslos	minimizar	VGMPE
minimizándomela	minimizar	VGFSE
minimizándotela	minimizar	VGFSE
minimizándosela	minimizar	VGFSE
minimizándonosla	minimizar	VGFSE
minimizándoosla	minimizar	VGFSE
minimizándomelas	minimizar	VGFPE
minimizándotelas	minimizar	VGFPE
minimizándoselas	minimizar	VGFPE
minimizándonoslas	minimizar	VGFPE
minimizándooslas	minimizar	VGFPE
ministrar	ministrar	O
ministro	ministrar	VIP1
ministras	ministrar	VIP2
ministra	ministrar	VIP3
ministramos	ministrar	VIP4
ministráis	ministrar	VIP5
ministran	ministrar	VIP6
ministraba	ministrar	VII1
ministrabas	ministrar	VII2
ministrábamos	ministrar	VII4
ministrabais	ministrar	VII5
ministraban	ministrar	VII6
ministraré	ministrar	VIF1
ministrarás	ministrar	VIF2
ministrará	ministrar	VIF3
ministraremos	ministrar	VIF4
ministraréis	ministrar	VIF5
ministrarán	ministrar	VIF6
ministraría	ministrar	VIC1
ministrarías	ministrar	VIC2
ministraría	ministrar	VIC3
ministraríamos	ministrar	VIC4
ministraríais	ministrar	VIC5
ministrarían	ministrar	VIC6
ministré	ministrar	VIX1
ministraste	ministrar	VIX2
ministró	ministrar	VIX3
ministrasteis	ministrar	VIX5
ministraron	ministrar	VIX6
ministre	ministrar	VSP1
ministres	ministrar	VSP2
ministremos	ministrar	VSP4
ministréis	ministrar	VSP5
ministren	ministrar	VSP6
ministrara	ministrar	VSX1
ministraras	ministrar	VSX2
ministráramos	ministrar	VSX4
ministrarais	ministrar	VSX5
ministraran	ministrar	VSX6
ministrare	ministrar	VSF1
ministrares	ministrar	VSF2
ministráremos	ministrar	VSF4
ministrareis	ministrar	VSF5
ministraren	ministrar	VSF6
ministrase	ministrar	VSI1
ministrases	ministrar	VSI2
ministrásemos	ministrar	VSI4
ministraseis	ministrar	VSI5
ministrasen	ministrar	VSI6
ministrad	ministrar	VMP
ministradme	ministrar	VMSE
ministradle	ministrar	VMSE
ministradnos	ministrar	VMPE
ministraos	ministrar	VMPE
ministradles	ministrar	VMPE
ministradlo	ministrar	VMMSE
ministradla	ministrar	VMFSE
ministradlos	ministrar	VMMPE
ministradlas	ministrar	VMFPE
ministrádmelo	ministrar	VMMSE
ministrádselo	ministrar	VMMSE
ministrádnoslo	ministrar	VMMSE
ministráoslo	ministrar	VMMSE
ministrádmelos	ministrar	VMMPE
ministrádselos	ministrar	VMMPE
ministrádnoslos	ministrar	VMMPE
ministráoslos	ministrar	VMMPE
ministrádmela	ministrar	VMFSE
ministrádsela	ministrar	VMFSE
ministrádnosla	ministrar	VMFSE
ministráosla	ministrar	VMFSE
ministrádmelas	ministrar	VMFPE
ministrádselas	ministrar	VMFPE
ministrádnoslas	ministrar	VMFPE
ministráoslas	ministrar	VMFPE
ministrado	ministrar	VPM
ministrados	ministrar	VPMP
ministrada	ministrar	VPF
ministradas	ministrar	VPFP
ministrando	ministrar	VG
ministrándome	ministrar	VGSE
ministrándote	ministrar	VGSE
ministrándole	ministrar	VGSE
ministrándonos	ministrar	VGPE
ministrándoos	ministrar	VGPE
ministrándolo	ministrar	VGMSE
ministrándola	ministrar	VGFSE
ministrándolos	ministrar	VGMPE
ministrándolas	ministrar	VGFPE
ministrándomelo	ministrar	VGMSE
ministrándotelo	ministrar	VGMSE
ministrándoselo	ministrar	VGMSE
ministrándonoslo	ministrar	VGMSE
ministrándooslo	ministrar	VGMSE
ministrándomelos	ministrar	VGMPE
ministrándotelos	ministrar	VGMPE
ministrándoselos	ministrar	VGMPE
ministrándonoslos	ministrar	VGMPE
ministrándooslos	ministrar	VGMPE
ministrándomela	ministrar	VGFSE
ministrándotela	ministrar	VGFSE
ministrándosela	ministrar	VGFSE
ministrándonosla	ministrar	VGFSE
ministrándoosla	ministrar	VGFSE
ministrándomelas	ministrar	VGFPE
ministrándotelas	ministrar	VGFPE
ministrándoselas	ministrar	VGFPE
ministrándonoslas	ministrar	VGFPE
ministrándooslas	ministrar	VGFPE
minorar	minorar	O
minoro	minorar	VIP1
minoras	minorar	VIP2
minora	minorar	VIP3
minoramos	minorar	VIP4
minoráis	minorar	VIP5
minoran	minorar	VIP6
minoraba	minorar	VII1
minorabas	minorar	VII2
minorábamos	minorar	VII4
minorabais	minorar	VII5
minoraban	minorar	VII6
minoraré	minorar	VIF1
minorarás	minorar	VIF2
minorará	minorar	VIF3
minoraremos	minorar	VIF4
minoraréis	minorar	VIF5
minorarán	minorar	VIF6
minoraría	minorar	VIC1
minorarías	minorar	VIC2
minoraría	minorar	VIC3
minoraríamos	minorar	VIC4
minoraríais	minorar	VIC5
minorarían	minorar	VIC6
minoré	minorar	VIX1
minoraste	minorar	VIX2
minoró	minorar	VIX3
minorasteis	minorar	VIX5
minoraron	minorar	VIX6
minore	minorar	VSP1
minores	minorar	VSP2
minoremos	minorar	VSP4
minoréis	minorar	VSP5
minoren	minorar	VSP6
minorara	minorar	VSX1
minoraras	minorar	VSX2
minoráramos	minorar	VSX4
minorarais	minorar	VSX5
minoraran	minorar	VSX6
minorare	minorar	VSF1
minorares	minorar	VSF2
minoráremos	minorar	VSF4
minorareis	minorar	VSF5
minoraren	minorar	VSF6
minorase	minorar	VSI1
minorases	minorar	VSI2
minorásemos	minorar	VSI4
minoraseis	minorar	VSI5
minorasen	minorar	VSI6
minorad	minorar	VMP
minoradme	minorar	VMSE
minoradle	minorar	VMSE
minoradnos	minorar	VMPE
minoraos	minorar	VMPE
minoradles	minorar	VMPE
minoradlo	minorar	VMMSE
minoradla	minorar	VMFSE
minoradlos	minorar	VMMPE
minoradlas	minorar	VMFPE
minorádmelo	minorar	VMMSE
minorádselo	minorar	VMMSE
minorádnoslo	minorar	VMMSE
minoráoslo	minorar	VMMSE
minorádmelos	minorar	VMMPE
minorádselos	minorar	VMMPE
minorádnoslos	minorar	VMMPE
minoráoslos	minorar	VMMPE
minorádmela	minorar	VMFSE
minorádsela	minorar	VMFSE
minorádnosla	minorar	VMFSE
minoráosla	minorar	VMFSE
minorádmelas	minorar	VMFPE
minorádselas	minorar	VMFPE
minorádnoslas	minorar	VMFPE
minoráoslas	minorar	VMFPE
minorado	minorar	VPM
minorados	minorar	VPMP
minorada	minorar	VPF
minoradas	minorar	VPFP
minorando	minorar	VG
minorándome	minorar	VGSE
minorándote	minorar	VGSE
minorándole	minorar	VGSE
minorándonos	minorar	VGPE
minorándoos	minorar	VGPE
minorándolo	minorar	VGMSE
minorándola	minorar	VGFSE
minorándolos	minorar	VGMPE
minorándolas	minorar	VGFPE
minorándomelo	minorar	VGMSE
minorándotelo	minorar	VGMSE
minorándoselo	minorar	VGMSE
minorándonoslo	minorar	VGMSE
minorándooslo	minorar	VGMSE
minorándomelos	minorar	VGMPE
minorándotelos	minorar	VGMPE
minorándoselos	minorar	VGMPE
minorándonoslos	minorar	VGMPE
minorándooslos	minorar	VGMPE
minorándomela	minorar	VGFSE
minorándotela	minorar	VGFSE
minorándosela	minorar	VGFSE
minorándonosla	minorar	VGFSE
minorándoosla	minorar	VGFSE
minorándomelas	minorar	VGFPE
minorándotelas	minorar	VGFPE
minorándoselas	minorar	VGFPE
minorándonoslas	minorar	VGFPE
minorándooslas	minorar	VGFPE
minusvalorar	minusvalorar	O
minusvaloro	minusvalorar	VIP1
minusvaloras	minusvalorar	VIP2
minusvalora	minusvalorar	VIP3
minusvaloramos	minusvalorar	VIP4
minusvaloráis	minusvalorar	VIP5
minusvaloran	minusvalorar	VIP6
minusvaloraba	minusvalorar	VII1
minusvalorabas	minusvalorar	VII2
minusvalorábamos	minusvalorar	VII4
minusvalorabais	minusvalorar	VII5
minusvaloraban	minusvalorar	VII6
minusvaloraré	minusvalorar	VIF1
minusvalorarás	minusvalorar	VIF2
minusvalorará	minusvalorar	VIF3
minusvaloraremos	minusvalorar	VIF4
minusvaloraréis	minusvalorar	VIF5
minusvalorarán	minusvalorar	VIF6
minusvaloraría	minusvalorar	VIC1
minusvalorarías	minusvalorar	VIC2
minusvaloraría	minusvalorar	VIC3
minusvaloraríamos	minusvalorar	VIC4
minusvaloraríais	minusvalorar	VIC5
minusvalorarían	minusvalorar	VIC6
minusvaloré	minusvalorar	VIX1
minusvaloraste	minusvalorar	VIX2
minusvaloró	minusvalorar	VIX3
minusvalorasteis	minusvalorar	VIX5
minusvaloraron	minusvalorar	VIX6
minusvalore	minusvalorar	VSP1
minusvalores	minusvalorar	VSP2
minusvaloremos	minusvalorar	VSP4
minusvaloréis	minusvalorar	VSP5
minusvaloren	minusvalorar	VSP6
minusvalorara	minusvalorar	VSX1
minusvaloraras	minusvalorar	VSX2
minusvaloráramos	minusvalorar	VSX4
minusvalorarais	minusvalorar	VSX5
minusvaloraran	minusvalorar	VSX6
minusvalorare	minusvalorar	VSF1
minusvalorares	minusvalorar	VSF2
minusvaloráremos	minusvalorar	VSF4
minusvalorareis	minusvalorar	VSF5
minusvaloraren	minusvalorar	VSF6
minusvalorase	minusvalorar	VSI1
minusvalorases	minusvalorar	VSI2
minusvalorásemos	minusvalorar	VSI4
minusvaloraseis	minusvalorar	VSI5
minusvalorasen	minusvalorar	VSI6
minusvalorad	minusvalorar	VMP
minusvaloradme	minusvalorar	VMSE
minusvaloradle	minusvalorar	VMSE
minusvaloradnos	minusvalorar	VMPE
minusvaloraos	minusvalorar	VMPE
minusvaloradles	minusvalorar	VMPE
minusvaloradlo	minusvalorar	VMMSE
minusvaloradla	minusvalorar	VMFSE
minusvaloradlos	minusvalorar	VMMPE
minusvaloradlas	minusvalorar	VMFPE
minusvalorádmelo	minusvalorar	VMMSE
minusvalorádselo	minusvalorar	VMMSE
minusvalorádnoslo	minusvalorar	VMMSE
minusvaloráoslo	minusvalorar	VMMSE
minusvalorádmelos	minusvalorar	VMMPE
minusvalorádselos	minusvalorar	VMMPE
minusvalorádnoslos	minusvalorar	VMMPE
minusvaloráoslos	minusvalorar	VMMPE
minusvalorádmela	minusvalorar	VMFSE
minusvalorádsela	minusvalorar	VMFSE
minusvalorádnosla	minusvalorar	VMFSE
minusvaloráosla	minusvalorar	VMFSE
minusvalorádmelas	minusvalorar	VMFPE
minusvalorádselas	minusvalorar	VMFPE
minusvalorádnoslas	minusvalorar	VMFPE
minusvaloráoslas	minusvalorar	VMFPE
minusvalorado	minusvalorar	VPM
minusvalorados	minusvalorar	VPMP
minusvalorada	minusvalorar	VPF
minusvaloradas	minusvalorar	VPFP
minusvalorando	minusvalorar	VG
minusvalorándome	minusvalorar	VGSE
minusvalorándote	minusvalorar	VGSE
minusvalorándole	minusvalorar	VGSE
minusvalorándonos	minusvalorar	VGPE
minusvalorándoos	minusvalorar	VGPE
minusvalorándolo	minusvalorar	VGMSE
minusvalorándola	minusvalorar	VGFSE
minusvalorándolos	minusvalorar	VGMPE
minusvalorándolas	minusvalorar	VGFPE
minusvalorándomelo	minusvalorar	VGMSE
minusvalorándotelo	minusvalorar	VGMSE
minusvalorándoselo	minusvalorar	VGMSE
minusvalorándonoslo	minusvalorar	VGMSE
minusvalorándooslo	minusvalorar	VGMSE
minusvalorándomelos	minusvalorar	VGMPE
minusvalorándotelos	minusvalorar	VGMPE
minusvalorándoselos	minusvalorar	VGMPE
minusvalorándonoslos	minusvalorar	VGMPE
minusvalorándooslos	minusvalorar	VGMPE
minusvalorándomela	minusvalorar	VGFSE
minusvalorándotela	minusvalorar	VGFSE
minusvalorándosela	minusvalorar	VGFSE
minusvalorándonosla	minusvalorar	VGFSE
minusvalorándoosla	minusvalorar	VGFSE
minusvalorándomelas	minusvalorar	VGFPE
minusvalorándotelas	minusvalorar	VGFPE
minusvalorándoselas	minusvalorar	VGFPE
minusvalorándonoslas	minusvalorar	VGFPE
minusvalorándooslas	minusvalorar	VGFPE
minutar	minutar	O
minuto	minutar	VIP1
minutas	minutar	VIP2
minuta	minutar	VIP3
minutamos	minutar	VIP4
minutáis	minutar	VIP5
minutan	minutar	VIP6
minutaba	minutar	VII1
minutabas	minutar	VII2
minutábamos	minutar	VII4
minutabais	minutar	VII5
minutaban	minutar	VII6
minutaré	minutar	VIF1
minutarás	minutar	VIF2
minutará	minutar	VIF3
minutaremos	minutar	VIF4
minutaréis	minutar	VIF5
minutarán	minutar	VIF6
minutaría	minutar	VIC1
minutarías	minutar	VIC2
minutaría	minutar	VIC3
minutaríamos	minutar	VIC4
minutaríais	minutar	VIC5
minutarían	minutar	VIC6
minuté	minutar	VIX1
minutaste	minutar	VIX2
minutó	minutar	VIX3
minutasteis	minutar	VIX5
minutaron	minutar	VIX6
minute	minutar	VSP1
minutes	minutar	VSP2
minutemos	minutar	VSP4
minutéis	minutar	VSP5
minuten	minutar	VSP6
minutara	minutar	VSX1
minutaras	minutar	VSX2
minutáramos	minutar	VSX4
minutarais	minutar	VSX5
minutaran	minutar	VSX6
minutare	minutar	VSF1
minutares	minutar	VSF2
minutáremos	minutar	VSF4
minutareis	minutar	VSF5
minutaren	minutar	VSF6
minutase	minutar	VSI1
minutases	minutar	VSI2
minutásemos	minutar	VSI4
minutaseis	minutar	VSI5
minutasen	minutar	VSI6
minutad	minutar	VMP
minutadme	minutar	VMSE
minutadle	minutar	VMSE
minutadnos	minutar	VMPE
minutaos	minutar	VMPE
minutadles	minutar	VMPE
minutadlo	minutar	VMMSE
minutadla	minutar	VMFSE
minutadlos	minutar	VMMPE
minutadlas	minutar	VMFPE
minutádmelo	minutar	VMMSE
minutádselo	minutar	VMMSE
minutádnoslo	minutar	VMMSE
minutáoslo	minutar	VMMSE
minutádmelos	minutar	VMMPE
minutádselos	minutar	VMMPE
minutádnoslos	minutar	VMMPE
minutáoslos	minutar	VMMPE
minutádmela	minutar	VMFSE
minutádsela	minutar	VMFSE
minutádnosla	minutar	VMFSE
minutáosla	minutar	VMFSE
minutádmelas	minutar	VMFPE
minutádselas	minutar	VMFPE
minutádnoslas	minutar	VMFPE
minutáoslas	minutar	VMFPE
minutado	minutar	VPM
minutados	minutar	VPMP
minutada	minutar	VPF
minutadas	minutar	VPFP
minutando	minutar	VG
minutándome	minutar	VGSE
minutándote	minutar	VGSE
minutándole	minutar	VGSE
minutándonos	minutar	VGPE
minutándoos	minutar	VGPE
minutándolo	minutar	VGMSE
minutándola	minutar	VGFSE
minutándolos	minutar	VGMPE
minutándolas	minutar	VGFPE
minutándomelo	minutar	VGMSE
minutándotelo	minutar	VGMSE
minutándoselo	minutar	VGMSE
minutándonoslo	minutar	VGMSE
minutándooslo	minutar	VGMSE
minutándomelos	minutar	VGMPE
minutándotelos	minutar	VGMPE
minutándoselos	minutar	VGMPE
minutándonoslos	minutar	VGMPE
minutándooslos	minutar	VGMPE
minutándomela	minutar	VGFSE
minutándotela	minutar	VGFSE
minutándosela	minutar	VGFSE
minutándonosla	minutar	VGFSE
minutándoosla	minutar	VGFSE
minutándomelas	minutar	VGFPE
minutándotelas	minutar	VGFPE
minutándoselas	minutar	VGFPE
minutándonoslas	minutar	VGFPE
minutándooslas	minutar	VGFPE
