mojada	mojada	O
mojadas	mojada	P
mojadedo	mojadedo	O
mojadedos	mojadedo	P
mojado	mojado	O
mojadas	mojado	FP
mojada	mojado	F
mojados	mojado	P
mojador	mojador	O
mojadoras	mojador	FP
mojadora	mojador	F
mojadores	mojador	P
mojadura	mojadura	O
mojaduras	mojadura	P
mojama	mojama	O
mojamas	mojama	P
mojarra	mojarra	O
mojarras	mojarra	P
mojarrilla	mojarrilla	O
mojarrillas	mojarrilla	P
moje	moje	O
mojes	moje	P
mojel	mojel	O
mojeles	mojel	P
mojera	mojera	O
mojeras	mojera	P
mojete	mojete	O
mojetes	mojete	P
mojicón	mojicón	O
mojicones	mojicón	P
mojiganga	mojiganga	O
mojigangas	mojiganga	P
mojigatería	mojigatería	O
mojigaterías	mojigatería	P
mojigatez	mojigatez	O
mojigateces	mojigatez	P
mojigato	mojigato	O
mojigatas	mojigato	FP
mojigata	mojigato	F
mojigatos	mojigato	P
mojil	mojil	O
mojiles	mojil	P
mojina	mojina	O
mojinas	mojina	P
mojinete	mojinete	O
mojinetes	mojinete	P
mojito	mojito	O
mojitos	mojito	P
mojo	mojo	O
mojos	mojo	P
mojona	mojona	O
mojonas	mojona	P
mojonación	mojonación	O
mojonaciones	mojonación	P
mojonera	mojonera	O
mojoneras	mojonera	P
mojonero	mojonero	O
mojoneros	mojonero	P
mojábana	mojábana	O
mojábanas	mojábana	P
mojí	mojí	O
mojíes	mojí	P
mojón	mojón	O
mojones	mojón	P
mojar	mojar	O
mojo	mojar	VIP1
mojas	mojar	VIP2
moja	mojar	VIP3
mojamos	mojar	VIP4
mojáis	mojar	VIP5
mojan	mojar	VIP6
mojaba	mojar	VII1
mojabas	mojar	VII2
mojábamos	mojar	VII4
mojabais	mojar	VII5
mojaban	mojar	VII6
mojaré	mojar	VIF1
mojarás	mojar	VIF2
mojará	mojar	VIF3
mojaremos	mojar	VIF4
mojaréis	mojar	VIF5
mojarán	mojar	VIF6
mojaría	mojar	VIC1
mojarías	mojar	VIC2
mojaría	mojar	VIC3
mojaríamos	mojar	VIC4
mojaríais	mojar	VIC5
mojarían	mojar	VIC6
mojé	mojar	VIX1
mojaste	mojar	VIX2
mojó	mojar	VIX3
mojasteis	mojar	VIX5
mojaron	mojar	VIX6
moje	mojar	VSP1
mojes	mojar	VSP2
mojemos	mojar	VSP4
mojéis	mojar	VSP5
mojen	mojar	VSP6
mojara	mojar	VSX1
mojaras	mojar	VSX2
mojáramos	mojar	VSX4
mojarais	mojar	VSX5
mojaran	mojar	VSX6
mojare	mojar	VSF1
mojares	mojar	VSF2
mojáremos	mojar	VSF4
mojareis	mojar	VSF5
mojaren	mojar	VSF6
mojase	mojar	VSI1
mojases	mojar	VSI2
mojásemos	mojar	VSI4
mojaseis	mojar	VSI5
mojasen	mojar	VSI6
mojad	mojar	VMP
mojadme	mojar	VMSE
mojadle	mojar	VMSE
mojadnos	mojar	VMPE
mojaos	mojar	VMPE
mojadles	mojar	VMPE
mojadlo	mojar	VMMSE
mojadla	mojar	VMFSE
mojadlos	mojar	VMMPE
mojadlas	mojar	VMFPE
mojádmelo	mojar	VMMSE
mojádselo	mojar	VMMSE
mojádnoslo	mojar	VMMSE
mojáoslo	mojar	VMMSE
mojádmelos	mojar	VMMPE
mojádselos	mojar	VMMPE
mojádnoslos	mojar	VMMPE
mojáoslos	mojar	VMMPE
mojádmela	mojar	VMFSE
mojádsela	mojar	VMFSE
mojádnosla	mojar	VMFSE
mojáosla	mojar	VMFSE
mojádmelas	mojar	VMFPE
mojádselas	mojar	VMFPE
mojádnoslas	mojar	VMFPE
mojáoslas	mojar	VMFPE
mojado	mojar	VPM
mojados	mojar	VPMP
mojada	mojar	VPF
mojadas	mojar	VPFP
mojando	mojar	VG
mojándome	mojar	VGSE
mojándote	mojar	VGSE
mojándole	mojar	VGSE
mojándonos	mojar	VGPE
mojándoos	mojar	VGPE
mojándolo	mojar	VGMSE
mojándola	mojar	VGFSE
mojándolos	mojar	VGMPE
mojándolas	mojar	VGFPE
mojándomelo	mojar	VGMSE
mojándotelo	mojar	VGMSE
mojándoselo	mojar	VGMSE
mojándonoslo	mojar	VGMSE
mojándooslo	mojar	VGMSE
mojándomelos	mojar	VGMPE
mojándotelos	mojar	VGMPE
mojándoselos	mojar	VGMPE
mojándonoslos	mojar	VGMPE
mojándooslos	mojar	VGMPE
mojándomela	mojar	VGFSE
mojándotela	mojar	VGFSE
mojándosela	mojar	VGFSE
mojándonosla	mojar	VGFSE
mojándoosla	mojar	VGFSE
mojándomelas	mojar	VGFPE
mojándotelas	mojar	VGFPE
mojándoselas	mojar	VGFPE
mojándonoslas	mojar	VGFPE
mojándooslas	mojar	VGFPE
mojonar	mojonar	O
mojono	mojonar	VIP1
mojonas	mojonar	VIP2
mojona	mojonar	VIP3
mojonamos	mojonar	VIP4
mojonáis	mojonar	VIP5
mojonan	mojonar	VIP6
mojonaba	mojonar	VII1
mojonabas	mojonar	VII2
mojonábamos	mojonar	VII4
mojonabais	mojonar	VII5
mojonaban	mojonar	VII6
mojonaré	mojonar	VIF1
mojonarás	mojonar	VIF2
mojonará	mojonar	VIF3
mojonaremos	mojonar	VIF4
mojonaréis	mojonar	VIF5
mojonarán	mojonar	VIF6
mojonaría	mojonar	VIC1
mojonarías	mojonar	VIC2
mojonaría	mojonar	VIC3
mojonaríamos	mojonar	VIC4
mojonaríais	mojonar	VIC5
mojonarían	mojonar	VIC6
mojoné	mojonar	VIX1
mojonaste	mojonar	VIX2
mojonó	mojonar	VIX3
mojonasteis	mojonar	VIX5
mojonaron	mojonar	VIX6
mojone	mojonar	VSP1
mojones	mojonar	VSP2
mojonemos	mojonar	VSP4
mojonéis	mojonar	VSP5
mojonen	mojonar	VSP6
mojonara	mojonar	VSX1
mojonaras	mojonar	VSX2
mojonáramos	mojonar	VSX4
mojonarais	mojonar	VSX5
mojonaran	mojonar	VSX6
mojonare	mojonar	VSF1
mojonares	mojonar	VSF2
mojonáremos	mojonar	VSF4
mojonareis	mojonar	VSF5
mojonaren	mojonar	VSF6
mojonase	mojonar	VSI1
mojonases	mojonar	VSI2
mojonásemos	mojonar	VSI4
mojonaseis	mojonar	VSI5
mojonasen	mojonar	VSI6
mojonad	mojonar	VMP
mojonadme	mojonar	VMSE
mojonadle	mojonar	VMSE
mojonadnos	mojonar	VMPE
mojonaos	mojonar	VMPE
mojonadles	mojonar	VMPE
mojonadlo	mojonar	VMMSE
mojonadla	mojonar	VMFSE
mojonadlos	mojonar	VMMPE
mojonadlas	mojonar	VMFPE
mojonádmelo	mojonar	VMMSE
mojonádselo	mojonar	VMMSE
mojonádnoslo	mojonar	VMMSE
mojonáoslo	mojonar	VMMSE
mojonádmelos	mojonar	VMMPE
mojonádselos	mojonar	VMMPE
mojonádnoslos	mojonar	VMMPE
mojonáoslos	mojonar	VMMPE
mojonádmela	mojonar	VMFSE
mojonádsela	mojonar	VMFSE
mojonádnosla	mojonar	VMFSE
mojonáosla	mojonar	VMFSE
mojonádmelas	mojonar	VMFPE
mojonádselas	mojonar	VMFPE
mojonádnoslas	mojonar	VMFPE
mojonáoslas	mojonar	VMFPE
mojonado	mojonar	VPM
mojonados	mojonar	VPMP
mojonada	mojonar	VPF
mojonadas	mojonar	VPFP
mojonando	mojonar	VG
mojonándome	mojonar	VGSE
mojonándote	mojonar	VGSE
mojonándole	mojonar	VGSE
mojonándonos	mojonar	VGPE
mojonándoos	mojonar	VGPE
mojonándolo	mojonar	VGMSE
mojonándola	mojonar	VGFSE
mojonándolos	mojonar	VGMPE
mojonándolas	mojonar	VGFPE
mojonándomelo	mojonar	VGMSE
mojonándotelo	mojonar	VGMSE
mojonándoselo	mojonar	VGMSE
mojonándonoslo	mojonar	VGMSE
mojonándooslo	mojonar	VGMSE
mojonándomelos	mojonar	VGMPE
mojonándotelos	mojonar	VGMPE
mojonándoselos	mojonar	VGMPE
mojonándonoslos	mojonar	VGMPE
mojonándooslos	mojonar	VGMPE
mojonándomela	mojonar	VGFSE
mojonándotela	mojonar	VGFSE
mojonándosela	mojonar	VGFSE
mojonándonosla	mojonar	VGFSE
mojonándoosla	mojonar	VGFSE
mojonándomelas	mojonar	VGFPE
mojonándotelas	mojonar	VGFPE
mojonándoselas	mojonar	VGFPE
mojonándonoslas	mojonar	VGFPE
mojonándooslas	mojonar	VGFPE
