mosaico	mosaico	O
mosaicas	mosaico	FP
mosaica	mosaico	F
mosaicos	mosaico	P
mosaiquista	mosaiquista	O
mosaiquistas	mosaiquista	P
mosaísmo	mosaísmo	O
mosaísmos	mosaísmo	P
mosca	mosca	O
moscas	mosca	P
moscabado	moscabado	O
moscabadas	moscabado	FP
moscabada	moscabado	F
moscada	moscada	O
moscadas	moscada	P
moscadero	moscadero	O
moscaderos	moscadero	P
moscarda	moscarda	O
moscardas	moscarda	P
moscardón	moscardón	O
moscardones	moscardón	P
moscareta	moscareta	O
moscaretas	moscareta	P
moscarrón	moscarrón	O
moscarrones	moscarrón	P
moscatel	moscatel	O
moscateles	moscatel	P
moscella	moscella	O
moscellas	moscella	P
mosco	mosco	O
moscas	mosco	FP
mosca	mosco	F
moscos	mosco	P
moscona	moscona	O
mosconas	moscona	P
mosconeo	mosconeo	O
mosconeos	mosconeo	P
moscorra	moscorra	O
moscorras	moscorra	P
moscovita	moscovita	O
moscovitas	moscovita	P
moscovítico	moscovítico	O
moscovíticas	moscovítico	FP
moscovítica	moscovítico	F
moscovíticos	moscovítico	P
moscón	moscón	O
moscones	moscón	P
mosolina	mosolina	O
mosolinas	mosolina	P
mosqueado	mosqueado	O
mosqueadas	mosqueado	FP
mosqueada	mosqueado	F
mosqueados	mosqueado	P
mosqueador	mosqueador	O
mosqueadores	mosqueador	P
mosqueo	mosqueo	O
mosqueos	mosqueo	P
mosquero	mosquero	O
mosqueros	mosquero	P
mosquerola	mosquerola	O
mosquerolas	mosquerola	P
mosqueruela	mosqueruela	O
mosqueruelas	mosqueruela	P
mosquerío	mosquerío	O
mosqueríos	mosquerío	P
mosqueta	mosqueta	O
mosquetas	mosqueta	P
mosquetazo	mosquetazo	O
mosquetazos	mosquetazo	P
mosquete	mosquete	O
mosquetes	mosquete	P
mosqueteril	mosqueteril	O
mosqueteriles	mosqueteril	P
mosquetero	mosquetero	O
mosqueteros	mosquetero	P
mosquetería	mosquetería	O
mosqueterías	mosquetería	P
mosquetón	mosquetón	O
mosquetones	mosquetón	P
mosquil	mosquil	O
mosquiles	mosquil	P
mosquillón	mosquillón	O
mosquillones	mosquillón	P
mosquino	mosquino	O
mosquinas	mosquino	FP
mosquina	mosquino	F
mosquinos	mosquino	P
mosquita	mosquita	O
mosquitas	mosquita	P
mosquitera	mosquitera	O
mosquiteras	mosquitera	P
mosquitero	mosquitero	O
mosquiteros	mosquitero	P
mosquito	mosquito	O
mosquitos	mosquito	P
mostacera	mostacera	O
mostaceras	mostacera	P
mostacero	mostacero	O
mostaceros	mostacero	P
mostacho	mostacho	O
mostachos	mostacho	P
mostachoso	mostachoso	O
mostachosas	mostachoso	FP
mostachosa	mostachoso	F
mostachosos	mostachoso	P
mostachón	mostachón	O
mostachones	mostachón	P
mostacilla	mostacilla	O
mostacillas	mostacilla	P
mostagán	mostagán	O
mostaganes	mostagán	P
mostajo	mostajo	O
mostajos	mostajo	P
mostaza	mostaza	O
mostazas	mostaza	P
mostazal	mostazal	O
mostazales	mostazal	P
mostazo	mostazo	O
mostazos	mostazo	P
moste	moste	O
mostes	moste	P
mostela	mostela	O
mostelas	mostela	P
mostelera	mostelera	O
mosteleras	mostelera	P
mostellar	mostellar	O
mostellares	mostellar	P
mostense	mostense	O
mostenses	mostense	P
mostillo	mostillo	O
mostillos	mostillo	P
mosto	mosto	O
mostos	mosto	P
mostrable	mostrable	O
mostrables	mostrable	P
mostración	mostración	O
mostraciones	mostración	P
mostrado	mostrado	O
mostradas	mostrado	FP
mostrada	mostrado	F
mostrados	mostrado	P
mostrador	mostrador	O
mostradoras	mostrador	FP
mostradora	mostrador	F
mostradores	mostrador	P
mostranza	mostranza	O
mostranzas	mostranza	P
mostrativo	mostrativo	O
mostrativas	mostrativo	FP
mostrativa	mostrativo	F
mostrativos	mostrativo	P
mostrenco	mostrenco	O
mostrencas	mostrenco	FP
mostrenca	mostrenco	F
mostrencos	mostrenco	P
mostro	mostro	O
mostros	mostro	P
mostén	mostén	O
mostenes	mostén	P
mosén	mosén	O
mosenes	mosén	P
moscar	moscar	O
mosco	moscar	VIP1
moscas	moscar	VIP2
mosca	moscar	VIP3
moscamos	moscar	VIP4
moscáis	moscar	VIP5
moscan	moscar	VIP6
moscaba	moscar	VII1
moscabas	moscar	VII2
moscábamos	moscar	VII4
moscabais	moscar	VII5
moscaban	moscar	VII6
moscaré	moscar	VIF1
moscarás	moscar	VIF2
moscará	moscar	VIF3
moscaremos	moscar	VIF4
moscaréis	moscar	VIF5
moscarán	moscar	VIF6
moscaría	moscar	VIC1
moscarías	moscar	VIC2
moscaría	moscar	VIC3
moscaríamos	moscar	VIC4
moscaríais	moscar	VIC5
moscarían	moscar	VIC6
mosqué	moscar	VIX1
moscaste	moscar	VIX2
moscó	moscar	VIX3
moscasteis	moscar	VIX5
moscaron	moscar	VIX6
mosque	moscar	VSP1
mosques	moscar	VSP2
mosquemos	moscar	VSP4
mosquéis	moscar	VSP5
mosquen	moscar	VSP6
moscara	moscar	VSX1
moscaras	moscar	VSX2
moscáramos	moscar	VSX4
moscarais	moscar	VSX5
moscaran	moscar	VSX6
moscare	moscar	VSF1
moscares	moscar	VSF2
moscáremos	moscar	VSF4
moscareis	moscar	VSF5
moscaren	moscar	VSF6
moscase	moscar	VSI1
moscases	moscar	VSI2
moscásemos	moscar	VSI4
moscaseis	moscar	VSI5
moscasen	moscar	VSI6
moscad	moscar	VMP
moscadme	moscar	VMSE
moscadle	moscar	VMSE
moscadnos	moscar	VMPE
moscaos	moscar	VMPE
moscadles	moscar	VMPE
moscadlo	moscar	VMMSE
moscadla	moscar	VMFSE
moscadlos	moscar	VMMPE
moscadlas	moscar	VMFPE
moscádmelo	moscar	VMMSE
moscádselo	moscar	VMMSE
moscádnoslo	moscar	VMMSE
moscáoslo	moscar	VMMSE
moscádmelos	moscar	VMMPE
moscádselos	moscar	VMMPE
moscádnoslos	moscar	VMMPE
moscáoslos	moscar	VMMPE
moscádmela	moscar	VMFSE
moscádsela	moscar	VMFSE
moscádnosla	moscar	VMFSE
moscáosla	moscar	VMFSE
moscádmelas	moscar	VMFPE
moscádselas	moscar	VMFPE
moscádnoslas	moscar	VMFPE
moscáoslas	moscar	VMFPE
moscado	moscar	VPM
moscados	moscar	VPMP
moscada	moscar	VPF
moscadas	moscar	VPFP
moscando	moscar	VG
moscándome	moscar	VGSE
moscándote	moscar	VGSE
moscándole	moscar	VGSE
moscándonos	moscar	VGPE
moscándoos	moscar	VGPE
moscándolo	moscar	VGMSE
moscándola	moscar	VGFSE
moscándolos	moscar	VGMPE
moscándolas	moscar	VGFPE
moscándomelo	moscar	VGMSE
moscándotelo	moscar	VGMSE
moscándoselo	moscar	VGMSE
moscándonoslo	moscar	VGMSE
moscándooslo	moscar	VGMSE
moscándomelos	moscar	VGMPE
moscándotelos	moscar	VGMPE
moscándoselos	moscar	VGMPE
moscándonoslos	moscar	VGMPE
moscándooslos	moscar	VGMPE
moscándomela	moscar	VGFSE
moscándotela	moscar	VGFSE
moscándosela	moscar	VGFSE
moscándonosla	moscar	VGFSE
moscándoosla	moscar	VGFSE
moscándomelas	moscar	VGFPE
moscándotelas	moscar	VGFPE
moscándoselas	moscar	VGFPE
moscándonoslas	moscar	VGFPE
moscándooslas	moscar	VGFPE
moscardear	moscardear	O
moscardeo	moscardear	VIP1
moscardeas	moscardear	VIP2
moscardea	moscardear	VIP3
moscardeamos	moscardear	VIP4
moscardeáis	moscardear	VIP5
moscardean	moscardear	VIP6
moscardeaba	moscardear	VII1
moscardeabas	moscardear	VII2
moscardeábamos	moscardear	VII4
moscardeabais	moscardear	VII5
moscardeaban	moscardear	VII6
moscardearé	moscardear	VIF1
moscardearás	moscardear	VIF2
moscardeará	moscardear	VIF3
moscardearemos	moscardear	VIF4
moscardearéis	moscardear	VIF5
moscardearán	moscardear	VIF6
moscardearía	moscardear	VIC1
moscardearías	moscardear	VIC2
moscardearía	moscardear	VIC3
moscardearíamos	moscardear	VIC4
moscardearíais	moscardear	VIC5
moscardearían	moscardear	VIC6
moscardeé	moscardear	VIX1
moscardeaste	moscardear	VIX2
moscardeó	moscardear	VIX3
moscardeasteis	moscardear	VIX5
moscardearon	moscardear	VIX6
moscardee	moscardear	VSP1
moscardees	moscardear	VSP2
moscardeemos	moscardear	VSP4
moscardeéis	moscardear	VSP5
moscardeen	moscardear	VSP6
moscardeara	moscardear	VSX1
moscardearas	moscardear	VSX2
moscardeáramos	moscardear	VSX4
moscardearais	moscardear	VSX5
moscardearan	moscardear	VSX6
moscardeare	moscardear	VSF1
moscardeares	moscardear	VSF2
moscardeáremos	moscardear	VSF4
moscardeareis	moscardear	VSF5
moscardearen	moscardear	VSF6
moscardease	moscardear	VSI1
moscardeases	moscardear	VSI2
moscardeásemos	moscardear	VSI4
moscardeaseis	moscardear	VSI5
moscardeasen	moscardear	VSI6
moscardead	moscardear	VMP
moscardeadme	moscardear	VMSE
moscardeadle	moscardear	VMSE
moscardeadnos	moscardear	VMPE
moscardeaos	moscardear	VMPE
moscardeadles	moscardear	VMPE
moscardeado	moscardear	VPM
moscardeados	moscardear	VPMP
moscardeada	moscardear	VPF
moscardeadas	moscardear	VPFP
moscardeando	moscardear	VG
moscardeándome	moscardear	VGSE
moscardeándote	moscardear	VGSE
moscardeándole	moscardear	VGSE
moscardeándonos	moscardear	VGPE
moscardeándoos	moscardear	VGPE
mosconear	mosconear	O
mosconeo	mosconear	VIP1
mosconeas	mosconear	VIP2
mosconea	mosconear	VIP3
mosconeamos	mosconear	VIP4
mosconeáis	mosconear	VIP5
mosconean	mosconear	VIP6
mosconeaba	mosconear	VII1
mosconeabas	mosconear	VII2
mosconeábamos	mosconear	VII4
mosconeabais	mosconear	VII5
mosconeaban	mosconear	VII6
mosconearé	mosconear	VIF1
mosconearás	mosconear	VIF2
mosconeará	mosconear	VIF3
mosconearemos	mosconear	VIF4
mosconearéis	mosconear	VIF5
mosconearán	mosconear	VIF6
mosconearía	mosconear	VIC1
mosconearías	mosconear	VIC2
mosconearía	mosconear	VIC3
mosconearíamos	mosconear	VIC4
mosconearíais	mosconear	VIC5
mosconearían	mosconear	VIC6
mosconeé	mosconear	VIX1
mosconeaste	mosconear	VIX2
mosconeó	mosconear	VIX3
mosconeasteis	mosconear	VIX5
mosconearon	mosconear	VIX6
mosconee	mosconear	VSP1
mosconees	mosconear	VSP2
mosconeemos	mosconear	VSP4
mosconeéis	mosconear	VSP5
mosconeen	mosconear	VSP6
mosconeara	mosconear	VSX1
mosconearas	mosconear	VSX2
mosconeáramos	mosconear	VSX4
mosconearais	mosconear	VSX5
mosconearan	mosconear	VSX6
mosconeare	mosconear	VSF1
mosconeares	mosconear	VSF2
mosconeáremos	mosconear	VSF4
mosconeareis	mosconear	VSF5
mosconearen	mosconear	VSF6
mosconease	mosconear	VSI1
mosconeases	mosconear	VSI2
mosconeásemos	mosconear	VSI4
mosconeaseis	mosconear	VSI5
mosconeasen	mosconear	VSI6
mosconead	mosconear	VMP
mosconeadme	mosconear	VMSE
mosconeadle	mosconear	VMSE
mosconeadnos	mosconear	VMPE
mosconeaos	mosconear	VMPE
mosconeadles	mosconear	VMPE
mosconeadlo	mosconear	VMMSE
mosconeadla	mosconear	VMFSE
mosconeadlos	mosconear	VMMPE
mosconeadlas	mosconear	VMFPE
mosconeádmelo	mosconear	VMMSE
mosconeádselo	mosconear	VMMSE
mosconeádnoslo	mosconear	VMMSE
mosconeáoslo	mosconear	VMMSE
mosconeádmelos	mosconear	VMMPE
mosconeádselos	mosconear	VMMPE
mosconeádnoslos	mosconear	VMMPE
mosconeáoslos	mosconear	VMMPE
mosconeádmela	mosconear	VMFSE
mosconeádsela	mosconear	VMFSE
mosconeádnosla	mosconear	VMFSE
mosconeáosla	mosconear	VMFSE
mosconeádmelas	mosconear	VMFPE
mosconeádselas	mosconear	VMFPE
mosconeádnoslas	mosconear	VMFPE
mosconeáoslas	mosconear	VMFPE
mosconeado	mosconear	VPM
mosconeados	mosconear	VPMP
mosconeada	mosconear	VPF
mosconeadas	mosconear	VPFP
mosconeando	mosconear	VG
mosconeándome	mosconear	VGSE
mosconeándote	mosconear	VGSE
mosconeándole	mosconear	VGSE
mosconeándonos	mosconear	VGPE
mosconeándoos	mosconear	VGPE
mosconeándolo	mosconear	VGMSE
mosconeándola	mosconear	VGFSE
mosconeándolos	mosconear	VGMPE
mosconeándolas	mosconear	VGFPE
mosconeándomelo	mosconear	VGMSE
mosconeándotelo	mosconear	VGMSE
mosconeándoselo	mosconear	VGMSE
mosconeándonoslo	mosconear	VGMSE
mosconeándooslo	mosconear	VGMSE
mosconeándomelos	mosconear	VGMPE
mosconeándotelos	mosconear	VGMPE
mosconeándoselos	mosconear	VGMPE
mosconeándonoslos	mosconear	VGMPE
mosconeándooslos	mosconear	VGMPE
mosconeándomela	mosconear	VGFSE
mosconeándotela	mosconear	VGFSE
mosconeándosela	mosconear	VGFSE
mosconeándonosla	mosconear	VGFSE
mosconeándoosla	mosconear	VGFSE
mosconeándomelas	mosconear	VGFPE
mosconeándotelas	mosconear	VGFPE
mosconeándoselas	mosconear	VGFPE
mosconeándonoslas	mosconear	VGFPE
mosconeándooslas	mosconear	VGFPE
mosquear	mosquear	O
mosqueo	mosquear	VIP1
mosqueas	mosquear	VIP2
mosquea	mosquear	VIP3
mosqueamos	mosquear	VIP4
mosqueáis	mosquear	VIP5
mosquean	mosquear	VIP6
mosqueaba	mosquear	VII1
mosqueabas	mosquear	VII2
mosqueábamos	mosquear	VII4
mosqueabais	mosquear	VII5
mosqueaban	mosquear	VII6
mosquearé	mosquear	VIF1
mosquearás	mosquear	VIF2
mosqueará	mosquear	VIF3
mosquearemos	mosquear	VIF4
mosquearéis	mosquear	VIF5
mosquearán	mosquear	VIF6
mosquearía	mosquear	VIC1
mosquearías	mosquear	VIC2
mosquearía	mosquear	VIC3
mosquearíamos	mosquear	VIC4
mosquearíais	mosquear	VIC5
mosquearían	mosquear	VIC6
mosqueé	mosquear	VIX1
mosqueaste	mosquear	VIX2
mosqueó	mosquear	VIX3
mosqueasteis	mosquear	VIX5
mosquearon	mosquear	VIX6
mosquee	mosquear	VSP1
mosquees	mosquear	VSP2
mosqueemos	mosquear	VSP4
mosqueéis	mosquear	VSP5
mosqueen	mosquear	VSP6
mosqueara	mosquear	VSX1
mosquearas	mosquear	VSX2
mosqueáramos	mosquear	VSX4
mosquearais	mosquear	VSX5
mosquearan	mosquear	VSX6
mosqueare	mosquear	VSF1
mosqueares	mosquear	VSF2
mosqueáremos	mosquear	VSF4
mosqueareis	mosquear	VSF5
mosquearen	mosquear	VSF6
mosquease	mosquear	VSI1
mosqueases	mosquear	VSI2
mosqueásemos	mosquear	VSI4
mosqueaseis	mosquear	VSI5
mosqueasen	mosquear	VSI6
mosquead	mosquear	VMP
mosqueadme	mosquear	VMSE
mosqueadle	mosquear	VMSE
mosqueadnos	mosquear	VMPE
mosqueaos	mosquear	VMPE
mosqueadles	mosquear	VMPE
mosqueadlo	mosquear	VMMSE
mosqueadla	mosquear	VMFSE
mosqueadlos	mosquear	VMMPE
mosqueadlas	mosquear	VMFPE
mosqueádmelo	mosquear	VMMSE
mosqueádselo	mosquear	VMMSE
mosqueádnoslo	mosquear	VMMSE
mosqueáoslo	mosquear	VMMSE
mosqueádmelos	mosquear	VMMPE
mosqueádselos	mosquear	VMMPE
mosqueádnoslos	mosquear	VMMPE
mosqueáoslos	mosquear	VMMPE
mosqueádmela	mosquear	VMFSE
mosqueádsela	mosquear	VMFSE
mosqueádnosla	mosquear	VMFSE
mosqueáosla	mosquear	VMFSE
mosqueádmelas	mosquear	VMFPE
mosqueádselas	mosquear	VMFPE
mosqueádnoslas	mosquear	VMFPE
mosqueáoslas	mosquear	VMFPE
mosqueado	mosquear	VPM
mosqueados	mosquear	VPMP
mosqueada	mosquear	VPF
mosqueadas	mosquear	VPFP
mosqueando	mosquear	VG
mosqueándome	mosquear	VGSE
mosqueándote	mosquear	VGSE
mosqueándole	mosquear	VGSE
mosqueándonos	mosquear	VGPE
mosqueándoos	mosquear	VGPE
mosqueándolo	mosquear	VGMSE
mosqueándola	mosquear	VGFSE
mosqueándolos	mosquear	VGMPE
mosqueándolas	mosquear	VGFPE
mosqueándomelo	mosquear	VGMSE
mosqueándotelo	mosquear	VGMSE
mosqueándoselo	mosquear	VGMSE
mosqueándonoslo	mosquear	VGMSE
mosqueándooslo	mosquear	VGMSE
mosqueándomelos	mosquear	VGMPE
mosqueándotelos	mosquear	VGMPE
mosqueándoselos	mosquear	VGMPE
mosqueándonoslos	mosquear	VGMPE
mosqueándooslos	mosquear	VGMPE
mosqueándomela	mosquear	VGFSE
mosqueándotela	mosquear	VGFSE
mosqueándosela	mosquear	VGFSE
mosqueándonosla	mosquear	VGFSE
mosqueándoosla	mosquear	VGFSE
mosqueándomelas	mosquear	VGFPE
mosqueándotelas	mosquear	VGFPE
mosqueándoselas	mosquear	VGFPE
mosqueándonoslas	mosquear	VGFPE
mosqueándooslas	mosquear	VGFPE
mostear	mostear	O
mosteo	mostear	VIP1
mosteas	mostear	VIP2
mostea	mostear	VIP3
mosteamos	mostear	VIP4
mosteáis	mostear	VIP5
mostean	mostear	VIP6
mosteaba	mostear	VII1
mosteabas	mostear	VII2
mosteábamos	mostear	VII4
mosteabais	mostear	VII5
mosteaban	mostear	VII6
mostearé	mostear	VIF1
mostearás	mostear	VIF2
mosteará	mostear	VIF3
mostearemos	mostear	VIF4
mostearéis	mostear	VIF5
mostearán	mostear	VIF6
mostearía	mostear	VIC1
mostearías	mostear	VIC2
mostearía	mostear	VIC3
mostearíamos	mostear	VIC4
mostearíais	mostear	VIC5
mostearían	mostear	VIC6
mosteé	mostear	VIX1
mosteaste	mostear	VIX2
mosteó	mostear	VIX3
mosteasteis	mostear	VIX5
mostearon	mostear	VIX6
mostee	mostear	VSP1
mostees	mostear	VSP2
mosteemos	mostear	VSP4
mosteéis	mostear	VSP5
mosteen	mostear	VSP6
mosteara	mostear	VSX1
mostearas	mostear	VSX2
mosteáramos	mostear	VSX4
mostearais	mostear	VSX5
mostearan	mostear	VSX6
mosteare	mostear	VSF1
mosteares	mostear	VSF2
mosteáremos	mostear	VSF4
mosteareis	mostear	VSF5
mostearen	mostear	VSF6
mostease	mostear	VSI1
mosteases	mostear	VSI2
mosteásemos	mostear	VSI4
mosteaseis	mostear	VSI5
mosteasen	mostear	VSI6
mostead	mostear	VMP
mosteadme	mostear	VMSE
mosteadle	mostear	VMSE
mosteadnos	mostear	VMPE
mosteaos	mostear	VMPE
mosteadles	mostear	VMPE
mosteadlo	mostear	VMMSE
mosteadla	mostear	VMFSE
mosteadlos	mostear	VMMPE
mosteadlas	mostear	VMFPE
mosteádmelo	mostear	VMMSE
mosteádselo	mostear	VMMSE
mosteádnoslo	mostear	VMMSE
mosteáoslo	mostear	VMMSE
mosteádmelos	mostear	VMMPE
mosteádselos	mostear	VMMPE
mosteádnoslos	mostear	VMMPE
mosteáoslos	mostear	VMMPE
mosteádmela	mostear	VMFSE
mosteádsela	mostear	VMFSE
mosteádnosla	mostear	VMFSE
mosteáosla	mostear	VMFSE
mosteádmelas	mostear	VMFPE
mosteádselas	mostear	VMFPE
mosteádnoslas	mostear	VMFPE
mosteáoslas	mostear	VMFPE
mosteado	mostear	VPM
mosteados	mostear	VPMP
mosteada	mostear	VPF
mosteadas	mostear	VPFP
mosteando	mostear	VG
mosteándome	mostear	VGSE
mosteándote	mostear	VGSE
mosteándole	mostear	VGSE
mosteándonos	mostear	VGPE
mosteándoos	mostear	VGPE
mosteándolo	mostear	VGMSE
mosteándola	mostear	VGFSE
mosteándolos	mostear	VGMPE
mosteándolas	mostear	VGFPE
mosteándomelo	mostear	VGMSE
mosteándotelo	mostear	VGMSE
mosteándoselo	mostear	VGMSE
mosteándonoslo	mostear	VGMSE
mosteándooslo	mostear	VGMSE
mosteándomelos	mostear	VGMPE
mosteándotelos	mostear	VGMPE
mosteándoselos	mostear	VGMPE
mosteándonoslos	mostear	VGMPE
mosteándooslos	mostear	VGMPE
mosteándomela	mostear	VGFSE
mosteándotela	mostear	VGFSE
mosteándosela	mostear	VGFSE
mosteándonosla	mostear	VGFSE
mosteándoosla	mostear	VGFSE
mosteándomelas	mostear	VGFPE
mosteándotelas	mostear	VGFPE
mosteándoselas	mostear	VGFPE
mosteándonoslas	mostear	VGFPE
mosteándooslas	mostear	VGFPE
mostrar	mostrar	O
mostramos	mostrar	VIP4
mostráis	mostrar	VIP5
mostraba	mostrar	VII1
mostrabas	mostrar	VII2
mostrábamos	mostrar	VII4
mostrabais	mostrar	VII5
mostraban	mostrar	VII6
mostraré	mostrar	VIF1
mostrarás	mostrar	VIF2
mostrará	mostrar	VIF3
mostraremos	mostrar	VIF4
mostraréis	mostrar	VIF5
mostrarán	mostrar	VIF6
mostraría	mostrar	VIC1
mostrarías	mostrar	VIC2
mostraría	mostrar	VIC3
mostraríamos	mostrar	VIC4
mostraríais	mostrar	VIC5
mostrarían	mostrar	VIC6
mostré	mostrar	VIX1
mostraste	mostrar	VIX2
mostró	mostrar	VIX3
mostrasteis	mostrar	VIX5
mostraron	mostrar	VIX6
mostremos	mostrar	VSP4
mostréis	mostrar	VSP5
mostrara	mostrar	VSX1
mostraras	mostrar	VSX2
mostráramos	mostrar	VSX4
mostrarais	mostrar	VSX5
mostraran	mostrar	VSX6
mostrare	mostrar	VSF1
mostrares	mostrar	VSF2
mostráremos	mostrar	VSF4
mostrareis	mostrar	VSF5
mostraren	mostrar	VSF6
mostrase	mostrar	VSI1
mostrases	mostrar	VSI2
mostrásemos	mostrar	VSI4
mostraseis	mostrar	VSI5
mostrasen	mostrar	VSI6
mostrad	mostrar	VMP
mostradme	mostrar	VMSE
mostradle	mostrar	VMSE
mostradnos	mostrar	VMPE
mostraos	mostrar	VMPE
mostradles	mostrar	VMPE
mostradlo	mostrar	VMMSE
mostradla	mostrar	VMFSE
mostradlos	mostrar	VMMPE
mostradlas	mostrar	VMFPE
mostrádmelo	mostrar	VMMSE
mostrádselo	mostrar	VMMSE
mostrádnoslo	mostrar	VMMSE
mostráoslo	mostrar	VMMSE
mostrádmelos	mostrar	VMMPE
mostrádselos	mostrar	VMMPE
mostrádnoslos	mostrar	VMMPE
mostráoslos	mostrar	VMMPE
mostrádmela	mostrar	VMFSE
mostrádsela	mostrar	VMFSE
mostrádnosla	mostrar	VMFSE
mostráosla	mostrar	VMFSE
mostrádmelas	mostrar	VMFPE
mostrádselas	mostrar	VMFPE
mostrádnoslas	mostrar	VMFPE
mostráoslas	mostrar	VMFPE
mostrado	mostrar	VPM
mostrados	mostrar	VPMP
mostrada	mostrar	VPF
mostradas	mostrar	VPFP
mostrando	mostrar	VG
mostrándome	mostrar	VGSE
mostrándote	mostrar	VGSE
mostrándole	mostrar	VGSE
mostrándonos	mostrar	VGPE
mostrándoos	mostrar	VGPE
mostrándolo	mostrar	VGMSE
mostrándola	mostrar	VGFSE
mostrándolos	mostrar	VGMPE
mostrándolas	mostrar	VGFPE
mostrándomelo	mostrar	VGMSE
mostrándotelo	mostrar	VGMSE
mostrándoselo	mostrar	VGMSE
mostrándonoslo	mostrar	VGMSE
mostrándooslo	mostrar	VGMSE
mostrándomelos	mostrar	VGMPE
mostrándotelos	mostrar	VGMPE
mostrándoselos	mostrar	VGMPE
mostrándonoslos	mostrar	VGMPE
mostrándooslos	mostrar	VGMPE
mostrándomela	mostrar	VGFSE
mostrándotela	mostrar	VGFSE
mostrándosela	mostrar	VGFSE
mostrándonosla	mostrar	VGFSE
mostrándoosla	mostrar	VGFSE
mostrándomelas	mostrar	VGFPE
mostrándotelas	mostrar	VGFPE
mostrándoselas	mostrar	VGFPE
mostrándonoslas	mostrar	VGFPE
mostrándooslas	mostrar	VGFPE
