mur	mur	O
mures	mur	P
mura	mura	O
muras	mura	P
muradal	muradal	O
muradales	muradal	P
murador	murador	O
muradoras	murador	FP
muradora	murador	F
muradores	murador	P
murajes	murajes	O
mural	mural	O
murales	mural	P
muralismo	muralismo	O
muralismos	muralismo	P
muralista	muralista	O
muralistas	muralista	P
muralla	muralla	O
murallas	muralla	P
murallón	murallón	O
murallones	murallón	P
murceguillo	murceguillo	O
murceguillos	murceguillo	P
murceo	murceo	O
murceos	murceo	P
murciano	murciano	O
murcianas	murciano	FP
murciana	murciano	F
murcianos	murciano	P
murcielaguina	murcielaguina	O
murcielaguinas	murcielaguina	P
murcigallero	murcigallero	O
murcigalleros	murcigallero	P
murciglero	murciglero	O
murcigleros	murciglero	P
murcio	murcio	O
murcios	murcio	P
murciégalo	murciégalo	O
murciégalos	murciégalo	P
murciélago	murciélago	O
murciélagos	murciélago	P
murecillo	murecillo	O
murecillos	murecillo	P
murena	murena	O
murenas	murena	P
mureño	mureño	O
mureños	mureño	P
murga	murga	O
murgas	murga	P
murgaño	murgaño	O
murgaños	murgaño	P
murguista	murguista	O
murguistas	murguista	P
murgón	murgón	O
murgones	murgón	P
muria	muria	O
murias	muria	P
muriacita	muriacita	O
muriacitas	muriacita	P
muriato	muriato	O
muriatos	muriato	P
muriático	muriático	O
muriáticos	muriático	P
murmullo	murmullo	O
murmullos	murmullo	P
murmuración	murmuración	O
murmuraciones	murmuración	P
murmurador	murmurador	O
murmuradoras	murmurador	FP
murmuradora	murmurador	F
murmuradores	murmurador	P
murmureo	murmureo	O
murmureos	murmureo	P
murmurio	murmurio	O
murmurios	murmurio	P
muro	muro	O
muros	muro	P
murria	murria	O
murrias	murria	P
murriada	murriada	O
murriadas	murriada	P
murrino	murrino	O
murrinos	murrino	P
murrio	murrio	O
murrias	murrio	FP
murria	murrio	F
murrios	murrio	P
murta	murta	O
murtas	murta	P
murtal	murtal	O
murtales	murtal	P
murtilla	murtilla	O
murtillas	murtilla	P
murtina	murtina	O
murtinas	murtina	P
murto	murto	O
murtos	murto	P
murtón	murtón	O
murtones	murtón	P
murucuyá	murucuyá	O
murucuyás	murucuyá	P
murueco	murueco	O
muruecos	murueco	P
murviedrés	murviedrés	O
murviedresas	murviedrés	FP
murviedresa	murviedrés	F
murviedreses	murviedrés	P
múrice	múrice	O
múrices	múrice	P
múrido	múrido	O
múridos	múrido	P
múrrino	múrrino	O
múrrinas	múrrino	FP
múrrina	múrrino	F
múrrinos	múrrino	P
murió	morir	VIX3
murieron	morir	VIX6
muramos	morir	VSP4
muráis	morir	VSP5
muriera	morir	VSX1
murieras	morir	VSX2
muriéramos	morir	VSX4
murierais	morir	VSX5
murieran	morir	VSX6
muriere	morir	VSF1
murieres	morir	VSF2
muriéremos	morir	VSF4
muriereis	morir	VSF5
murieren	morir	VSF6
muriese	morir	VSI1
murieses	morir	VSI2
muriésemos	morir	VSI4
murieseis	morir	VSI5
muriesen	morir	VSI6
muriendo	morir	VG
muriéndome	morir	VGSE
muriéndote	morir	VGSE
muriéndole	morir	VGSE
muriéndonos	morir	VGPE
muriéndoos	morir	VGPE
muriéndolo	morir	VGMSE
muriéndola	morir	VGFSE
muriéndolos	morir	VGMPE
muriéndolas	morir	VGFPE
muriéndomelo	morir	VGMSE
muriéndotelo	morir	VGMSE
muriéndoselo	morir	VGMSE
muriéndonoslo	morir	VGMSE
muriéndooslo	morir	VGMSE
muriéndomelos	morir	VGMPE
muriéndotelos	morir	VGMPE
muriéndoselos	morir	VGMPE
muriéndonoslos	morir	VGMPE
muriéndooslos	morir	VGMPE
muriéndomela	morir	VGFSE
muriéndotela	morir	VGFSE
muriéndosela	morir	VGFSE
muriéndonosla	morir	VGFSE
muriéndoosla	morir	VGFSE
muriéndomelas	morir	VGFPE
muriéndotelas	morir	VGFPE
muriéndoselas	morir	VGFPE
muriéndonoslas	morir	VGFPE
muriéndooslas	morir	VGFPE
murar	murar	O
muro	murar	VIP1
muras	murar	VIP2
mura	murar	VIP3
muramos	murar	VIP4
muráis	murar	VIP5
muran	murar	VIP6
muraba	murar	VII1
murabas	murar	VII2
murábamos	murar	VII4
murabais	murar	VII5
muraban	murar	VII6
muraré	murar	VIF1
murarás	murar	VIF2
murará	murar	VIF3
muraremos	murar	VIF4
muraréis	murar	VIF5
murarán	murar	VIF6
muraría	murar	VIC1
murarías	murar	VIC2
muraría	murar	VIC3
muraríamos	murar	VIC4
muraríais	murar	VIC5
murarían	murar	VIC6
muré	murar	VIX1
muraste	murar	VIX2
muró	murar	VIX3
murasteis	murar	VIX5
muraron	murar	VIX6
mure	murar	VSP1
mures	murar	VSP2
muremos	murar	VSP4
muréis	murar	VSP5
muren	murar	VSP6
murara	murar	VSX1
muraras	murar	VSX2
muráramos	murar	VSX4
murarais	murar	VSX5
muraran	murar	VSX6
murare	murar	VSF1
murares	murar	VSF2
muráremos	murar	VSF4
murareis	murar	VSF5
muraren	murar	VSF6
murase	murar	VSI1
murases	murar	VSI2
murásemos	murar	VSI4
muraseis	murar	VSI5
murasen	murar	VSI6
murad	murar	VMP
muradme	murar	VMSE
muradle	murar	VMSE
muradnos	murar	VMPE
muraos	murar	VMPE
muradles	murar	VMPE
muradlo	murar	VMMSE
muradla	murar	VMFSE
muradlos	murar	VMMPE
muradlas	murar	VMFPE
murádmelo	murar	VMMSE
murádselo	murar	VMMSE
murádnoslo	murar	VMMSE
muráoslo	murar	VMMSE
murádmelos	murar	VMMPE
murádselos	murar	VMMPE
murádnoslos	murar	VMMPE
muráoslos	murar	VMMPE
murádmela	murar	VMFSE
murádsela	murar	VMFSE
murádnosla	murar	VMFSE
muráosla	murar	VMFSE
murádmelas	murar	VMFPE
murádselas	murar	VMFPE
murádnoslas	murar	VMFPE
muráoslas	murar	VMFPE
murado	murar	VPM
murados	murar	VPMP
murada	murar	VPF
muradas	murar	VPFP
murando	murar	VG
murándome	murar	VGSE
murándote	murar	VGSE
murándole	murar	VGSE
murándonos	murar	VGPE
murándoos	murar	VGPE
murándolo	murar	VGMSE
murándola	murar	VGFSE
murándolos	murar	VGMPE
murándolas	murar	VGFPE
murándomelo	murar	VGMSE
murándotelo	murar	VGMSE
murándoselo	murar	VGMSE
murándonoslo	murar	VGMSE
murándooslo	murar	VGMSE
murándomelos	murar	VGMPE
murándotelos	murar	VGMPE
murándoselos	murar	VGMPE
murándonoslos	murar	VGMPE
murándooslos	murar	VGMPE
murándomela	murar	VGFSE
murándotela	murar	VGFSE
murándosela	murar	VGFSE
murándonosla	murar	VGFSE
murándoosla	murar	VGFSE
murándomelas	murar	VGFPE
murándotelas	murar	VGFPE
murándoselas	murar	VGFPE
murándonoslas	murar	VGFPE
murándooslas	murar	VGFPE
murciar	murciar	O
murcio	murciar	VIP1
murcias	murciar	VIP2
murcia	murciar	VIP3
murciamos	murciar	VIP4
murciáis	murciar	VIP5
murcian	murciar	VIP6
murciaba	murciar	VII1
murciabas	murciar	VII2
murciábamos	murciar	VII4
murciabais	murciar	VII5
murciaban	murciar	VII6
murciaré	murciar	VIF1
murciarás	murciar	VIF2
murciará	murciar	VIF3
murciaremos	murciar	VIF4
murciaréis	murciar	VIF5
murciarán	murciar	VIF6
murciaría	murciar	VIC1
murciarías	murciar	VIC2
murciaría	murciar	VIC3
murciaríamos	murciar	VIC4
murciaríais	murciar	VIC5
murciarían	murciar	VIC6
murcié	murciar	VIX1
murciaste	murciar	VIX2
murció	murciar	VIX3
murciasteis	murciar	VIX5
murciaron	murciar	VIX6
murcie	murciar	VSP1
murcies	murciar	VSP2
murciemos	murciar	VSP4
murciéis	murciar	VSP5
murcien	murciar	VSP6
murciara	murciar	VSX1
murciaras	murciar	VSX2
murciáramos	murciar	VSX4
murciarais	murciar	VSX5
murciaran	murciar	VSX6
murciare	murciar	VSF1
murciares	murciar	VSF2
murciáremos	murciar	VSF4
murciareis	murciar	VSF5
murciaren	murciar	VSF6
murciase	murciar	VSI1
murciases	murciar	VSI2
murciásemos	murciar	VSI4
murciaseis	murciar	VSI5
murciasen	murciar	VSI6
murciad	murciar	VMP
murciadme	murciar	VMSE
murciadle	murciar	VMSE
murciadnos	murciar	VMPE
murciaos	murciar	VMPE
murciadles	murciar	VMPE
murciadlo	murciar	VMMSE
murciadla	murciar	VMFSE
murciadlos	murciar	VMMPE
murciadlas	murciar	VMFPE
murciádmelo	murciar	VMMSE
murciádselo	murciar	VMMSE
murciádnoslo	murciar	VMMSE
murciáoslo	murciar	VMMSE
murciádmelos	murciar	VMMPE
murciádselos	murciar	VMMPE
murciádnoslos	murciar	VMMPE
murciáoslos	murciar	VMMPE
murciádmela	murciar	VMFSE
murciádsela	murciar	VMFSE
murciádnosla	murciar	VMFSE
murciáosla	murciar	VMFSE
murciádmelas	murciar	VMFPE
murciádselas	murciar	VMFPE
murciádnoslas	murciar	VMFPE
murciáoslas	murciar	VMFPE
murciado	murciar	VPM
murciados	murciar	VPMP
murciada	murciar	VPF
murciadas	murciar	VPFP
murciando	murciar	VG
murciándome	murciar	VGSE
murciándote	murciar	VGSE
murciándole	murciar	VGSE
murciándonos	murciar	VGPE
murciándoos	murciar	VGPE
murciándolo	murciar	VGMSE
murciándola	murciar	VGFSE
murciándolos	murciar	VGMPE
murciándolas	murciar	VGFPE
murciándomelo	murciar	VGMSE
murciándotelo	murciar	VGMSE
murciándoselo	murciar	VGMSE
murciándonoslo	murciar	VGMSE
murciándooslo	murciar	VGMSE
murciándomelos	murciar	VGMPE
murciándotelos	murciar	VGMPE
murciándoselos	murciar	VGMPE
murciándonoslos	murciar	VGMPE
murciándooslos	murciar	VGMPE
murciándomela	murciar	VGFSE
murciándotela	murciar	VGFSE
murciándosela	murciar	VGFSE
murciándonosla	murciar	VGFSE
murciándoosla	murciar	VGFSE
murciándomelas	murciar	VGFPE
murciándotelas	murciar	VGFPE
murciándoselas	murciar	VGFPE
murciándonoslas	murciar	VGFPE
murciándooslas	murciar	VGFPE
murgular	murgular	O
murgulo	murgular	VIP1
murgulas	murgular	VIP2
murgula	murgular	VIP3
murgulamos	murgular	VIP4
murguláis	murgular	VIP5
murgulan	murgular	VIP6
murgulaba	murgular	VII1
murgulabas	murgular	VII2
murgulábamos	murgular	VII4
murgulabais	murgular	VII5
murgulaban	murgular	VII6
murgularé	murgular	VIF1
murgularás	murgular	VIF2
murgulará	murgular	VIF3
murgularemos	murgular	VIF4
murgularéis	murgular	VIF5
murgularán	murgular	VIF6
murgularía	murgular	VIC1
murgularías	murgular	VIC2
murgularía	murgular	VIC3
murgularíamos	murgular	VIC4
murgularíais	murgular	VIC5
murgularían	murgular	VIC6
murgulé	murgular	VIX1
murgulaste	murgular	VIX2
murguló	murgular	VIX3
murgulasteis	murgular	VIX5
murgularon	murgular	VIX6
murgule	murgular	VSP1
murgules	murgular	VSP2
murgulemos	murgular	VSP4
murguléis	murgular	VSP5
murgulen	murgular	VSP6
murgulara	murgular	VSX1
murgularas	murgular	VSX2
murguláramos	murgular	VSX4
murgularais	murgular	VSX5
murgularan	murgular	VSX6
murgulare	murgular	VSF1
murgulares	murgular	VSF2
murguláremos	murgular	VSF4
murgulareis	murgular	VSF5
murgularen	murgular	VSF6
murgulase	murgular	VSI1
murgulases	murgular	VSI2
murgulásemos	murgular	VSI4
murgulaseis	murgular	VSI5
murgulasen	murgular	VSI6
murgulad	murgular	VMP
murguladme	murgular	VMSE
murguladle	murgular	VMSE
murguladnos	murgular	VMPE
murgulaos	murgular	VMPE
murguladles	murgular	VMPE
murguladlo	murgular	VMMSE
murguladla	murgular	VMFSE
murguladlos	murgular	VMMPE
murguladlas	murgular	VMFPE
murguládmelo	murgular	VMMSE
murguládselo	murgular	VMMSE
murguládnoslo	murgular	VMMSE
murguláoslo	murgular	VMMSE
murguládmelos	murgular	VMMPE
murguládselos	murgular	VMMPE
murguládnoslos	murgular	VMMPE
murguláoslos	murgular	VMMPE
murguládmela	murgular	VMFSE
murguládsela	murgular	VMFSE
murguládnosla	murgular	VMFSE
murguláosla	murgular	VMFSE
murguládmelas	murgular	VMFPE
murguládselas	murgular	VMFPE
murguládnoslas	murgular	VMFPE
murguláoslas	murgular	VMFPE
murgulado	murgular	VPM
murgulados	murgular	VPMP
murgulada	murgular	VPF
murguladas	murgular	VPFP
murgulando	murgular	VG
murgulándome	murgular	VGSE
murgulándote	murgular	VGSE
murgulándole	murgular	VGSE
murgulándonos	murgular	VGPE
murgulándoos	murgular	VGPE
murgulándolo	murgular	VGMSE
murgulándola	murgular	VGFSE
murgulándolos	murgular	VGMPE
murgulándolas	murgular	VGFPE
murgulándomelo	murgular	VGMSE
murgulándotelo	murgular	VGMSE
murgulándoselo	murgular	VGMSE
murgulándonoslo	murgular	VGMSE
murgulándooslo	murgular	VGMSE
murgulándomelos	murgular	VGMPE
murgulándotelos	murgular	VGMPE
murgulándoselos	murgular	VGMPE
murgulándonoslos	murgular	VGMPE
murgulándooslos	murgular	VGMPE
murgulándomela	murgular	VGFSE
murgulándotela	murgular	VGFSE
murgulándosela	murgular	VGFSE
murgulándonosla	murgular	VGFSE
murgulándoosla	murgular	VGFSE
murgulándomelas	murgular	VGFPE
murgulándotelas	murgular	VGFPE
murgulándoselas	murgular	VGFPE
murgulándonoslas	murgular	VGFPE
murgulándooslas	murgular	VGFPE
murmujear	murmujear	O
murmujeo	murmujear	VIP1
murmujeas	murmujear	VIP2
murmujea	murmujear	VIP3
murmujeamos	murmujear	VIP4
murmujeáis	murmujear	VIP5
murmujean	murmujear	VIP6
murmujeaba	murmujear	VII1
murmujeabas	murmujear	VII2
murmujeábamos	murmujear	VII4
murmujeabais	murmujear	VII5
murmujeaban	murmujear	VII6
murmujearé	murmujear	VIF1
murmujearás	murmujear	VIF2
murmujeará	murmujear	VIF3
murmujearemos	murmujear	VIF4
murmujearéis	murmujear	VIF5
murmujearán	murmujear	VIF6
murmujearía	murmujear	VIC1
murmujearías	murmujear	VIC2
murmujearía	murmujear	VIC3
murmujearíamos	murmujear	VIC4
murmujearíais	murmujear	VIC5
murmujearían	murmujear	VIC6
murmujeé	murmujear	VIX1
murmujeaste	murmujear	VIX2
murmujeó	murmujear	VIX3
murmujeasteis	murmujear	VIX5
murmujearon	murmujear	VIX6
murmujee	murmujear	VSP1
murmujees	murmujear	VSP2
murmujeemos	murmujear	VSP4
murmujeéis	murmujear	VSP5
murmujeen	murmujear	VSP6
murmujeara	murmujear	VSX1
murmujearas	murmujear	VSX2
murmujeáramos	murmujear	VSX4
murmujearais	murmujear	VSX5
murmujearan	murmujear	VSX6
murmujeare	murmujear	VSF1
murmujeares	murmujear	VSF2
murmujeáremos	murmujear	VSF4
murmujeareis	murmujear	VSF5
murmujearen	murmujear	VSF6
murmujease	murmujear	VSI1
murmujeases	murmujear	VSI2
murmujeásemos	murmujear	VSI4
murmujeaseis	murmujear	VSI5
murmujeasen	murmujear	VSI6
murmujead	murmujear	VMP
murmujeadme	murmujear	VMSE
murmujeadle	murmujear	VMSE
murmujeadnos	murmujear	VMPE
murmujeaos	murmujear	VMPE
murmujeadles	murmujear	VMPE
murmujeadlo	murmujear	VMMSE
murmujeadla	murmujear	VMFSE
murmujeadlos	murmujear	VMMPE
murmujeadlas	murmujear	VMFPE
murmujeádmelo	murmujear	VMMSE
murmujeádselo	murmujear	VMMSE
murmujeádnoslo	murmujear	VMMSE
murmujeáoslo	murmujear	VMMSE
murmujeádmelos	murmujear	VMMPE
murmujeádselos	murmujear	VMMPE
murmujeádnoslos	murmujear	VMMPE
murmujeáoslos	murmujear	VMMPE
murmujeádmela	murmujear	VMFSE
murmujeádsela	murmujear	VMFSE
murmujeádnosla	murmujear	VMFSE
murmujeáosla	murmujear	VMFSE
murmujeádmelas	murmujear	VMFPE
murmujeádselas	murmujear	VMFPE
murmujeádnoslas	murmujear	VMFPE
murmujeáoslas	murmujear	VMFPE
murmujeado	murmujear	VPM
murmujeados	murmujear	VPMP
murmujeada	murmujear	VPF
murmujeadas	murmujear	VPFP
murmujeando	murmujear	VG
murmujeándome	murmujear	VGSE
murmujeándote	murmujear	VGSE
murmujeándole	murmujear	VGSE
murmujeándonos	murmujear	VGPE
murmujeándoos	murmujear	VGPE
murmujeándolo	murmujear	VGMSE
murmujeándola	murmujear	VGFSE
murmujeándolos	murmujear	VGMPE
murmujeándolas	murmujear	VGFPE
murmujeándomelo	murmujear	VGMSE
murmujeándotelo	murmujear	VGMSE
murmujeándoselo	murmujear	VGMSE
murmujeándonoslo	murmujear	VGMSE
murmujeándooslo	murmujear	VGMSE
murmujeándomelos	murmujear	VGMPE
murmujeándotelos	murmujear	VGMPE
murmujeándoselos	murmujear	VGMPE
murmujeándonoslos	murmujear	VGMPE
murmujeándooslos	murmujear	VGMPE
murmujeándomela	murmujear	VGFSE
murmujeándotela	murmujear	VGFSE
murmujeándosela	murmujear	VGFSE
murmujeándonosla	murmujear	VGFSE
murmujeándoosla	murmujear	VGFSE
murmujeándomelas	murmujear	VGFPE
murmujeándotelas	murmujear	VGFPE
murmujeándoselas	murmujear	VGFPE
murmujeándonoslas	murmujear	VGFPE
murmujeándooslas	murmujear	VGFPE
murmullar	murmullar	O
murmullo	murmullar	VIP1
murmullas	murmullar	VIP2
murmulla	murmullar	VIP3
murmullamos	murmullar	VIP4
murmulláis	murmullar	VIP5
murmullan	murmullar	VIP6
murmullaba	murmullar	VII1
murmullabas	murmullar	VII2
murmullábamos	murmullar	VII4
murmullabais	murmullar	VII5
murmullaban	murmullar	VII6
murmullaré	murmullar	VIF1
murmullarás	murmullar	VIF2
murmullará	murmullar	VIF3
murmullaremos	murmullar	VIF4
murmullaréis	murmullar	VIF5
murmullarán	murmullar	VIF6
murmullaría	murmullar	VIC1
murmullarías	murmullar	VIC2
murmullaría	murmullar	VIC3
murmullaríamos	murmullar	VIC4
murmullaríais	murmullar	VIC5
murmullarían	murmullar	VIC6
murmullé	murmullar	VIX1
murmullaste	murmullar	VIX2
murmulló	murmullar	VIX3
murmullasteis	murmullar	VIX5
murmullaron	murmullar	VIX6
murmulle	murmullar	VSP1
murmulles	murmullar	VSP2
murmullemos	murmullar	VSP4
murmulléis	murmullar	VSP5
murmullen	murmullar	VSP6
murmullara	murmullar	VSX1
murmullaras	murmullar	VSX2
murmulláramos	murmullar	VSX4
murmullarais	murmullar	VSX5
murmullaran	murmullar	VSX6
murmullare	murmullar	VSF1
murmullares	murmullar	VSF2
murmulláremos	murmullar	VSF4
murmullareis	murmullar	VSF5
murmullaren	murmullar	VSF6
murmullase	murmullar	VSI1
murmullases	murmullar	VSI2
murmullásemos	murmullar	VSI4
murmullaseis	murmullar	VSI5
murmullasen	murmullar	VSI6
murmullad	murmullar	VMP
murmulladme	murmullar	VMSE
murmulladle	murmullar	VMSE
murmulladnos	murmullar	VMPE
murmullaos	murmullar	VMPE
murmulladles	murmullar	VMPE
murmullado	murmullar	VPM
murmullados	murmullar	VPMP
murmullada	murmullar	VPF
murmulladas	murmullar	VPFP
murmullando	murmullar	VG
murmullándome	murmullar	VGSE
murmullándote	murmullar	VGSE
murmullándole	murmullar	VGSE
murmullándonos	murmullar	VGPE
murmullándoos	murmullar	VGPE
murmurar	murmurar	O
murmuro	murmurar	VIP1
murmuras	murmurar	VIP2
murmura	murmurar	VIP3
murmuramos	murmurar	VIP4
murmuráis	murmurar	VIP5
murmuran	murmurar	VIP6
murmuraba	murmurar	VII1
murmurabas	murmurar	VII2
murmurábamos	murmurar	VII4
murmurabais	murmurar	VII5
murmuraban	murmurar	VII6
murmuraré	murmurar	VIF1
murmurarás	murmurar	VIF2
murmurará	murmurar	VIF3
murmuraremos	murmurar	VIF4
murmuraréis	murmurar	VIF5
murmurarán	murmurar	VIF6
murmuraría	murmurar	VIC1
murmurarías	murmurar	VIC2
murmuraría	murmurar	VIC3
murmuraríamos	murmurar	VIC4
murmuraríais	murmurar	VIC5
murmurarían	murmurar	VIC6
murmuré	murmurar	VIX1
murmuraste	murmurar	VIX2
murmuró	murmurar	VIX3
murmurasteis	murmurar	VIX5
murmuraron	murmurar	VIX6
murmure	murmurar	VSP1
murmures	murmurar	VSP2
murmuremos	murmurar	VSP4
murmuréis	murmurar	VSP5
murmuren	murmurar	VSP6
murmurara	murmurar	VSX1
murmuraras	murmurar	VSX2
murmuráramos	murmurar	VSX4
murmurarais	murmurar	VSX5
murmuraran	murmurar	VSX6
murmurare	murmurar	VSF1
murmurares	murmurar	VSF2
murmuráremos	murmurar	VSF4
murmurareis	murmurar	VSF5
murmuraren	murmurar	VSF6
murmurase	murmurar	VSI1
murmurases	murmurar	VSI2
murmurásemos	murmurar	VSI4
murmuraseis	murmurar	VSI5
murmurasen	murmurar	VSI6
murmurad	murmurar	VMP
murmuradme	murmurar	VMSE
murmuradle	murmurar	VMSE
murmuradnos	murmurar	VMPE
murmuraos	murmurar	VMPE
murmuradles	murmurar	VMPE
murmuradlo	murmurar	VMMSE
murmuradla	murmurar	VMFSE
murmuradlos	murmurar	VMMPE
murmuradlas	murmurar	VMFPE
murmurádmelo	murmurar	VMMSE
murmurádselo	murmurar	VMMSE
murmurádnoslo	murmurar	VMMSE
murmuráoslo	murmurar	VMMSE
murmurádmelos	murmurar	VMMPE
murmurádselos	murmurar	VMMPE
murmurádnoslos	murmurar	VMMPE
murmuráoslos	murmurar	VMMPE
murmurádmela	murmurar	VMFSE
murmurádsela	murmurar	VMFSE
murmurádnosla	murmurar	VMFSE
murmuráosla	murmurar	VMFSE
murmurádmelas	murmurar	VMFPE
murmurádselas	murmurar	VMFPE
murmurádnoslas	murmurar	VMFPE
murmuráoslas	murmurar	VMFPE
murmurado	murmurar	VPM
murmurados	murmurar	VPMP
murmurada	murmurar	VPF
murmuradas	murmurar	VPFP
murmurando	murmurar	VG
murmurándome	murmurar	VGSE
murmurándote	murmurar	VGSE
murmurándole	murmurar	VGSE
murmurándonos	murmurar	VGPE
murmurándoos	murmurar	VGPE
murmurándolo	murmurar	VGMSE
murmurándola	murmurar	VGFSE
murmurándolos	murmurar	VGMPE
murmurándolas	murmurar	VGFPE
murmurándomelo	murmurar	VGMSE
murmurándotelo	murmurar	VGMSE
murmurándoselo	murmurar	VGMSE
murmurándonoslo	murmurar	VGMSE
murmurándooslo	murmurar	VGMSE
murmurándomelos	murmurar	VGMPE
murmurándotelos	murmurar	VGMPE
murmurándoselos	murmurar	VGMPE
murmurándonoslos	murmurar	VGMPE
murmurándooslos	murmurar	VGMPE
murmurándomela	murmurar	VGFSE
murmurándotela	murmurar	VGFSE
murmurándosela	murmurar	VGFSE
murmurándonosla	murmurar	VGFSE
murmurándoosla	murmurar	VGFSE
murmurándomelas	murmurar	VGFPE
murmurándotelas	murmurar	VGFPE
murmurándoselas	murmurar	VGFPE
murmurándonoslas	murmurar	VGFPE
murmurándooslas	murmurar	VGFPE
murmurear	murmurear	O
murmureo	murmurear	VIP1
murmureas	murmurear	VIP2
murmurea	murmurear	VIP3
murmureamos	murmurear	VIP4
murmureáis	murmurear	VIP5
murmurean	murmurear	VIP6
murmureaba	murmurear	VII1
murmureabas	murmurear	VII2
murmureábamos	murmurear	VII4
murmureabais	murmurear	VII5
murmureaban	murmurear	VII6
murmurearé	murmurear	VIF1
murmurearás	murmurear	VIF2
murmureará	murmurear	VIF3
murmurearemos	murmurear	VIF4
murmurearéis	murmurear	VIF5
murmurearán	murmurear	VIF6
murmurearía	murmurear	VIC1
murmurearías	murmurear	VIC2
murmurearía	murmurear	VIC3
murmurearíamos	murmurear	VIC4
murmurearíais	murmurear	VIC5
murmurearían	murmurear	VIC6
murmureé	murmurear	VIX1
murmureaste	murmurear	VIX2
murmureó	murmurear	VIX3
murmureasteis	murmurear	VIX5
murmurearon	murmurear	VIX6
murmuree	murmurear	VSP1
murmurees	murmurear	VSP2
murmureemos	murmurear	VSP4
murmureéis	murmurear	VSP5
murmureen	murmurear	VSP6
murmureara	murmurear	VSX1
murmurearas	murmurear	VSX2
murmureáramos	murmurear	VSX4
murmurearais	murmurear	VSX5
murmurearan	murmurear	VSX6
murmureare	murmurear	VSF1
murmureares	murmurear	VSF2
murmureáremos	murmurear	VSF4
murmureareis	murmurear	VSF5
murmurearen	murmurear	VSF6
murmurease	murmurear	VSI1
murmureases	murmurear	VSI2
murmureásemos	murmurear	VSI4
murmureaseis	murmurear	VSI5
murmureasen	murmurear	VSI6
murmuread	murmurear	VMP
murmureadme	murmurear	VMSE
murmureadle	murmurear	VMSE
murmureadnos	murmurear	VMPE
murmureaos	murmurear	VMPE
murmureadles	murmurear	VMPE
murmureado	murmurear	VPM
murmureados	murmurear	VPMP
murmureada	murmurear	VPF
murmureadas	murmurear	VPFP
murmureando	murmurear	VG
murmureándome	murmurear	VGSE
murmureándote	murmurear	VGSE
murmureándole	murmurear	VGSE
murmureándonos	murmurear	VGPE
murmureándoos	murmurear	VGPE
murriar	murriar	O
murrio	murriar	VIP1
murrias	murriar	VIP2
murria	murriar	VIP3
murriamos	murriar	VIP4
murriáis	murriar	VIP5
murrian	murriar	VIP6
murriaba	murriar	VII1
murriabas	murriar	VII2
murriábamos	murriar	VII4
murriabais	murriar	VII5
murriaban	murriar	VII6
murriaré	murriar	VIF1
murriarás	murriar	VIF2
murriará	murriar	VIF3
murriaremos	murriar	VIF4
murriaréis	murriar	VIF5
murriarán	murriar	VIF6
murriaría	murriar	VIC1
murriarías	murriar	VIC2
murriaría	murriar	VIC3
murriaríamos	murriar	VIC4
murriaríais	murriar	VIC5
murriarían	murriar	VIC6
murrié	murriar	VIX1
murriaste	murriar	VIX2
murrió	murriar	VIX3
murriasteis	murriar	VIX5
murriaron	murriar	VIX6
murrie	murriar	VSP1
murries	murriar	VSP2
murriemos	murriar	VSP4
murriéis	murriar	VSP5
murrien	murriar	VSP6
murriara	murriar	VSX1
murriaras	murriar	VSX2
murriáramos	murriar	VSX4
murriarais	murriar	VSX5
murriaran	murriar	VSX6
murriare	murriar	VSF1
murriares	murriar	VSF2
murriáremos	murriar	VSF4
murriareis	murriar	VSF5
murriaren	murriar	VSF6
murriase	murriar	VSI1
murriases	murriar	VSI2
murriásemos	murriar	VSI4
murriaseis	murriar	VSI5
murriasen	murriar	VSI6
murriad	murriar	VMP
murriadme	murriar	VMSE
murriadle	murriar	VMSE
murriadnos	murriar	VMPE
murriaos	murriar	VMPE
murriadles	murriar	VMPE
murriadlo	murriar	VMMSE
murriadla	murriar	VMFSE
murriadlos	murriar	VMMPE
murriadlas	murriar	VMFPE
murriádmelo	murriar	VMMSE
murriádselo	murriar	VMMSE
murriádnoslo	murriar	VMMSE
murriáoslo	murriar	VMMSE
murriádmelos	murriar	VMMPE
murriádselos	murriar	VMMPE
murriádnoslos	murriar	VMMPE
murriáoslos	murriar	VMMPE
murriádmela	murriar	VMFSE
murriádsela	murriar	VMFSE
murriádnosla	murriar	VMFSE
murriáosla	murriar	VMFSE
murriádmelas	murriar	VMFPE
murriádselas	murriar	VMFPE
murriádnoslas	murriar	VMFPE
murriáoslas	murriar	VMFPE
murriado	murriar	VPM
murriados	murriar	VPMP
murriada	murriar	VPF
murriadas	murriar	VPFP
murriando	murriar	VG
murriándome	murriar	VGSE
murriándote	murriar	VGSE
murriándole	murriar	VGSE
murriándonos	murriar	VGPE
murriándoos	murriar	VGPE
murriándolo	murriar	VGMSE
murriándola	murriar	VGFSE
murriándolos	murriar	VGMPE
murriándolas	murriar	VGFPE
murriándomelo	murriar	VGMSE
murriándotelo	murriar	VGMSE
murriándoselo	murriar	VGMSE
murriándonoslo	murriar	VGMSE
murriándooslo	murriar	VGMSE
murriándomelos	murriar	VGMPE
murriándotelos	murriar	VGMPE
murriándoselos	murriar	VGMPE
murriándonoslos	murriar	VGMPE
murriándooslos	murriar	VGMPE
murriándomela	murriar	VGFSE
murriándotela	murriar	VGFSE
murriándosela	murriar	VGFSE
murriándonosla	murriar	VGFSE
murriándoosla	murriar	VGFSE
murriándomelas	murriar	VGFPE
murriándotelas	murriar	VGFPE
murriándoselas	murriar	VGFPE
murriándonoslas	murriar	VGFPE
murriándooslas	murriar	VGFPE
