ocuje	ocuje	O
ocujes	ocuje	P
ocular	ocular	O
oculares	ocular	P
ocularista	ocularista	O
ocularistas	ocularista	P
ocularmente	ocularmente	O
oculista	oculista	O
oculistas	oculista	P
ocultación	ocultación	O
ocultaciones	ocultación	P
ocultador	ocultador	O
ocultadoras	ocultador	FP
ocultadora	ocultador	F
ocultadores	ocultador	P
ocultamente	ocultamente	O
ocultis	ocultis	O
ocultismo	ocultismo	O
ocultismos	ocultismo	P
ocultista	ocultista	O
ocultistas	ocultista	P
oculto	oculto	O
ocultas	oculto	FP
oculta	oculto	F
ocultos	oculto	P
ocume	ocume	O
ocumes	ocume	P
ocumo	ocumo	O
ocumos	ocumo	P
ocupacional	ocupacional	O
ocupacionales	ocupacional	P
ocupación	ocupación	O
ocupaciones	ocupación	P
ocupada	ocupada	O
ocupadas	ocupada	P
ocupador	ocupador	O
ocupadoras	ocupador	FP
ocupadora	ocupador	F
ocupadores	ocupador	P
ocupante	ocupante	O
ocupantes	ocupante	P
ocurrencia	ocurrencia	O
ocurrencias	ocurrencia	P
ocurrente	ocurrente	O
ocurrentes	ocurrente	P
ocurrido	ocurrido	O
ocurridas	ocurrido	FP
ocurrida	ocurrido	F
ocurridos	ocurrido	P
ocurso	ocurso	O
ocursos	ocurso	P
ocurrir	ocurrir	O
ocurro	ocurrir	VIP1
ocurres	ocurrir	VIP2
ocurre	ocurrir	VIP3
ocurrimos	ocurrir	VIP4
ocurrís	ocurrir	VIP5
ocurren	ocurrir	VIP6
ocurría	ocurrir	VII1
ocurrías	ocurrir	VII2
ocurríamos	ocurrir	VII4
ocurríais	ocurrir	VII5
ocurrían	ocurrir	VII6
ocurriré	ocurrir	VIF1
ocurrirás	ocurrir	VIF2
ocurrirá	ocurrir	VIF3
ocurriremos	ocurrir	VIF4
ocurriréis	ocurrir	VIF5
ocurrirán	ocurrir	VIF6
ocurriría	ocurrir	VIC1
ocurrirías	ocurrir	VIC2
ocurriría	ocurrir	VIC3
ocurriríamos	ocurrir	VIC4
ocurriríais	ocurrir	VIC5
ocurrirían	ocurrir	VIC6
ocurrí	ocurrir	VIX1
ocurriste	ocurrir	VIX2
ocurrió	ocurrir	VIX3
ocurristeis	ocurrir	VIX5
ocurrieron	ocurrir	VIX6
ocurra	ocurrir	VSP1
ocurras	ocurrir	VSP2
ocurramos	ocurrir	VSP4
ocurráis	ocurrir	VSP5
ocurran	ocurrir	VSP6
ocurriera	ocurrir	VSX1
ocurrieras	ocurrir	VSX2
ocurriéramos	ocurrir	VSX4
ocurrierais	ocurrir	VSX5
ocurrieran	ocurrir	VSX6
ocurriere	ocurrir	VSF1
ocurrieres	ocurrir	VSF2
ocurriéremos	ocurrir	VSF4
ocurriereis	ocurrir	VSF5
ocurrieren	ocurrir	VSF6
ocurriese	ocurrir	VSI1
ocurrieses	ocurrir	VSI2
ocurriésemos	ocurrir	VSI4
ocurrieseis	ocurrir	VSI5
ocurriesen	ocurrir	VSI6
ocurrid	ocurrir	VMP
ocurridme	ocurrir	VMSE
ocurridle	ocurrir	VMSE
ocurridnos	ocurrir	VMPE
ocurrios	ocurrir	VMPE
ocurridles	ocurrir	VMPE
ocurrido	ocurrir	VPM
ocurridos	ocurrir	VPMP
ocurrida	ocurrir	VPF
ocurridas	ocurrir	VPFP
ocurriendo	ocurrir	VG
ocurriéndome	ocurrir	VGSE
ocurriéndote	ocurrir	VGSE
ocurriéndole	ocurrir	VGSE
ocurriéndonos	ocurrir	VGPE
ocurriéndoos	ocurrir	VGPE
ocultar	ocultar	O
oculto	ocultar	VIP1
ocultas	ocultar	VIP2
oculta	ocultar	VIP3
ocultamos	ocultar	VIP4
ocultáis	ocultar	VIP5
ocultan	ocultar	VIP6
ocultaba	ocultar	VII1
ocultabas	ocultar	VII2
ocultábamos	ocultar	VII4
ocultabais	ocultar	VII5
ocultaban	ocultar	VII6
ocultaré	ocultar	VIF1
ocultarás	ocultar	VIF2
ocultará	ocultar	VIF3
ocultaremos	ocultar	VIF4
ocultaréis	ocultar	VIF5
ocultarán	ocultar	VIF6
ocultaría	ocultar	VIC1
ocultarías	ocultar	VIC2
ocultaría	ocultar	VIC3
ocultaríamos	ocultar	VIC4
ocultaríais	ocultar	VIC5
ocultarían	ocultar	VIC6
oculté	ocultar	VIX1
ocultaste	ocultar	VIX2
ocultó	ocultar	VIX3
ocultasteis	ocultar	VIX5
ocultaron	ocultar	VIX6
oculte	ocultar	VSP1
ocultes	ocultar	VSP2
ocultemos	ocultar	VSP4
ocultéis	ocultar	VSP5
oculten	ocultar	VSP6
ocultara	ocultar	VSX1
ocultaras	ocultar	VSX2
ocultáramos	ocultar	VSX4
ocultarais	ocultar	VSX5
ocultaran	ocultar	VSX6
ocultare	ocultar	VSF1
ocultares	ocultar	VSF2
ocultáremos	ocultar	VSF4
ocultareis	ocultar	VSF5
ocultaren	ocultar	VSF6
ocultase	ocultar	VSI1
ocultases	ocultar	VSI2
ocultásemos	ocultar	VSI4
ocultaseis	ocultar	VSI5
ocultasen	ocultar	VSI6
ocultad	ocultar	VMP
ocultadme	ocultar	VMSE
ocultadle	ocultar	VMSE
ocultadnos	ocultar	VMPE
ocultaos	ocultar	VMPE
ocultadles	ocultar	VMPE
ocultadlo	ocultar	VMMSE
ocultadla	ocultar	VMFSE
ocultadlos	ocultar	VMMPE
ocultadlas	ocultar	VMFPE
ocultádmelo	ocultar	VMMSE
ocultádselo	ocultar	VMMSE
ocultádnoslo	ocultar	VMMSE
ocultáoslo	ocultar	VMMSE
ocultádmelos	ocultar	VMMPE
ocultádselos	ocultar	VMMPE
ocultádnoslos	ocultar	VMMPE
ocultáoslos	ocultar	VMMPE
ocultádmela	ocultar	VMFSE
ocultádsela	ocultar	VMFSE
ocultádnosla	ocultar	VMFSE
ocultáosla	ocultar	VMFSE
ocultádmelas	ocultar	VMFPE
ocultádselas	ocultar	VMFPE
ocultádnoslas	ocultar	VMFPE
ocultáoslas	ocultar	VMFPE
ocultado	ocultar	VPM
ocultados	ocultar	VPMP
ocultada	ocultar	VPF
ocultadas	ocultar	VPFP
ocultando	ocultar	VG
ocultándome	ocultar	VGSE
ocultándote	ocultar	VGSE
ocultándole	ocultar	VGSE
ocultándonos	ocultar	VGPE
ocultándoos	ocultar	VGPE
ocultándolo	ocultar	VGMSE
ocultándola	ocultar	VGFSE
ocultándolos	ocultar	VGMPE
ocultándolas	ocultar	VGFPE
ocultándomelo	ocultar	VGMSE
ocultándotelo	ocultar	VGMSE
ocultándoselo	ocultar	VGMSE
ocultándonoslo	ocultar	VGMSE
ocultándooslo	ocultar	VGMSE
ocultándomelos	ocultar	VGMPE
ocultándotelos	ocultar	VGMPE
ocultándoselos	ocultar	VGMPE
ocultándonoslos	ocultar	VGMPE
ocultándooslos	ocultar	VGMPE
ocultándomela	ocultar	VGFSE
ocultándotela	ocultar	VGFSE
ocultándosela	ocultar	VGFSE
ocultándonosla	ocultar	VGFSE
ocultándoosla	ocultar	VGFSE
ocultándomelas	ocultar	VGFPE
ocultándotelas	ocultar	VGFPE
ocultándoselas	ocultar	VGFPE
ocultándonoslas	ocultar	VGFPE
ocultándooslas	ocultar	VGFPE
ocupar	ocupar	O
ocupo	ocupar	VIP1
ocupas	ocupar	VIP2
ocupa	ocupar	VIP3
ocupamos	ocupar	VIP4
ocupáis	ocupar	VIP5
ocupan	ocupar	VIP6
ocupaba	ocupar	VII1
ocupabas	ocupar	VII2
ocupábamos	ocupar	VII4
ocupabais	ocupar	VII5
ocupaban	ocupar	VII6
ocuparé	ocupar	VIF1
ocuparás	ocupar	VIF2
ocupará	ocupar	VIF3
ocuparemos	ocupar	VIF4
ocuparéis	ocupar	VIF5
ocuparán	ocupar	VIF6
ocuparía	ocupar	VIC1
ocuparías	ocupar	VIC2
ocuparía	ocupar	VIC3
ocuparíamos	ocupar	VIC4
ocuparíais	ocupar	VIC5
ocuparían	ocupar	VIC6
ocupé	ocupar	VIX1
ocupaste	ocupar	VIX2
ocupó	ocupar	VIX3
ocupasteis	ocupar	VIX5
ocuparon	ocupar	VIX6
ocupe	ocupar	VSP1
ocupes	ocupar	VSP2
ocupemos	ocupar	VSP4
ocupéis	ocupar	VSP5
ocupen	ocupar	VSP6
ocupara	ocupar	VSX1
ocuparas	ocupar	VSX2
ocupáramos	ocupar	VSX4
ocuparais	ocupar	VSX5
ocuparan	ocupar	VSX6
ocupare	ocupar	VSF1
ocupares	ocupar	VSF2
ocupáremos	ocupar	VSF4
ocupareis	ocupar	VSF5
ocuparen	ocupar	VSF6
ocupase	ocupar	VSI1
ocupases	ocupar	VSI2
ocupásemos	ocupar	VSI4
ocupaseis	ocupar	VSI5
ocupasen	ocupar	VSI6
ocupad	ocupar	VMP
ocupadme	ocupar	VMSE
ocupadle	ocupar	VMSE
ocupadnos	ocupar	VMPE
ocupaos	ocupar	VMPE
ocupadles	ocupar	VMPE
ocupadlo	ocupar	VMMSE
ocupadla	ocupar	VMFSE
ocupadlos	ocupar	VMMPE
ocupadlas	ocupar	VMFPE
ocupádmelo	ocupar	VMMSE
ocupádselo	ocupar	VMMSE
ocupádnoslo	ocupar	VMMSE
ocupáoslo	ocupar	VMMSE
ocupádmelos	ocupar	VMMPE
ocupádselos	ocupar	VMMPE
ocupádnoslos	ocupar	VMMPE
ocupáoslos	ocupar	VMMPE
ocupádmela	ocupar	VMFSE
ocupádsela	ocupar	VMFSE
ocupádnosla	ocupar	VMFSE
ocupáosla	ocupar	VMFSE
ocupádmelas	ocupar	VMFPE
ocupádselas	ocupar	VMFPE
ocupádnoslas	ocupar	VMFPE
ocupáoslas	ocupar	VMFPE
ocupado	ocupar	VPM
ocupados	ocupar	VPMP
ocupada	ocupar	VPF
ocupadas	ocupar	VPFP
ocupando	ocupar	VG
ocupándome	ocupar	VGSE
ocupándote	ocupar	VGSE
ocupándole	ocupar	VGSE
ocupándonos	ocupar	VGPE
ocupándoos	ocupar	VGPE
ocupándolo	ocupar	VGMSE
ocupándola	ocupar	VGFSE
ocupándolos	ocupar	VGMPE
ocupándolas	ocupar	VGFPE
ocupándomelo	ocupar	VGMSE
ocupándotelo	ocupar	VGMSE
ocupándoselo	ocupar	VGMSE
ocupándonoslo	ocupar	VGMSE
ocupándooslo	ocupar	VGMSE
ocupándomelos	ocupar	VGMPE
ocupándotelos	ocupar	VGMPE
ocupándoselos	ocupar	VGMPE
ocupándonoslos	ocupar	VGMPE
ocupándooslos	ocupar	VGMPE
ocupándomela	ocupar	VGFSE
ocupándotela	ocupar	VGFSE
ocupándosela	ocupar	VGFSE
ocupándonosla	ocupar	VGFSE
ocupándoosla	ocupar	VGFSE
ocupándomelas	ocupar	VGFPE
ocupándotelas	ocupar	VGFPE
ocupándoselas	ocupar	VGFPE
ocupándonoslas	ocupar	VGFPE
ocupándooslas	ocupar	VGFPE
