opresivamente	opresivamente	O
opresivo	opresivo	O
opresivas	opresivo	FP
opresiva	opresivo	F
opresivos	opresivo	P
opresión	opresión	O
opresiones	opresión	P
opresor	opresor	O
opresoras	opresor	FP
opresora	opresor	F
opresores	opresor	P
oprobio	oprobio	O
oprobios	oprobio	P
oprobiosamente	oprobiosamente	O
oprobioso	oprobioso	O
oprobiosas	oprobioso	FP
oprobiosa	oprobioso	F
oprobiosos	oprobioso	P
oprobrio	oprobrio	O
oprobrios	oprobrio	P
oprimir	oprimir	O
oprimo	oprimir	VIP1
oprimes	oprimir	VIP2
oprime	oprimir	VIP3
oprimimos	oprimir	VIP4
oprimís	oprimir	VIP5
oprimen	oprimir	VIP6
oprimía	oprimir	VII1
oprimías	oprimir	VII2
oprimíamos	oprimir	VII4
oprimíais	oprimir	VII5
oprimían	oprimir	VII6
oprimiré	oprimir	VIF1
oprimirás	oprimir	VIF2
oprimirá	oprimir	VIF3
oprimiremos	oprimir	VIF4
oprimiréis	oprimir	VIF5
oprimirán	oprimir	VIF6
oprimiría	oprimir	VIC1
oprimirías	oprimir	VIC2
oprimiría	oprimir	VIC3
oprimiríamos	oprimir	VIC4
oprimiríais	oprimir	VIC5
oprimirían	oprimir	VIC6
oprimí	oprimir	VIX1
oprimiste	oprimir	VIX2
oprimió	oprimir	VIX3
oprimisteis	oprimir	VIX5
oprimieron	oprimir	VIX6
oprima	oprimir	VSP1
oprimas	oprimir	VSP2
oprimamos	oprimir	VSP4
oprimáis	oprimir	VSP5
opriman	oprimir	VSP6
oprimiera	oprimir	VSX1
oprimieras	oprimir	VSX2
oprimiéramos	oprimir	VSX4
oprimierais	oprimir	VSX5
oprimieran	oprimir	VSX6
oprimiere	oprimir	VSF1
oprimieres	oprimir	VSF2
oprimiéremos	oprimir	VSF4
oprimiereis	oprimir	VSF5
oprimieren	oprimir	VSF6
oprimiese	oprimir	VSI1
oprimieses	oprimir	VSI2
oprimiésemos	oprimir	VSI4
oprimieseis	oprimir	VSI5
oprimiesen	oprimir	VSI6
oprimid	oprimir	VMP
oprimidme	oprimir	VMSE
oprimidle	oprimir	VMSE
oprimidnos	oprimir	VMPE
oprimios	oprimir	VMPE
oprimidles	oprimir	VMPE
oprimidlo	oprimir	VMMSE
oprimidla	oprimir	VMFSE
oprimidlos	oprimir	VMMPE
oprimidlas	oprimir	VMFPE
oprimídmelo	oprimir	VMMSE
oprimídselo	oprimir	VMMSE
oprimídnoslo	oprimir	VMMSE
oprimíoslo	oprimir	VMMSE
oprimídmelos	oprimir	VMMPE
oprimídselos	oprimir	VMMPE
oprimídnoslos	oprimir	VMMPE
oprimíoslos	oprimir	VMMPE
oprimídmela	oprimir	VMFSE
oprimídsela	oprimir	VMFSE
oprimídnosla	oprimir	VMFSE
oprimíosla	oprimir	VMFSE
oprimídmelas	oprimir	VMFPE
oprimídselas	oprimir	VMFPE
oprimídnoslas	oprimir	VMFPE
oprimíoslas	oprimir	VMFPE
oprimido	oprimir	VPM
oprimidos	oprimir	VPMP
oprimida	oprimir	VPF
oprimidas	oprimir	VPFP
oprimiendo	oprimir	VG
oprimiéndome	oprimir	VGSE
oprimiéndote	oprimir	VGSE
oprimiéndole	oprimir	VGSE
oprimiéndonos	oprimir	VGPE
oprimiéndoos	oprimir	VGPE
oprimiéndolo	oprimir	VGMSE
oprimiéndola	oprimir	VGFSE
oprimiéndolos	oprimir	VGMPE
oprimiéndolas	oprimir	VGFPE
oprimiéndomelo	oprimir	VGMSE
oprimiéndotelo	oprimir	VGMSE
oprimiéndoselo	oprimir	VGMSE
oprimiéndonoslo	oprimir	VGMSE
oprimiéndooslo	oprimir	VGMSE
oprimiéndomelos	oprimir	VGMPE
oprimiéndotelos	oprimir	VGMPE
oprimiéndoselos	oprimir	VGMPE
oprimiéndonoslos	oprimir	VGMPE
oprimiéndooslos	oprimir	VGMPE
oprimiéndomela	oprimir	VGFSE
oprimiéndotela	oprimir	VGFSE
oprimiéndosela	oprimir	VGFSE
oprimiéndonosla	oprimir	VGFSE
oprimiéndoosla	oprimir	VGFSE
oprimiéndomelas	oprimir	VGFPE
oprimiéndotelas	oprimir	VGFPE
oprimiéndoselas	oprimir	VGFPE
oprimiéndonoslas	oprimir	VGFPE
oprimiéndooslas	oprimir	VGFPE
opresar	opresar	O
opreso	opresar	VIP1
opresas	opresar	VIP2
opresa	opresar	VIP3
opresamos	opresar	VIP4
opresáis	opresar	VIP5
opresan	opresar	VIP6
opresaba	opresar	VII1
opresabas	opresar	VII2
opresábamos	opresar	VII4
opresabais	opresar	VII5
opresaban	opresar	VII6
opresaré	opresar	VIF1
opresarás	opresar	VIF2
opresará	opresar	VIF3
opresaremos	opresar	VIF4
opresaréis	opresar	VIF5
opresarán	opresar	VIF6
opresaría	opresar	VIC1
opresarías	opresar	VIC2
opresaría	opresar	VIC3
opresaríamos	opresar	VIC4
opresaríais	opresar	VIC5
opresarían	opresar	VIC6
opresé	opresar	VIX1
opresaste	opresar	VIX2
opresó	opresar	VIX3
opresasteis	opresar	VIX5
opresaron	opresar	VIX6
oprese	opresar	VSP1
opreses	opresar	VSP2
opresemos	opresar	VSP4
opreséis	opresar	VSP5
opresen	opresar	VSP6
opresara	opresar	VSX1
opresaras	opresar	VSX2
opresáramos	opresar	VSX4
opresarais	opresar	VSX5
opresaran	opresar	VSX6
opresare	opresar	VSF1
opresares	opresar	VSF2
opresáremos	opresar	VSF4
opresareis	opresar	VSF5
opresaren	opresar	VSF6
opresase	opresar	VSI1
opresases	opresar	VSI2
opresásemos	opresar	VSI4
opresaseis	opresar	VSI5
opresasen	opresar	VSI6
opresad	opresar	VMP
opresadme	opresar	VMSE
opresadle	opresar	VMSE
opresadnos	opresar	VMPE
opresaos	opresar	VMPE
opresadles	opresar	VMPE
opresadlo	opresar	VMMSE
opresadla	opresar	VMFSE
opresadlos	opresar	VMMPE
opresadlas	opresar	VMFPE
opresádmelo	opresar	VMMSE
opresádselo	opresar	VMMSE
opresádnoslo	opresar	VMMSE
opresáoslo	opresar	VMMSE
opresádmelos	opresar	VMMPE
opresádselos	opresar	VMMPE
opresádnoslos	opresar	VMMPE
opresáoslos	opresar	VMMPE
opresádmela	opresar	VMFSE
opresádsela	opresar	VMFSE
opresádnosla	opresar	VMFSE
opresáosla	opresar	VMFSE
opresádmelas	opresar	VMFPE
opresádselas	opresar	VMFPE
opresádnoslas	opresar	VMFPE
opresáoslas	opresar	VMFPE
opresado	opresar	VPM
opresados	opresar	VPMP
opresada	opresar	VPF
opresadas	opresar	VPFP
opresando	opresar	VG
opresándome	opresar	VGSE
opresándote	opresar	VGSE
opresándole	opresar	VGSE
opresándonos	opresar	VGPE
opresándoos	opresar	VGPE
opresándolo	opresar	VGMSE
opresándola	opresar	VGFSE
opresándolos	opresar	VGMPE
opresándolas	opresar	VGFPE
opresándomelo	opresar	VGMSE
opresándotelo	opresar	VGMSE
opresándoselo	opresar	VGMSE
opresándonoslo	opresar	VGMSE
opresándooslo	opresar	VGMSE
opresándomelos	opresar	VGMPE
opresándotelos	opresar	VGMPE
opresándoselos	opresar	VGMPE
opresándonoslos	opresar	VGMPE
opresándooslos	opresar	VGMPE
opresándomela	opresar	VGFSE
opresándotela	opresar	VGFSE
opresándosela	opresar	VGFSE
opresándonosla	opresar	VGFSE
opresándoosla	opresar	VGFSE
opresándomelas	opresar	VGFPE
opresándotelas	opresar	VGFPE
opresándoselas	opresar	VGFPE
opresándonoslas	opresar	VGFPE
opresándooslas	opresar	VGFPE
oprobiar	oprobiar	O
oprobio	oprobiar	VIP1
oprobias	oprobiar	VIP2
oprobia	oprobiar	VIP3
oprobiamos	oprobiar	VIP4
oprobiáis	oprobiar	VIP5
oprobian	oprobiar	VIP6
oprobiaba	oprobiar	VII1
oprobiabas	oprobiar	VII2
oprobiábamos	oprobiar	VII4
oprobiabais	oprobiar	VII5
oprobiaban	oprobiar	VII6
oprobiaré	oprobiar	VIF1
oprobiarás	oprobiar	VIF2
oprobiará	oprobiar	VIF3
oprobiaremos	oprobiar	VIF4
oprobiaréis	oprobiar	VIF5
oprobiarán	oprobiar	VIF6
oprobiaría	oprobiar	VIC1
oprobiarías	oprobiar	VIC2
oprobiaría	oprobiar	VIC3
oprobiaríamos	oprobiar	VIC4
oprobiaríais	oprobiar	VIC5
oprobiarían	oprobiar	VIC6
oprobié	oprobiar	VIX1
oprobiaste	oprobiar	VIX2
oprobió	oprobiar	VIX3
oprobiasteis	oprobiar	VIX5
oprobiaron	oprobiar	VIX6
oprobie	oprobiar	VSP1
oprobies	oprobiar	VSP2
oprobiemos	oprobiar	VSP4
oprobiéis	oprobiar	VSP5
oprobien	oprobiar	VSP6
oprobiara	oprobiar	VSX1
oprobiaras	oprobiar	VSX2
oprobiáramos	oprobiar	VSX4
oprobiarais	oprobiar	VSX5
oprobiaran	oprobiar	VSX6
oprobiare	oprobiar	VSF1
oprobiares	oprobiar	VSF2
oprobiáremos	oprobiar	VSF4
oprobiareis	oprobiar	VSF5
oprobiaren	oprobiar	VSF6
oprobiase	oprobiar	VSI1
oprobiases	oprobiar	VSI2
oprobiásemos	oprobiar	VSI4
oprobiaseis	oprobiar	VSI5
oprobiasen	oprobiar	VSI6
oprobiad	oprobiar	VMP
oprobiadme	oprobiar	VMSE
oprobiadle	oprobiar	VMSE
oprobiadnos	oprobiar	VMPE
oprobiaos	oprobiar	VMPE
oprobiadles	oprobiar	VMPE
oprobiadlo	oprobiar	VMMSE
oprobiadla	oprobiar	VMFSE
oprobiadlos	oprobiar	VMMPE
oprobiadlas	oprobiar	VMFPE
oprobiádmelo	oprobiar	VMMSE
oprobiádselo	oprobiar	VMMSE
oprobiádnoslo	oprobiar	VMMSE
oprobiáoslo	oprobiar	VMMSE
oprobiádmelos	oprobiar	VMMPE
oprobiádselos	oprobiar	VMMPE
oprobiádnoslos	oprobiar	VMMPE
oprobiáoslos	oprobiar	VMMPE
oprobiádmela	oprobiar	VMFSE
oprobiádsela	oprobiar	VMFSE
oprobiádnosla	oprobiar	VMFSE
oprobiáosla	oprobiar	VMFSE
oprobiádmelas	oprobiar	VMFPE
oprobiádselas	oprobiar	VMFPE
oprobiádnoslas	oprobiar	VMFPE
oprobiáoslas	oprobiar	VMFPE
oprobiado	oprobiar	VPM
oprobiados	oprobiar	VPMP
oprobiada	oprobiar	VPF
oprobiadas	oprobiar	VPFP
oprobiando	oprobiar	VG
oprobiándome	oprobiar	VGSE
oprobiándote	oprobiar	VGSE
oprobiándole	oprobiar	VGSE
oprobiándonos	oprobiar	VGPE
oprobiándoos	oprobiar	VGPE
oprobiándolo	oprobiar	VGMSE
oprobiándola	oprobiar	VGFSE
oprobiándolos	oprobiar	VGMPE
oprobiándolas	oprobiar	VGFPE
oprobiándomelo	oprobiar	VGMSE
oprobiándotelo	oprobiar	VGMSE
oprobiándoselo	oprobiar	VGMSE
oprobiándonoslo	oprobiar	VGMSE
oprobiándooslo	oprobiar	VGMSE
oprobiándomelos	oprobiar	VGMPE
oprobiándotelos	oprobiar	VGMPE
oprobiándoselos	oprobiar	VGMPE
oprobiándonoslos	oprobiar	VGMPE
oprobiándooslos	oprobiar	VGMPE
oprobiándomela	oprobiar	VGFSE
oprobiándotela	oprobiar	VGFSE
oprobiándosela	oprobiar	VGFSE
oprobiándonosla	oprobiar	VGFSE
oprobiándoosla	oprobiar	VGFSE
oprobiándomelas	oprobiar	VGFPE
oprobiándotelas	oprobiar	VGFPE
oprobiándoselas	oprobiar	VGFPE
oprobiándonoslas	oprobiar	VGFPE
oprobiándooslas	oprobiar	VGFPE
