ori	ori	O
oris	ori	P
oribe	oribe	O
oribes	oribe	P
orientación	orientación	O
orientaciones	orientación	P
orientador	orientador	O
orientadoras	orientador	FP
orientadora	orientador	F
orientadores	orientador	P
oriental	oriental	O
orientales	oriental	P
orientalismo	orientalismo	O
orientalismos	orientalismo	P
orientalista	orientalista	O
orientalistas	orientalista	P
oriente	oriente	O
orientes	oriente	P
orificación	orificación	O
orificaciones	orificación	P
orificador	orificador	O
orificadores	orificador	P
orificia	orificia	O
orificias	orificia	P
orificio	orificio	O
orificios	orificio	P
oriflama	oriflama	O
oriflamas	oriflama	P
orifrés	orifrés	O
orifreses	orifrés	P
origen	origen	O
origenes	origen	P
origenismo	origenismo	O
origenismos	origenismo	P
origenista	origenista	O
origenistas	origenista	P
original	original	O
originales	original	P
originalidad	originalidad	O
originalidades	originalidad	P
originalmente	originalmente	O
originariamente	originariamente	O
originario	originario	O
originarias	originario	FP
originaria	originario	F
originarios	originario	P
orilla	orilla	O
orillas	orilla	P
orillero	orillero	O
orilleras	orillero	FP
orillera	orillero	F
orilleros	orillero	P
orillo	orillo	O
orillos	orillo	P
orina	orina	O
orinas	orina	P
orinal	orinal	O
orinales	orinal	P
oriniento	oriniento	O
orinientas	oriniento	FP
orinienta	oriniento	F
orinientos	oriniento	P
orinque	orinque	O
orinques	orinque	P
oriol	oriol	O
orioles	oriol	P
oriolano	oriolano	O
oriolanas	oriolano	FP
oriolana	oriolano	F
oriolanos	oriolano	P
oripié	oripié	O
oripiés	oripié	P
oriundez	oriundez	O
oriundeces	oriundez	P
oriundo	oriundo	O
oriundas	oriundo	FP
oriunda	oriundo	F
oriundos	oriundo	P
orive	orive	O
orives	orive	P
orí	orí	O
oríes	orí	P
orífice	orífice	O
orífices	orífice	P
orín	orín	O
orines	orín	P
orinecer	orinecer	O
orinezco	orinecer	VIP1
orineces	orinecer	VIP2
orinece	orinecer	VIP3
orinecemos	orinecer	VIP4
orinecéis	orinecer	VIP5
orinecen	orinecer	VIP6
orinecía	orinecer	VII1
orinecías	orinecer	VII2
orinecíamos	orinecer	VII4
orinecíais	orinecer	VII5
orinecían	orinecer	VII6
orineceré	orinecer	VIF1
orinecerás	orinecer	VIF2
orinecerá	orinecer	VIF3
orineceremos	orinecer	VIF4
orineceréis	orinecer	VIF5
orinecerán	orinecer	VIF6
orinecería	orinecer	VIC1
orinecerías	orinecer	VIC2
orinecería	orinecer	VIC3
orineceríamos	orinecer	VIC4
orineceríais	orinecer	VIC5
orinecerían	orinecer	VIC6
orinecí	orinecer	VIX1
orineciste	orinecer	VIX2
orineció	orinecer	VIX3
orinecisteis	orinecer	VIX5
orinecieron	orinecer	VIX6
orinezca	orinecer	VSP1
orinezcas	orinecer	VSP2
orinezcamos	orinecer	VSP4
orinezcáis	orinecer	VSP5
orinezcan	orinecer	VSP6
orineciera	orinecer	VSX1
orinecieras	orinecer	VSX2
orineciéramos	orinecer	VSX4
orinecierais	orinecer	VSX5
orinecieran	orinecer	VSX6
orineciere	orinecer	VSF1
orinecieres	orinecer	VSF2
orineciéremos	orinecer	VSF4
orineciereis	orinecer	VSF5
orinecieren	orinecer	VSF6
orineciese	orinecer	VSI1
orinecieses	orinecer	VSI2
orineciésemos	orinecer	VSI4
orinecieseis	orinecer	VSI5
orineciesen	orinecer	VSI6
orineced	orinecer	VMP
orinecedme	orinecer	VMSE
orinecedle	orinecer	VMSE
orinecednos	orinecer	VMPE
orineceos	orinecer	VMPE
orinecedles	orinecer	VMPE
orinecido	orinecer	VPM
orinecidos	orinecer	VPMP
orinecida	orinecer	VPF
orinecidas	orinecer	VPFP
orineciendo	orinecer	VG
orineciéndome	orinecer	VGSE
orineciéndote	orinecer	VGSE
orineciéndole	orinecer	VGSE
orineciéndonos	orinecer	VGPE
orineciéndoos	orinecer	VGPE
orientar	orientar	O
oriento	orientar	VIP1
orientas	orientar	VIP2
orienta	orientar	VIP3
orientamos	orientar	VIP4
orientáis	orientar	VIP5
orientan	orientar	VIP6
orientaba	orientar	VII1
orientabas	orientar	VII2
orientábamos	orientar	VII4
orientabais	orientar	VII5
orientaban	orientar	VII6
orientaré	orientar	VIF1
orientarás	orientar	VIF2
orientará	orientar	VIF3
orientaremos	orientar	VIF4
orientaréis	orientar	VIF5
orientarán	orientar	VIF6
orientaría	orientar	VIC1
orientarías	orientar	VIC2
orientaría	orientar	VIC3
orientaríamos	orientar	VIC4
orientaríais	orientar	VIC5
orientarían	orientar	VIC6
orienté	orientar	VIX1
orientaste	orientar	VIX2
orientó	orientar	VIX3
orientasteis	orientar	VIX5
orientaron	orientar	VIX6
oriente	orientar	VSP1
orientes	orientar	VSP2
orientemos	orientar	VSP4
orientéis	orientar	VSP5
orienten	orientar	VSP6
orientara	orientar	VSX1
orientaras	orientar	VSX2
orientáramos	orientar	VSX4
orientarais	orientar	VSX5
orientaran	orientar	VSX6
orientare	orientar	VSF1
orientares	orientar	VSF2
orientáremos	orientar	VSF4
orientareis	orientar	VSF5
orientaren	orientar	VSF6
orientase	orientar	VSI1
orientases	orientar	VSI2
orientásemos	orientar	VSI4
orientaseis	orientar	VSI5
orientasen	orientar	VSI6
orientad	orientar	VMP
orientadme	orientar	VMSE
orientadle	orientar	VMSE
orientadnos	orientar	VMPE
orientaos	orientar	VMPE
orientadles	orientar	VMPE
orientadlo	orientar	VMMSE
orientadla	orientar	VMFSE
orientadlos	orientar	VMMPE
orientadlas	orientar	VMFPE
orientádmelo	orientar	VMMSE
orientádselo	orientar	VMMSE
orientádnoslo	orientar	VMMSE
orientáoslo	orientar	VMMSE
orientádmelos	orientar	VMMPE
orientádselos	orientar	VMMPE
orientádnoslos	orientar	VMMPE
orientáoslos	orientar	VMMPE
orientádmela	orientar	VMFSE
orientádsela	orientar	VMFSE
orientádnosla	orientar	VMFSE
orientáosla	orientar	VMFSE
orientádmelas	orientar	VMFPE
orientádselas	orientar	VMFPE
orientádnoslas	orientar	VMFPE
orientáoslas	orientar	VMFPE
orientado	orientar	VPM
orientados	orientar	VPMP
orientada	orientar	VPF
orientadas	orientar	VPFP
orientando	orientar	VG
orientándome	orientar	VGSE
orientándote	orientar	VGSE
orientándole	orientar	VGSE
orientándonos	orientar	VGPE
orientándoos	orientar	VGPE
orientándolo	orientar	VGMSE
orientándola	orientar	VGFSE
orientándolos	orientar	VGMPE
orientándolas	orientar	VGFPE
orientándomelo	orientar	VGMSE
orientándotelo	orientar	VGMSE
orientándoselo	orientar	VGMSE
orientándonoslo	orientar	VGMSE
orientándooslo	orientar	VGMSE
orientándomelos	orientar	VGMPE
orientándotelos	orientar	VGMPE
orientándoselos	orientar	VGMPE
orientándonoslos	orientar	VGMPE
orientándooslos	orientar	VGMPE
orientándomela	orientar	VGFSE
orientándotela	orientar	VGFSE
orientándosela	orientar	VGFSE
orientándonosla	orientar	VGFSE
orientándoosla	orientar	VGFSE
orientándomelas	orientar	VGFPE
orientándotelas	orientar	VGFPE
orientándoselas	orientar	VGFPE
orientándonoslas	orientar	VGFPE
orientándooslas	orientar	VGFPE
orificar	orificar	O
orifico	orificar	VIP1
orificas	orificar	VIP2
orifica	orificar	VIP3
orificamos	orificar	VIP4
orificáis	orificar	VIP5
orifican	orificar	VIP6
orificaba	orificar	VII1
orificabas	orificar	VII2
orificábamos	orificar	VII4
orificabais	orificar	VII5
orificaban	orificar	VII6
orificaré	orificar	VIF1
orificarás	orificar	VIF2
orificará	orificar	VIF3
orificaremos	orificar	VIF4
orificaréis	orificar	VIF5
orificarán	orificar	VIF6
orificaría	orificar	VIC1
orificarías	orificar	VIC2
orificaría	orificar	VIC3
orificaríamos	orificar	VIC4
orificaríais	orificar	VIC5
orificarían	orificar	VIC6
orifiqué	orificar	VIX1
orificaste	orificar	VIX2
orificó	orificar	VIX3
orificasteis	orificar	VIX5
orificaron	orificar	VIX6
orifique	orificar	VSP1
orifiques	orificar	VSP2
orifiquemos	orificar	VSP4
orifiquéis	orificar	VSP5
orifiquen	orificar	VSP6
orificara	orificar	VSX1
orificaras	orificar	VSX2
orificáramos	orificar	VSX4
orificarais	orificar	VSX5
orificaran	orificar	VSX6
orificare	orificar	VSF1
orificares	orificar	VSF2
orificáremos	orificar	VSF4
orificareis	orificar	VSF5
orificaren	orificar	VSF6
orificase	orificar	VSI1
orificases	orificar	VSI2
orificásemos	orificar	VSI4
orificaseis	orificar	VSI5
orificasen	orificar	VSI6
orificad	orificar	VMP
orificadme	orificar	VMSE
orificadle	orificar	VMSE
orificadnos	orificar	VMPE
orificaos	orificar	VMPE
orificadles	orificar	VMPE
orificadlo	orificar	VMMSE
orificadla	orificar	VMFSE
orificadlos	orificar	VMMPE
orificadlas	orificar	VMFPE
orificádmelo	orificar	VMMSE
orificádselo	orificar	VMMSE
orificádnoslo	orificar	VMMSE
orificáoslo	orificar	VMMSE
orificádmelos	orificar	VMMPE
orificádselos	orificar	VMMPE
orificádnoslos	orificar	VMMPE
orificáoslos	orificar	VMMPE
orificádmela	orificar	VMFSE
orificádsela	orificar	VMFSE
orificádnosla	orificar	VMFSE
orificáosla	orificar	VMFSE
orificádmelas	orificar	VMFPE
orificádselas	orificar	VMFPE
orificádnoslas	orificar	VMFPE
orificáoslas	orificar	VMFPE
orificado	orificar	VPM
orificados	orificar	VPMP
orificada	orificar	VPF
orificadas	orificar	VPFP
orificando	orificar	VG
orificándome	orificar	VGSE
orificándote	orificar	VGSE
orificándole	orificar	VGSE
orificándonos	orificar	VGPE
orificándoos	orificar	VGPE
orificándolo	orificar	VGMSE
orificándola	orificar	VGFSE
orificándolos	orificar	VGMPE
orificándolas	orificar	VGFPE
orificándomelo	orificar	VGMSE
orificándotelo	orificar	VGMSE
orificándoselo	orificar	VGMSE
orificándonoslo	orificar	VGMSE
orificándooslo	orificar	VGMSE
orificándomelos	orificar	VGMPE
orificándotelos	orificar	VGMPE
orificándoselos	orificar	VGMPE
orificándonoslos	orificar	VGMPE
orificándooslos	orificar	VGMPE
orificándomela	orificar	VGFSE
orificándotela	orificar	VGFSE
orificándosela	orificar	VGFSE
orificándonosla	orificar	VGFSE
orificándoosla	orificar	VGFSE
orificándomelas	orificar	VGFPE
orificándotelas	orificar	VGFPE
orificándoselas	orificar	VGFPE
orificándonoslas	orificar	VGFPE
orificándooslas	orificar	VGFPE
originar	originar	O
origino	originar	VIP1
originas	originar	VIP2
origina	originar	VIP3
originamos	originar	VIP4
origináis	originar	VIP5
originan	originar	VIP6
originaba	originar	VII1
originabas	originar	VII2
originábamos	originar	VII4
originabais	originar	VII5
originaban	originar	VII6
originaré	originar	VIF1
originarás	originar	VIF2
originará	originar	VIF3
originaremos	originar	VIF4
originaréis	originar	VIF5
originarán	originar	VIF6
originaría	originar	VIC1
originarías	originar	VIC2
originaría	originar	VIC3
originaríamos	originar	VIC4
originaríais	originar	VIC5
originarían	originar	VIC6
originé	originar	VIX1
originaste	originar	VIX2
originó	originar	VIX3
originasteis	originar	VIX5
originaron	originar	VIX6
origine	originar	VSP1
origines	originar	VSP2
originemos	originar	VSP4
originéis	originar	VSP5
originen	originar	VSP6
originara	originar	VSX1
originaras	originar	VSX2
origináramos	originar	VSX4
originarais	originar	VSX5
originaran	originar	VSX6
originare	originar	VSF1
originares	originar	VSF2
origináremos	originar	VSF4
originareis	originar	VSF5
originaren	originar	VSF6
originase	originar	VSI1
originases	originar	VSI2
originásemos	originar	VSI4
originaseis	originar	VSI5
originasen	originar	VSI6
originad	originar	VMP
originadme	originar	VMSE
originadle	originar	VMSE
originadnos	originar	VMPE
originaos	originar	VMPE
originadles	originar	VMPE
originadlo	originar	VMMSE
originadla	originar	VMFSE
originadlos	originar	VMMPE
originadlas	originar	VMFPE
originádmelo	originar	VMMSE
originádselo	originar	VMMSE
originádnoslo	originar	VMMSE
origináoslo	originar	VMMSE
originádmelos	originar	VMMPE
originádselos	originar	VMMPE
originádnoslos	originar	VMMPE
origináoslos	originar	VMMPE
originádmela	originar	VMFSE
originádsela	originar	VMFSE
originádnosla	originar	VMFSE
origináosla	originar	VMFSE
originádmelas	originar	VMFPE
originádselas	originar	VMFPE
originádnoslas	originar	VMFPE
origináoslas	originar	VMFPE
originado	originar	VPM
originados	originar	VPMP
originada	originar	VPF
originadas	originar	VPFP
originando	originar	VG
originándome	originar	VGSE
originándote	originar	VGSE
originándole	originar	VGSE
originándonos	originar	VGPE
originándoos	originar	VGPE
originándolo	originar	VGMSE
originándola	originar	VGFSE
originándolos	originar	VGMPE
originándolas	originar	VGFPE
originándomelo	originar	VGMSE
originándotelo	originar	VGMSE
originándoselo	originar	VGMSE
originándonoslo	originar	VGMSE
originándooslo	originar	VGMSE
originándomelos	originar	VGMPE
originándotelos	originar	VGMPE
originándoselos	originar	VGMPE
originándonoslos	originar	VGMPE
originándooslos	originar	VGMPE
originándomela	originar	VGFSE
originándotela	originar	VGFSE
originándosela	originar	VGFSE
originándonosla	originar	VGFSE
originándoosla	originar	VGFSE
originándomelas	originar	VGFPE
originándotelas	originar	VGFPE
originándoselas	originar	VGFPE
originándonoslas	originar	VGFPE
originándooslas	originar	VGFPE
orillar	orillar	O
orillo	orillar	VIP1
orillas	orillar	VIP2
orilla	orillar	VIP3
orillamos	orillar	VIP4
orilláis	orillar	VIP5
orillan	orillar	VIP6
orillaba	orillar	VII1
orillabas	orillar	VII2
orillábamos	orillar	VII4
orillabais	orillar	VII5
orillaban	orillar	VII6
orillaré	orillar	VIF1
orillarás	orillar	VIF2
orillará	orillar	VIF3
orillaremos	orillar	VIF4
orillaréis	orillar	VIF5
orillarán	orillar	VIF6
orillaría	orillar	VIC1
orillarías	orillar	VIC2
orillaría	orillar	VIC3
orillaríamos	orillar	VIC4
orillaríais	orillar	VIC5
orillarían	orillar	VIC6
orillé	orillar	VIX1
orillaste	orillar	VIX2
orilló	orillar	VIX3
orillasteis	orillar	VIX5
orillaron	orillar	VIX6
orille	orillar	VSP1
orilles	orillar	VSP2
orillemos	orillar	VSP4
orilléis	orillar	VSP5
orillen	orillar	VSP6
orillara	orillar	VSX1
orillaras	orillar	VSX2
orilláramos	orillar	VSX4
orillarais	orillar	VSX5
orillaran	orillar	VSX6
orillare	orillar	VSF1
orillares	orillar	VSF2
orilláremos	orillar	VSF4
orillareis	orillar	VSF5
orillaren	orillar	VSF6
orillase	orillar	VSI1
orillases	orillar	VSI2
orillásemos	orillar	VSI4
orillaseis	orillar	VSI5
orillasen	orillar	VSI6
orillad	orillar	VMP
orilladme	orillar	VMSE
orilladle	orillar	VMSE
orilladnos	orillar	VMPE
orillaos	orillar	VMPE
orilladles	orillar	VMPE
orilladlo	orillar	VMMSE
orilladla	orillar	VMFSE
orilladlos	orillar	VMMPE
orilladlas	orillar	VMFPE
orilládmelo	orillar	VMMSE
orilládselo	orillar	VMMSE
orilládnoslo	orillar	VMMSE
orilláoslo	orillar	VMMSE
orilládmelos	orillar	VMMPE
orilládselos	orillar	VMMPE
orilládnoslos	orillar	VMMPE
orilláoslos	orillar	VMMPE
orilládmela	orillar	VMFSE
orilládsela	orillar	VMFSE
orilládnosla	orillar	VMFSE
orilláosla	orillar	VMFSE
orilládmelas	orillar	VMFPE
orilládselas	orillar	VMFPE
orilládnoslas	orillar	VMFPE
orilláoslas	orillar	VMFPE
orillado	orillar	VPM
orillados	orillar	VPMP
orillada	orillar	VPF
orilladas	orillar	VPFP
orillando	orillar	VG
orillándome	orillar	VGSE
orillándote	orillar	VGSE
orillándole	orillar	VGSE
orillándonos	orillar	VGPE
orillándoos	orillar	VGPE
orillándolo	orillar	VGMSE
orillándola	orillar	VGFSE
orillándolos	orillar	VGMPE
orillándolas	orillar	VGFPE
orillándomelo	orillar	VGMSE
orillándotelo	orillar	VGMSE
orillándoselo	orillar	VGMSE
orillándonoslo	orillar	VGMSE
orillándooslo	orillar	VGMSE
orillándomelos	orillar	VGMPE
orillándotelos	orillar	VGMPE
orillándoselos	orillar	VGMPE
orillándonoslos	orillar	VGMPE
orillándooslos	orillar	VGMPE
orillándomela	orillar	VGFSE
orillándotela	orillar	VGFSE
orillándosela	orillar	VGFSE
orillándonosla	orillar	VGFSE
orillándoosla	orillar	VGFSE
orillándomelas	orillar	VGFPE
orillándotelas	orillar	VGFPE
orillándoselas	orillar	VGFPE
orillándonoslas	orillar	VGFPE
orillándooslas	orillar	VGFPE
orinar	orinar	O
orino	orinar	VIP1
orinas	orinar	VIP2
orina	orinar	VIP3
orinamos	orinar	VIP4
orináis	orinar	VIP5
orinan	orinar	VIP6
orinaba	orinar	VII1
orinabas	orinar	VII2
orinábamos	orinar	VII4
orinabais	orinar	VII5
orinaban	orinar	VII6
orinaré	orinar	VIF1
orinarás	orinar	VIF2
orinará	orinar	VIF3
orinaremos	orinar	VIF4
orinaréis	orinar	VIF5
orinarán	orinar	VIF6
orinaría	orinar	VIC1
orinarías	orinar	VIC2
orinaría	orinar	VIC3
orinaríamos	orinar	VIC4
orinaríais	orinar	VIC5
orinarían	orinar	VIC6
oriné	orinar	VIX1
orinaste	orinar	VIX2
orinó	orinar	VIX3
orinasteis	orinar	VIX5
orinaron	orinar	VIX6
orine	orinar	VSP1
orines	orinar	VSP2
orinemos	orinar	VSP4
orinéis	orinar	VSP5
orinen	orinar	VSP6
orinara	orinar	VSX1
orinaras	orinar	VSX2
orináramos	orinar	VSX4
orinarais	orinar	VSX5
orinaran	orinar	VSX6
orinare	orinar	VSF1
orinares	orinar	VSF2
orináremos	orinar	VSF4
orinareis	orinar	VSF5
orinaren	orinar	VSF6
orinase	orinar	VSI1
orinases	orinar	VSI2
orinásemos	orinar	VSI4
orinaseis	orinar	VSI5
orinasen	orinar	VSI6
orinad	orinar	VMP
orinadme	orinar	VMSE
orinadle	orinar	VMSE
orinadnos	orinar	VMPE
orinaos	orinar	VMPE
orinadles	orinar	VMPE
orinadlo	orinar	VMMSE
orinadla	orinar	VMFSE
orinadlos	orinar	VMMPE
orinadlas	orinar	VMFPE
orinádmelo	orinar	VMMSE
orinádselo	orinar	VMMSE
orinádnoslo	orinar	VMMSE
orináoslo	orinar	VMMSE
orinádmelos	orinar	VMMPE
orinádselos	orinar	VMMPE
orinádnoslos	orinar	VMMPE
orináoslos	orinar	VMMPE
orinádmela	orinar	VMFSE
orinádsela	orinar	VMFSE
orinádnosla	orinar	VMFSE
orináosla	orinar	VMFSE
orinádmelas	orinar	VMFPE
orinádselas	orinar	VMFPE
orinádnoslas	orinar	VMFPE
orináoslas	orinar	VMFPE
orinado	orinar	VPM
orinados	orinar	VPMP
orinada	orinar	VPF
orinadas	orinar	VPFP
orinando	orinar	VG
orinándome	orinar	VGSE
orinándote	orinar	VGSE
orinándole	orinar	VGSE
orinándonos	orinar	VGPE
orinándoos	orinar	VGPE
orinándolo	orinar	VGMSE
orinándola	orinar	VGFSE
orinándolos	orinar	VGMPE
orinándolas	orinar	VGFPE
orinándomelo	orinar	VGMSE
orinándotelo	orinar	VGMSE
orinándoselo	orinar	VGMSE
orinándonoslo	orinar	VGMSE
orinándooslo	orinar	VGMSE
orinándomelos	orinar	VGMPE
orinándotelos	orinar	VGMPE
orinándoselos	orinar	VGMPE
orinándonoslos	orinar	VGMPE
orinándooslos	orinar	VGMPE
orinándomela	orinar	VGFSE
orinándotela	orinar	VGFSE
orinándosela	orinar	VGFSE
orinándonosla	orinar	VGFSE
orinándoosla	orinar	VGFSE
orinándomelas	orinar	VGFPE
orinándotelas	orinar	VGFPE
orinándoselas	orinar	VGFPE
orinándonoslas	orinar	VGFPE
orinándooslas	orinar	VGFPE
