osa	osa	O
osas	osa	P
osadamente	osadamente	O
osado	osado	O
osadas	osado	FP
osada	osado	F
osados	osado	P
osadía	osadía	O
osadías	osadía	P
osambre	osambre	O
osambres	osambre	P
osamenta	osamenta	O
osamentas	osamenta	P
osario	osario	O
osarios	osario	P
osas	oso	FP
osa	oso	F
osar	osar	O
osas	osar	VIP2
osa	osar	VIP3
osamos	osar	VIP4
osáis	osar	VIP5
osan	osar	VIP6
osaba	osar	VII1
osabas	osar	VII2
osábamos	osar	VII4
osabais	osar	VII5
osaban	osar	VII6
osaré	osar	VIF1
osarás	osar	VIF2
osará	osar	VIF3
osaremos	osar	VIF4
osaréis	osar	VIF5
osarán	osar	VIF6
osaría	osar	VIC1
osarías	osar	VIC2
osaría	osar	VIC3
osaríamos	osar	VIC4
osaríais	osar	VIC5
osarían	osar	VIC6
osaste	osar	VIX2
osasteis	osar	VIX5
osaron	osar	VIX6
osara	osar	VSX1
osaras	osar	VSX2
osáramos	osar	VSX4
osarais	osar	VSX5
osaran	osar	VSX6
osare	osar	VSF1
osares	osar	VSF2
osáremos	osar	VSF4
osareis	osar	VSF5
osaren	osar	VSF6
osase	osar	VSI1
osases	osar	VSI2
osásemos	osar	VSI4
osaseis	osar	VSI5
osasen	osar	VSI6
osad	osar	VMP
osadme	osar	VMSE
osadle	osar	VMSE
osadnos	osar	VMPE
osaos	osar	VMPE
osadles	osar	VMPE
osadlo	osar	VMMSE
osadla	osar	VMFSE
osadlos	osar	VMMPE
osadlas	osar	VMFPE
osádmelo	osar	VMMSE
osádselo	osar	VMMSE
osádnoslo	osar	VMMSE
osáoslo	osar	VMMSE
osádmelos	osar	VMMPE
osádselos	osar	VMMPE
osádnoslos	osar	VMMPE
osáoslos	osar	VMMPE
osádmela	osar	VMFSE
osádsela	osar	VMFSE
osádnosla	osar	VMFSE
osáosla	osar	VMFSE
osádmelas	osar	VMFPE
osádselas	osar	VMFPE
osádnoslas	osar	VMFPE
osáoslas	osar	VMFPE
osado	osar	VPM
osados	osar	VPMP
osada	osar	VPF
osadas	osar	VPFP
osando	osar	VG
osándome	osar	VGSE
osándote	osar	VGSE
osándole	osar	VGSE
osándonos	osar	VGPE
osándoos	osar	VGPE
osándolo	osar	VGMSE
osándola	osar	VGFSE
osándolos	osar	VGMPE
osándolas	osar	VGFPE
osándomelo	osar	VGMSE
osándotelo	osar	VGMSE
osándoselo	osar	VGMSE
osándonoslo	osar	VGMSE
osándooslo	osar	VGMSE
osándomelos	osar	VGMPE
osándotelos	osar	VGMPE
osándoselos	osar	VGMPE
osándonoslos	osar	VGMPE
osándooslos	osar	VGMPE
osándomela	osar	VGFSE
osándotela	osar	VGFSE
osándosela	osar	VGFSE
osándonosla	osar	VGFSE
osándoosla	osar	VGFSE
osándomelas	osar	VGFPE
osándotelas	osar	VGFPE
osándoselas	osar	VGFPE
osándonoslas	osar	VGFPE
osándooslas	osar	VGFPE
osares	osar	P
