raja	raja	O
rajas	raja	P
rajable	rajable	O
rajables	rajable	P
rajabroqueles	rajabroqueles	O
rajada	rajada	O
rajadas	rajada	P
rajadillo	rajadillo	O
rajadillos	rajadillo	P
rajadizo	rajadizo	O
rajadizas	rajadizo	FP
rajadiza	rajadizo	F
rajadizos	rajadizo	P
rajado	rajado	O
rajadas	rajado	FP
rajada	rajado	F
rajados	rajado	P
rajador	rajador	O
rajadores	rajador	P
rajadura	rajadura	O
rajaduras	rajadura	P
rajatabla	rajatabla	O
rajatablas	rajatabla	P
raje	raje	O
rajes	raje	P
rajeta	rajeta	O
rajetas	rajeta	P
rajonada	rajonada	O
rajonadas	rajonada	P
rajuela	rajuela	O
rajuelas	rajuela	P
rajá	rajá	O
rajás	rajá	P
rajón	rajón	O
rajonas	rajón	FP
rajona	rajón	F
rajones	rajón	P
rajar	rajar	O
rajo	rajar	VIP1
rajas	rajar	VIP2
raja	rajar	VIP3
rajamos	rajar	VIP4
rajáis	rajar	VIP5
rajan	rajar	VIP6
rajaba	rajar	VII1
rajabas	rajar	VII2
rajábamos	rajar	VII4
rajabais	rajar	VII5
rajaban	rajar	VII6
rajaré	rajar	VIF1
rajarás	rajar	VIF2
rajará	rajar	VIF3
rajaremos	rajar	VIF4
rajaréis	rajar	VIF5
rajarán	rajar	VIF6
rajaría	rajar	VIC1
rajarías	rajar	VIC2
rajaría	rajar	VIC3
rajaríamos	rajar	VIC4
rajaríais	rajar	VIC5
rajarían	rajar	VIC6
rajé	rajar	VIX1
rajaste	rajar	VIX2
rajó	rajar	VIX3
rajasteis	rajar	VIX5
rajaron	rajar	VIX6
raje	rajar	VSP1
rajes	rajar	VSP2
rajemos	rajar	VSP4
rajéis	rajar	VSP5
rajen	rajar	VSP6
rajara	rajar	VSX1
rajaras	rajar	VSX2
rajáramos	rajar	VSX4
rajarais	rajar	VSX5
rajaran	rajar	VSX6
rajare	rajar	VSF1
rajares	rajar	VSF2
rajáremos	rajar	VSF4
rajareis	rajar	VSF5
rajaren	rajar	VSF6
rajase	rajar	VSI1
rajases	rajar	VSI2
rajásemos	rajar	VSI4
rajaseis	rajar	VSI5
rajasen	rajar	VSI6
rajad	rajar	VMP
rajadme	rajar	VMSE
rajadle	rajar	VMSE
rajadnos	rajar	VMPE
rajaos	rajar	VMPE
rajadles	rajar	VMPE
rajadlo	rajar	VMMSE
rajadla	rajar	VMFSE
rajadlos	rajar	VMMPE
rajadlas	rajar	VMFPE
rajádmelo	rajar	VMMSE
rajádselo	rajar	VMMSE
rajádnoslo	rajar	VMMSE
rajáoslo	rajar	VMMSE
rajádmelos	rajar	VMMPE
rajádselos	rajar	VMMPE
rajádnoslos	rajar	VMMPE
rajáoslos	rajar	VMMPE
rajádmela	rajar	VMFSE
rajádsela	rajar	VMFSE
rajádnosla	rajar	VMFSE
rajáosla	rajar	VMFSE
rajádmelas	rajar	VMFPE
rajádselas	rajar	VMFPE
rajádnoslas	rajar	VMFPE
rajáoslas	rajar	VMFPE
rajado	rajar	VPM
rajados	rajar	VPMP
rajada	rajar	VPF
rajadas	rajar	VPFP
rajando	rajar	VG
rajándome	rajar	VGSE
rajándote	rajar	VGSE
rajándole	rajar	VGSE
rajándonos	rajar	VGPE
rajándoos	rajar	VGPE
rajándolo	rajar	VGMSE
rajándola	rajar	VGFSE
rajándolos	rajar	VGMPE
rajándolas	rajar	VGFPE
rajándomelo	rajar	VGMSE
rajándotelo	rajar	VGMSE
rajándoselo	rajar	VGMSE
rajándonoslo	rajar	VGMSE
rajándooslo	rajar	VGMSE
rajándomelos	rajar	VGMPE
rajándotelos	rajar	VGMPE
rajándoselos	rajar	VGMPE
rajándonoslos	rajar	VGMPE
rajándooslos	rajar	VGMPE
rajándomela	rajar	VGFSE
rajándotela	rajar	VGFSE
rajándosela	rajar	VGFSE
rajándonosla	rajar	VGFSE
rajándoosla	rajar	VGFSE
rajándomelas	rajar	VGFPE
rajándotelas	rajar	VGFPE
rajándoselas	rajar	VGFPE
rajándonoslas	rajar	VGFPE
rajándooslas	rajar	VGFPE
