racamenta	racamenta	O
racamentas	racamenta	P
racamento	racamento	O
racamentos	racamento	P
racanería	racanería	O
racanerías	racanería	P
racel	racel	O
raceles	racel	P
racha	racha	O
rachas	racha	P
racheado	racheado	O
racheados	racheado	P
racial	racial	O
raciales	racial	P
racima	racima	O
racimas	racima	P
racimado	racimado	O
racimadas	racimado	FP
racimada	racimado	F
racimados	racimado	P
racimal	racimal	O
racimales	racimal	P
racimo	racimo	O
racimos	racimo	P
racimoso	racimoso	O
racimosas	racimoso	FP
racimosa	racimoso	F
racimosos	racimoso	P
racimudo	racimudo	O
racimudas	racimudo	FP
racimuda	racimudo	F
racimudos	racimudo	P
raciocinación	raciocinación	O
raciocinaciones	raciocinación	P
raciocinio	raciocinio	O
raciocinios	raciocinio	P
racionabilidad	racionabilidad	O
racionabilidades	racionabilidad	P
racional	racional	O
racionales	racional	P
racionalidad	racionalidad	O
racionalidades	racionalidad	P
racionalismo	racionalismo	O
racionalismos	racionalismo	P
racionalista	racionalista	O
racionalistas	racionalista	P
racionalización	racionalización	O
racionalizaciones	racionalización	P
racionalmente	racionalmente	O
racionamiento	racionamiento	O
racionamientos	racionamiento	P
racionero	racionero	O
racioneros	racionero	P
racionista	racionista	O
racionistas	racionista	P
racismo	racismo	O
racismos	racismo	P
racista	racista	O
racistas	racista	P
ración	ración	O
raciones	ración	P
racor	racor	O
racores	racor	P
rácano	rácano	O
rácanas	rácano	FP
rácana	rácano	F
rácanos	rácano	P
racanear	racanear	O
racaneo	racanear	VIP1
racaneas	racanear	VIP2
racanea	racanear	VIP3
racaneamos	racanear	VIP4
racaneáis	racanear	VIP5
racanean	racanear	VIP6
racaneaba	racanear	VII1
racaneabas	racanear	VII2
racaneábamos	racanear	VII4
racaneabais	racanear	VII5
racaneaban	racanear	VII6
racanearé	racanear	VIF1
racanearás	racanear	VIF2
racaneará	racanear	VIF3
racanearemos	racanear	VIF4
racanearéis	racanear	VIF5
racanearán	racanear	VIF6
racanearía	racanear	VIC1
racanearías	racanear	VIC2
racanearía	racanear	VIC3
racanearíamos	racanear	VIC4
racanearíais	racanear	VIC5
racanearían	racanear	VIC6
racaneé	racanear	VIX1
racaneaste	racanear	VIX2
racaneó	racanear	VIX3
racaneasteis	racanear	VIX5
racanearon	racanear	VIX6
racanee	racanear	VSP1
racanees	racanear	VSP2
racaneemos	racanear	VSP4
racaneéis	racanear	VSP5
racaneen	racanear	VSP6
racaneara	racanear	VSX1
racanearas	racanear	VSX2
racaneáramos	racanear	VSX4
racanearais	racanear	VSX5
racanearan	racanear	VSX6
racaneare	racanear	VSF1
racaneares	racanear	VSF2
racaneáremos	racanear	VSF4
racaneareis	racanear	VSF5
racanearen	racanear	VSF6
racanease	racanear	VSI1
racaneases	racanear	VSI2
racaneásemos	racanear	VSI4
racaneaseis	racanear	VSI5
racaneasen	racanear	VSI6
racanead	racanear	VMP
racaneadme	racanear	VMSE
racaneadle	racanear	VMSE
racaneadnos	racanear	VMPE
racaneaos	racanear	VMPE
racaneadles	racanear	VMPE
racaneado	racanear	VPM
racaneados	racanear	VPMP
racaneada	racanear	VPF
racaneadas	racanear	VPFP
racaneando	racanear	VG
racaneándome	racanear	VGSE
racaneándote	racanear	VGSE
racaneándole	racanear	VGSE
racaneándonos	racanear	VGPE
racaneándoos	racanear	VGPE
rachar	rachar	O
racho	rachar	VIP1
rachas	rachar	VIP2
racha	rachar	VIP3
rachamos	rachar	VIP4
racháis	rachar	VIP5
rachan	rachar	VIP6
rachaba	rachar	VII1
rachabas	rachar	VII2
rachábamos	rachar	VII4
rachabais	rachar	VII5
rachaban	rachar	VII6
racharé	rachar	VIF1
racharás	rachar	VIF2
rachará	rachar	VIF3
racharemos	rachar	VIF4
racharéis	rachar	VIF5
racharán	rachar	VIF6
racharía	rachar	VIC1
racharías	rachar	VIC2
racharía	rachar	VIC3
racharíamos	rachar	VIC4
racharíais	rachar	VIC5
racharían	rachar	VIC6
raché	rachar	VIX1
rachaste	rachar	VIX2
rachó	rachar	VIX3
rachasteis	rachar	VIX5
racharon	rachar	VIX6
rache	rachar	VSP1
raches	rachar	VSP2
rachemos	rachar	VSP4
rachéis	rachar	VSP5
rachen	rachar	VSP6
rachara	rachar	VSX1
racharas	rachar	VSX2
racháramos	rachar	VSX4
racharais	rachar	VSX5
racharan	rachar	VSX6
rachare	rachar	VSF1
rachares	rachar	VSF2
racháremos	rachar	VSF4
rachareis	rachar	VSF5
racharen	rachar	VSF6
rachase	rachar	VSI1
rachases	rachar	VSI2
rachásemos	rachar	VSI4
rachaseis	rachar	VSI5
rachasen	rachar	VSI6
rachad	rachar	VMP
rachadme	rachar	VMSE
rachadle	rachar	VMSE
rachadnos	rachar	VMPE
rachaos	rachar	VMPE
rachadles	rachar	VMPE
rachadlo	rachar	VMMSE
rachadla	rachar	VMFSE
rachadlos	rachar	VMMPE
rachadlas	rachar	VMFPE
rachádmelo	rachar	VMMSE
rachádselo	rachar	VMMSE
rachádnoslo	rachar	VMMSE
racháoslo	rachar	VMMSE
rachádmelos	rachar	VMMPE
rachádselos	rachar	VMMPE
rachádnoslos	rachar	VMMPE
racháoslos	rachar	VMMPE
rachádmela	rachar	VMFSE
rachádsela	rachar	VMFSE
rachádnosla	rachar	VMFSE
racháosla	rachar	VMFSE
rachádmelas	rachar	VMFPE
rachádselas	rachar	VMFPE
rachádnoslas	rachar	VMFPE
racháoslas	rachar	VMFPE
rachado	rachar	VPM
rachados	rachar	VPMP
rachada	rachar	VPF
rachadas	rachar	VPFP
rachando	rachar	VG
rachándome	rachar	VGSE
rachándote	rachar	VGSE
rachándole	rachar	VGSE
rachándonos	rachar	VGPE
rachándoos	rachar	VGPE
rachándolo	rachar	VGMSE
rachándola	rachar	VGFSE
rachándolos	rachar	VGMPE
rachándolas	rachar	VGFPE
rachándomelo	rachar	VGMSE
rachándotelo	rachar	VGMSE
rachándoselo	rachar	VGMSE
rachándonoslo	rachar	VGMSE
rachándooslo	rachar	VGMSE
rachándomelos	rachar	VGMPE
rachándotelos	rachar	VGMPE
rachándoselos	rachar	VGMPE
rachándonoslos	rachar	VGMPE
rachándooslos	rachar	VGMPE
rachándomela	rachar	VGFSE
rachándotela	rachar	VGFSE
rachándosela	rachar	VGFSE
rachándonosla	rachar	VGFSE
rachándoosla	rachar	VGFSE
rachándomelas	rachar	VGFPE
rachándotelas	rachar	VGFPE
rachándoselas	rachar	VGFPE
rachándonoslas	rachar	VGFPE
rachándooslas	rachar	VGFPE
rachear	rachear	O
racheo	rachear	VIP1
racheas	rachear	VIP2
rachea	rachear	VIP3
racheamos	rachear	VIP4
racheáis	rachear	VIP5
rachean	rachear	VIP6
racheaba	rachear	VII1
racheabas	rachear	VII2
racheábamos	rachear	VII4
racheabais	rachear	VII5
racheaban	rachear	VII6
rachearé	rachear	VIF1
rachearás	rachear	VIF2
racheará	rachear	VIF3
rachearemos	rachear	VIF4
rachearéis	rachear	VIF5
rachearán	rachear	VIF6
rachearía	rachear	VIC1
rachearías	rachear	VIC2
rachearía	rachear	VIC3
rachearíamos	rachear	VIC4
rachearíais	rachear	VIC5
rachearían	rachear	VIC6
racheé	rachear	VIX1
racheaste	rachear	VIX2
racheó	rachear	VIX3
racheasteis	rachear	VIX5
rachearon	rachear	VIX6
rachee	rachear	VSP1
rachees	rachear	VSP2
racheemos	rachear	VSP4
racheéis	rachear	VSP5
racheen	rachear	VSP6
racheara	rachear	VSX1
rachearas	rachear	VSX2
racheáramos	rachear	VSX4
rachearais	rachear	VSX5
rachearan	rachear	VSX6
racheare	rachear	VSF1
racheares	rachear	VSF2
racheáremos	rachear	VSF4
racheareis	rachear	VSF5
rachearen	rachear	VSF6
rachease	rachear	VSI1
racheases	rachear	VSI2
racheásemos	rachear	VSI4
racheaseis	rachear	VSI5
racheasen	rachear	VSI6
rachead	rachear	VMP
racheadme	rachear	VMSE
racheadle	rachear	VMSE
racheadnos	rachear	VMPE
racheaos	rachear	VMPE
racheadles	rachear	VMPE
racheado	rachear	VPM
racheados	rachear	VPMP
racheada	rachear	VPF
racheadas	rachear	VPFP
racheando	rachear	VG
racheándome	rachear	VGSE
racheándote	rachear	VGSE
racheándole	rachear	VGSE
racheándonos	rachear	VGPE
racheándoos	rachear	VGPE
racimar	racimar	O
racimo	racimar	VIP1
racimas	racimar	VIP2
racima	racimar	VIP3
racimamos	racimar	VIP4
racimáis	racimar	VIP5
raciman	racimar	VIP6
racimaba	racimar	VII1
racimabas	racimar	VII2
racimábamos	racimar	VII4
racimabais	racimar	VII5
racimaban	racimar	VII6
racimaré	racimar	VIF1
racimarás	racimar	VIF2
racimará	racimar	VIF3
racimaremos	racimar	VIF4
racimaréis	racimar	VIF5
racimarán	racimar	VIF6
racimaría	racimar	VIC1
racimarías	racimar	VIC2
racimaría	racimar	VIC3
racimaríamos	racimar	VIC4
racimaríais	racimar	VIC5
racimarían	racimar	VIC6
racimé	racimar	VIX1
racimaste	racimar	VIX2
racimó	racimar	VIX3
racimasteis	racimar	VIX5
racimaron	racimar	VIX6
racime	racimar	VSP1
racimes	racimar	VSP2
racimemos	racimar	VSP4
raciméis	racimar	VSP5
racimen	racimar	VSP6
racimara	racimar	VSX1
racimaras	racimar	VSX2
racimáramos	racimar	VSX4
racimarais	racimar	VSX5
racimaran	racimar	VSX6
racimare	racimar	VSF1
racimares	racimar	VSF2
racimáremos	racimar	VSF4
racimareis	racimar	VSF5
racimaren	racimar	VSF6
racimase	racimar	VSI1
racimases	racimar	VSI2
racimásemos	racimar	VSI4
racimaseis	racimar	VSI5
racimasen	racimar	VSI6
racimad	racimar	VMP
racimadme	racimar	VMSE
racimadle	racimar	VMSE
racimadnos	racimar	VMPE
racimaos	racimar	VMPE
racimadles	racimar	VMPE
racimadlo	racimar	VMMSE
racimadla	racimar	VMFSE
racimadlos	racimar	VMMPE
racimadlas	racimar	VMFPE
racimádmelo	racimar	VMMSE
racimádselo	racimar	VMMSE
racimádnoslo	racimar	VMMSE
racimáoslo	racimar	VMMSE
racimádmelos	racimar	VMMPE
racimádselos	racimar	VMMPE
racimádnoslos	racimar	VMMPE
racimáoslos	racimar	VMMPE
racimádmela	racimar	VMFSE
racimádsela	racimar	VMFSE
racimádnosla	racimar	VMFSE
racimáosla	racimar	VMFSE
racimádmelas	racimar	VMFPE
racimádselas	racimar	VMFPE
racimádnoslas	racimar	VMFPE
racimáoslas	racimar	VMFPE
racimado	racimar	VPM
racimados	racimar	VPMP
racimada	racimar	VPF
racimadas	racimar	VPFP
racimando	racimar	VG
racimándome	racimar	VGSE
racimándote	racimar	VGSE
racimándole	racimar	VGSE
racimándonos	racimar	VGPE
racimándoos	racimar	VGPE
racimándolo	racimar	VGMSE
racimándola	racimar	VGFSE
racimándolos	racimar	VGMPE
racimándolas	racimar	VGFPE
racimándomelo	racimar	VGMSE
racimándotelo	racimar	VGMSE
racimándoselo	racimar	VGMSE
racimándonoslo	racimar	VGMSE
racimándooslo	racimar	VGMSE
racimándomelos	racimar	VGMPE
racimándotelos	racimar	VGMPE
racimándoselos	racimar	VGMPE
racimándonoslos	racimar	VGMPE
racimándooslos	racimar	VGMPE
racimándomela	racimar	VGFSE
racimándotela	racimar	VGFSE
racimándosela	racimar	VGFSE
racimándonosla	racimar	VGFSE
racimándoosla	racimar	VGFSE
racimándomelas	racimar	VGFPE
racimándotelas	racimar	VGFPE
racimándoselas	racimar	VGFPE
racimándonoslas	racimar	VGFPE
racimándooslas	racimar	VGFPE
raciocinar	raciocinar	O
raciocino	raciocinar	VIP1
raciocinas	raciocinar	VIP2
raciocina	raciocinar	VIP3
raciocinamos	raciocinar	VIP4
raciocináis	raciocinar	VIP5
raciocinan	raciocinar	VIP6
raciocinaba	raciocinar	VII1
raciocinabas	raciocinar	VII2
raciocinábamos	raciocinar	VII4
raciocinabais	raciocinar	VII5
raciocinaban	raciocinar	VII6
raciocinaré	raciocinar	VIF1
raciocinarás	raciocinar	VIF2
raciocinará	raciocinar	VIF3
raciocinaremos	raciocinar	VIF4
raciocinaréis	raciocinar	VIF5
raciocinarán	raciocinar	VIF6
raciocinaría	raciocinar	VIC1
raciocinarías	raciocinar	VIC2
raciocinaría	raciocinar	VIC3
raciocinaríamos	raciocinar	VIC4
raciocinaríais	raciocinar	VIC5
raciocinarían	raciocinar	VIC6
raciociné	raciocinar	VIX1
raciocinaste	raciocinar	VIX2
raciocinó	raciocinar	VIX3
raciocinasteis	raciocinar	VIX5
raciocinaron	raciocinar	VIX6
raciocine	raciocinar	VSP1
raciocines	raciocinar	VSP2
raciocinemos	raciocinar	VSP4
raciocinéis	raciocinar	VSP5
raciocinen	raciocinar	VSP6
raciocinara	raciocinar	VSX1
raciocinaras	raciocinar	VSX2
raciocináramos	raciocinar	VSX4
raciocinarais	raciocinar	VSX5
raciocinaran	raciocinar	VSX6
raciocinare	raciocinar	VSF1
raciocinares	raciocinar	VSF2
raciocináremos	raciocinar	VSF4
raciocinareis	raciocinar	VSF5
raciocinaren	raciocinar	VSF6
raciocinase	raciocinar	VSI1
raciocinases	raciocinar	VSI2
raciocinásemos	raciocinar	VSI4
raciocinaseis	raciocinar	VSI5
raciocinasen	raciocinar	VSI6
raciocinad	raciocinar	VMP
raciocinadme	raciocinar	VMSE
raciocinadle	raciocinar	VMSE
raciocinadnos	raciocinar	VMPE
raciocinaos	raciocinar	VMPE
raciocinadles	raciocinar	VMPE
raciocinado	raciocinar	VPM
raciocinados	raciocinar	VPMP
raciocinada	raciocinar	VPF
raciocinadas	raciocinar	VPFP
raciocinando	raciocinar	VG
raciocinándome	raciocinar	VGSE
raciocinándote	raciocinar	VGSE
raciocinándole	raciocinar	VGSE
raciocinándonos	raciocinar	VGPE
raciocinándoos	raciocinar	VGPE
racionalizar	racionalizar	O
racionalizo	racionalizar	VIP1
racionalizas	racionalizar	VIP2
racionaliza	racionalizar	VIP3
racionalizamos	racionalizar	VIP4
racionalizáis	racionalizar	VIP5
racionalizan	racionalizar	VIP6
racionalizaba	racionalizar	VII1
racionalizabas	racionalizar	VII2
racionalizábamos	racionalizar	VII4
racionalizabais	racionalizar	VII5
racionalizaban	racionalizar	VII6
racionalizaré	racionalizar	VIF1
racionalizarás	racionalizar	VIF2
racionalizará	racionalizar	VIF3
racionalizaremos	racionalizar	VIF4
racionalizaréis	racionalizar	VIF5
racionalizarán	racionalizar	VIF6
racionalizaría	racionalizar	VIC1
racionalizarías	racionalizar	VIC2
racionalizaría	racionalizar	VIC3
racionalizaríamos	racionalizar	VIC4
racionalizaríais	racionalizar	VIC5
racionalizarían	racionalizar	VIC6
racionalicé	racionalizar	VIX1
racionalizaste	racionalizar	VIX2
racionalizó	racionalizar	VIX3
racionalizasteis	racionalizar	VIX5
racionalizaron	racionalizar	VIX6
racionalice	racionalizar	VSP1
racionalices	racionalizar	VSP2
racionalicemos	racionalizar	VSP4
racionalicéis	racionalizar	VSP5
racionalicen	racionalizar	VSP6
racionalizara	racionalizar	VSX1
racionalizaras	racionalizar	VSX2
racionalizáramos	racionalizar	VSX4
racionalizarais	racionalizar	VSX5
racionalizaran	racionalizar	VSX6
racionalizare	racionalizar	VSF1
racionalizares	racionalizar	VSF2
racionalizáremos	racionalizar	VSF4
racionalizareis	racionalizar	VSF5
racionalizaren	racionalizar	VSF6
racionalizase	racionalizar	VSI1
racionalizases	racionalizar	VSI2
racionalizásemos	racionalizar	VSI4
racionalizaseis	racionalizar	VSI5
racionalizasen	racionalizar	VSI6
racionalizad	racionalizar	VMP
racionalizadme	racionalizar	VMSE
racionalizadle	racionalizar	VMSE
racionalizadnos	racionalizar	VMPE
racionalizaos	racionalizar	VMPE
racionalizadles	racionalizar	VMPE
racionalizadlo	racionalizar	VMMSE
racionalizadla	racionalizar	VMFSE
racionalizadlos	racionalizar	VMMPE
racionalizadlas	racionalizar	VMFPE
racionalizádmelo	racionalizar	VMMSE
racionalizádselo	racionalizar	VMMSE
racionalizádnoslo	racionalizar	VMMSE
racionalizáoslo	racionalizar	VMMSE
racionalizádmelos	racionalizar	VMMPE
racionalizádselos	racionalizar	VMMPE
racionalizádnoslos	racionalizar	VMMPE
racionalizáoslos	racionalizar	VMMPE
racionalizádmela	racionalizar	VMFSE
racionalizádsela	racionalizar	VMFSE
racionalizádnosla	racionalizar	VMFSE
racionalizáosla	racionalizar	VMFSE
racionalizádmelas	racionalizar	VMFPE
racionalizádselas	racionalizar	VMFPE
racionalizádnoslas	racionalizar	VMFPE
racionalizáoslas	racionalizar	VMFPE
racionalizado	racionalizar	VPM
racionalizados	racionalizar	VPMP
racionalizada	racionalizar	VPF
racionalizadas	racionalizar	VPFP
racionalizando	racionalizar	VG
racionalizándome	racionalizar	VGSE
racionalizándote	racionalizar	VGSE
racionalizándole	racionalizar	VGSE
racionalizándonos	racionalizar	VGPE
racionalizándoos	racionalizar	VGPE
racionalizándolo	racionalizar	VGMSE
racionalizándola	racionalizar	VGFSE
racionalizándolos	racionalizar	VGMPE
racionalizándolas	racionalizar	VGFPE
racionalizándomelo	racionalizar	VGMSE
racionalizándotelo	racionalizar	VGMSE
racionalizándoselo	racionalizar	VGMSE
racionalizándonoslo	racionalizar	VGMSE
racionalizándooslo	racionalizar	VGMSE
racionalizándomelos	racionalizar	VGMPE
racionalizándotelos	racionalizar	VGMPE
racionalizándoselos	racionalizar	VGMPE
racionalizándonoslos	racionalizar	VGMPE
racionalizándooslos	racionalizar	VGMPE
racionalizándomela	racionalizar	VGFSE
racionalizándotela	racionalizar	VGFSE
racionalizándosela	racionalizar	VGFSE
racionalizándonosla	racionalizar	VGFSE
racionalizándoosla	racionalizar	VGFSE
racionalizándomelas	racionalizar	VGFPE
racionalizándotelas	racionalizar	VGFPE
racionalizándoselas	racionalizar	VGFPE
racionalizándonoslas	racionalizar	VGFPE
racionalizándooslas	racionalizar	VGFPE
racionar	racionar	O
raciono	racionar	VIP1
racionas	racionar	VIP2
raciona	racionar	VIP3
racionamos	racionar	VIP4
racionáis	racionar	VIP5
racionan	racionar	VIP6
racionaba	racionar	VII1
racionabas	racionar	VII2
racionábamos	racionar	VII4
racionabais	racionar	VII5
racionaban	racionar	VII6
racionaré	racionar	VIF1
racionarás	racionar	VIF2
racionará	racionar	VIF3
racionaremos	racionar	VIF4
racionaréis	racionar	VIF5
racionarán	racionar	VIF6
racionaría	racionar	VIC1
racionarías	racionar	VIC2
racionaría	racionar	VIC3
racionaríamos	racionar	VIC4
racionaríais	racionar	VIC5
racionarían	racionar	VIC6
racioné	racionar	VIX1
racionaste	racionar	VIX2
racionó	racionar	VIX3
racionasteis	racionar	VIX5
racionaron	racionar	VIX6
racione	racionar	VSP1
raciones	racionar	VSP2
racionemos	racionar	VSP4
racionéis	racionar	VSP5
racionen	racionar	VSP6
racionara	racionar	VSX1
racionaras	racionar	VSX2
racionáramos	racionar	VSX4
racionarais	racionar	VSX5
racionaran	racionar	VSX6
racionare	racionar	VSF1
racionares	racionar	VSF2
racionáremos	racionar	VSF4
racionareis	racionar	VSF5
racionaren	racionar	VSF6
racionase	racionar	VSI1
racionases	racionar	VSI2
racionásemos	racionar	VSI4
racionaseis	racionar	VSI5
racionasen	racionar	VSI6
racionad	racionar	VMP
racionadme	racionar	VMSE
racionadle	racionar	VMSE
racionadnos	racionar	VMPE
racionaos	racionar	VMPE
racionadles	racionar	VMPE
racionadlo	racionar	VMMSE
racionadla	racionar	VMFSE
racionadlos	racionar	VMMPE
racionadlas	racionar	VMFPE
racionádmelo	racionar	VMMSE
racionádselo	racionar	VMMSE
racionádnoslo	racionar	VMMSE
racionáoslo	racionar	VMMSE
racionádmelos	racionar	VMMPE
racionádselos	racionar	VMMPE
racionádnoslos	racionar	VMMPE
racionáoslos	racionar	VMMPE
racionádmela	racionar	VMFSE
racionádsela	racionar	VMFSE
racionádnosla	racionar	VMFSE
racionáosla	racionar	VMFSE
racionádmelas	racionar	VMFPE
racionádselas	racionar	VMFPE
racionádnoslas	racionar	VMFPE
racionáoslas	racionar	VMFPE
racionado	racionar	VPM
racionados	racionar	VPMP
racionada	racionar	VPF
racionadas	racionar	VPFP
racionando	racionar	VG
racionándome	racionar	VGSE
racionándote	racionar	VGSE
racionándole	racionar	VGSE
racionándonos	racionar	VGPE
racionándoos	racionar	VGPE
racionándolo	racionar	VGMSE
racionándola	racionar	VGFSE
racionándolos	racionar	VGMPE
racionándolas	racionar	VGFPE
racionándomelo	racionar	VGMSE
racionándotelo	racionar	VGMSE
racionándoselo	racionar	VGMSE
racionándonoslo	racionar	VGMSE
racionándooslo	racionar	VGMSE
racionándomelos	racionar	VGMPE
racionándotelos	racionar	VGMPE
racionándoselos	racionar	VGMPE
racionándonoslos	racionar	VGMPE
racionándooslos	racionar	VGMPE
racionándomela	racionar	VGFSE
racionándotela	racionar	VGFSE
racionándosela	racionar	VGFSE
racionándonosla	racionar	VGFSE
racionándoosla	racionar	VGFSE
racionándomelas	racionar	VGFPE
racionándotelas	racionar	VGFPE
racionándoselas	racionar	VGFPE
racionándonoslas	racionar	VGFPE
racionándooslas	racionar	VGFPE
racé	razar	VIX1
race	razar	VSP1
races	razar	VSP2
racemos	razar	VSP4
racéis	razar	VSP5
racen	razar	VSP6
