remachado	remachado	O
remachadas	remachado	FP
remachada	remachado	F
remachados	remachado	P
remachador	remachador	O
remachadoras	remachador	FP
remachadora	remachador	F
remachadores	remachador	P
remache	remache	O
remaches	remache	P
remador	remador	O
remadoras	remador	FP
remadora	remador	F
remadores	remador	P
remadura	remadura	O
remaduras	remadura	P
remamiento	remamiento	O
remamientos	remamiento	P
remanal	remanal	O
remanales	remanal	P
remanente	remanente	O
remanentes	remanente	P
remanga	remanga	O
remangas	remanga	P
remangado	remangado	O
remangadas	remangado	FP
remangada	remangado	F
remangados	remangado	P
remango	remango	O
remangos	remango	P
remanguillé	remanguillé	O
remanguillés	remanguillé	P
remanoso	remanoso	O
remanosas	remanoso	FP
remanosa	remanoso	F
remanosos	remanoso	P
remanso	remanso	O
remansos	remanso	P
remasa	remasa	O
remasas	remasa	P
rematadamente	rematadamente	O
rematado	rematado	O
rematadas	rematado	FP
rematada	rematado	F
rematados	rematado	P
rematador	rematador	O
rematadoras	rematador	FP
rematadora	rematador	F
rematadores	rematador	P
rematamiento	rematamiento	O
rematamientos	rematamiento	P
rematante	rematante	O
rematantes	rematante	P
remate	remate	O
remates	remate	P
rembolso	rembolso	O
rembolsos	rembolso	P
remecedor	remecedor	O
remecedoras	remecedor	FP
remecedora	remecedor	F
remecedores	remecedor	P
remedable	remedable	O
remedables	remedable	P
remedador	remedador	O
remedadoras	remedador	FP
remedadora	remedador	F
remedadores	remedador	P
remediable	remediable	O
remediables	remediable	P
remediador	remediador	O
remediadoras	remediador	FP
remediadora	remediador	F
remediadores	remediador	P
remediavagos	remediavagos	O
remedición	remedición	O
remediciones	remedición	P
remedio	remedio	O
remedios	remedio	P
remedión	remedión	O
remediones	remedión	P
remedo	remedo	O
remedos	remedo	P
remellado	remellado	O
remelladas	remellado	FP
remellada	remellado	F
remellados	remellado	P
remellón	remellón	O
remellonas	remellón	FP
remellona	remellón	F
remellones	remellón	P
remembranza	remembranza	O
remembranzas	remembranza	P
rememoración	rememoración	O
rememoraciones	rememoración	P
rememorativo	rememorativo	O
rememorativas	rememorativo	FP
rememorativa	rememorativo	F
rememorativos	rememorativo	P
remendado	remendado	O
remendadas	remendado	FP
remendada	remendado	F
remendados	remendado	P
remendón	remendón	O
remendonas	remendón	FP
remendona	remendón	F
remendones	remendón	P
remeneo	remeneo	O
remeneos	remeneo	P
remense	remense	O
remenses	remense	P
remero	remero	O
remeras	remero	FP
remera	remero	F
remeros	remero	P
remesa	remesa	O
remesas	remesa	P
remesón	remesón	O
remesones	remesón	P
remezón	remezón	O
remezones	remezón	P
remiche	remiche	O
remiches	remiche	P
remiel	remiel	O
remieles	remiel	P
remiendo	remiendo	O
remiendos	remiendo	P
remilgadamente	remilgadamente	O
remilgado	remilgado	O
remilgadas	remilgado	FP
remilgada	remilgado	F
remilgados	remilgado	P
remilgo	remilgo	O
remilgos	remilgo	P
remillón	remillón	O
remillones	remillón	P
reminiscencia	reminiscencia	O
reminiscencias	reminiscencia	P
remirado	remirado	O
remiradas	remirado	FP
remirada	remirado	F
remirados	remirado	P
remisamente	remisamente	O
remisible	remisible	O
remisibles	remisible	P
remisivamente	remisivamente	O
remisivo	remisivo	O
remisivas	remisivo	FP
remisiva	remisivo	F
remisivos	remisivo	P
remisión	remisión	O
remisiones	remisión	P
remiso	remiso	O
remisas	remiso	FP
remisa	remiso	F
remisos	remiso	P
remisorio	remisorio	O
remisorias	remisorio	FP
remisoria	remisorio	F
remisorios	remisorio	P
remite	remite	O
remites	remite	P
remitente	remitente	O
remitentes	remitente	P
remitido	remitido	O
remitidos	remitido	P
remo	remo	O
remos	remo	P
remocho	remocho	O
remochos	remocho	P
remoción	remoción	O
remociones	remoción	P
remodelación	remodelación	O
remodelaciones	remodelación	P
remojadero	remojadero	O
remojaderos	remojadero	P
remojo	remojo	O
remojos	remojo	P
remojón	remojón	O
remojones	remojón	P
remolacha	remolacha	O
remolachas	remolacha	P
remolachero	remolachero	O
remolacheras	remolachero	FP
remolachera	remolachero	F
remolacheros	remolachero	P
remolar	remolar	O
remolares	remolar	P
remolcador	remolcador	O
remolcadoras	remolcador	FP
remolcadora	remolcador	F
remolcadores	remolcador	P
remolda	remolda	O
remoldas	remolda	P
remolido	remolido	O
remolidos	remolido	P
remolienda	remolienda	O
remoliendas	remolienda	P
remolimiento	remolimiento	O
remolimientos	remolimiento	P
remolino	remolino	O
remolinos	remolino	P
remollero	remollero	O
remolleros	remollero	P
remolque	remolque	O
remolques	remolque	P
remolón	remolón	O
remolonas	remolón	FP
remolona	remolón	F
remolones	remolón	P
remonta	remonta	O
remontas	remonta	P
remontado	remontado	O
remontados	remontado	P
remontamiento	remontamiento	O
remontamientos	remontamiento	P
remonte	remonte	O
remontes	remonte	P
remontista	remontista	O
remontistas	remontista	P
remoque	remoque	O
remoques	remoque	P
remoquete	remoquete	O
remoquetes	remoquete	P
remordedor	remordedor	O
remordedoras	remordedor	FP
remordedora	remordedor	F
remordedores	remordedor	P
remordimiento	remordimiento	O
remordimientos	remordimiento	P
remosto	remosto	O
remostos	remosto	P
remotamente	remotamente	O
remotidad	remotidad	O
remotidades	remotidad	P
remoto	remoto	O
remotas	remoto	FP
remota	remoto	F
remotos	remoto	P
removimiento	removimiento	O
removimientos	removimiento	P
remozamiento	remozamiento	O
remozamientos	remozamiento	P
remplazo	remplazo	O
remplazos	remplazo	P
rempujo	rempujo	O
rempujos	rempujo	P
rempujón	rempujón	O
rempujones	rempujón	P
remuda	remuda	O
remudas	remuda	P
remudamiento	remudamiento	O
remudamientos	remudamiento	P
remuneración	remuneración	O
remuneraciones	remuneración	P
remunerador	remunerador	O
remuneradoras	remunerador	FP
remuneradora	remunerador	F
remuneradores	remunerador	P
remunerativo	remunerativo	O
remunerativas	remunerativo	FP
remunerativa	remunerativo	F
remunerativos	remunerativo	P
remuneratorio	remuneratorio	O
remuneratorias	remuneratorio	FP
remuneratoria	remuneratorio	F
remuneratorios	remuneratorio	P
remusgo	remusgo	O
remusgos	remusgo	P
rémige	rémige	O
rémiges	rémige	P
rémora	rémora	O
rémoras	rémora	P
remanir	remanir	O
remano	remanir	VIP1
remanes	remanir	VIP2
remane	remanir	VIP3
remanimos	remanir	VIP4
remanís	remanir	VIP5
remanen	remanir	VIP6
remanía	remanir	VII1
remanías	remanir	VII2
remaníamos	remanir	VII4
remaníais	remanir	VII5
remanían	remanir	VII6
remaniré	remanir	VIF1
remanirás	remanir	VIF2
remanirá	remanir	VIF3
remaniremos	remanir	VIF4
remaniréis	remanir	VIF5
remanirán	remanir	VIF6
remaniría	remanir	VIC1
remanirías	remanir	VIC2
remaniría	remanir	VIC3
remaniríamos	remanir	VIC4
remaniríais	remanir	VIC5
remanirían	remanir	VIC6
remaní	remanir	VIX1
remaníste	remanir	VIX2
remanió	remanir	VIX3
remanisteis	remanir	VIX5
remanieron	remanir	VIX6
remana	remanir	VSP1
remanas	remanir	VSP2
remanamos	remanir	VSP4
remanáis	remanir	VSP5
remanan	remanir	VSP6
remaniera	remanir	VSX1
remanieras	remanir	VSX2
remaniéramos	remanir	VSX4
remanierais	remanir	VSX5
remanieran	remanir	VSX6
remaniere	remanir	VSF1
remanieres	remanir	VSF2
remaniéremos	remanir	VSF4
remaniereis	remanir	VSF5
remanieren	remanir	VSF6
remaniese	remanir	VSI1
remanieses	remanir	VSI2
remaniésemos	remanir	VSI4
remanieseis	remanir	VSI5
remaniesen	remanir	VSI6
remanid	remanir	VMP
remanidme	remanir	VMSE
remanidle	remanir	VMSE
remanidnos	remanir	VMPE
remanios	remanir	VMPE
remanidles	remanir	VMPE
remanido	remanir	VPM
remanidos	remanir	VPMP
remanida	remanir	VPF
remanidas	remanir	VPFP
remaniendo	remanir	VG
remaniéndome	remanir	VGSE
remaniéndote	remanir	VGSE
remaniéndole	remanir	VGSE
remaniéndonos	remanir	VGPE
remaniéndoos	remanir	VGPE
remedir	remedir	O
remido	remedir	VIP1
remides	remedir	VIP2
remide	remedir	VIP3
remedimos	remedir	VIP4
remedís	remedir	VIP5
remiden	remedir	VIP6
remedía	remedir	VII1
remedías	remedir	VII2
remedíamos	remedir	VII4
remedíais	remedir	VII5
remedían	remedir	VII6
remediré	remedir	VIF1
remedirás	remedir	VIF2
remedirá	remedir	VIF3
remediremos	remedir	VIF4
remediréis	remedir	VIF5
remedirán	remedir	VIF6
remediría	remedir	VIC1
remedirías	remedir	VIC2
remediría	remedir	VIC3
remediríamos	remedir	VIC4
remediríais	remedir	VIC5
remedirían	remedir	VIC6
remedí	remedir	VIX1
remedíste	remedir	VIX2
remidió	remedir	VIX3
remedisteis	remedir	VIX5
remidieron	remedir	VIX6
remida	remedir	VSP1
remidas	remedir	VSP2
remidamos	remedir	VSP4
remidáis	remedir	VSP5
remidan	remedir	VSP6
remidiera	remedir	VSX1
remidieras	remedir	VSX2
remidiéramos	remedir	VSX4
remidierais	remedir	VSX5
remidieran	remedir	VSX6
remidiere	remedir	VSF1
remidieres	remedir	VSF2
remidiéremos	remedir	VSF4
remidiereis	remedir	VSF5
remidieren	remedir	VSF6
remidiese	remedir	VSI1
remidieses	remedir	VSI2
remidiésemos	remedir	VSI4
remidieseis	remedir	VSI5
remidiesen	remedir	VSI6
remedid	remedir	VMP
remedidme	remedir	VMSE
remedidle	remedir	VMSE
remedidnos	remedir	VMPE
remedios	remedir	VMPE
remedidles	remedir	VMPE
remedidlo	remedir	VMMSE
remedidla	remedir	VMFSE
remedidlos	remedir	VMMPE
remedidlas	remedir	VMFPE
remedídmelo	remedir	VMMSE
remedídselo	remedir	VMMSE
remedídnoslo	remedir	VMMSE
remedíoslo	remedir	VMMSE
remedídmelos	remedir	VMMPE
remedídselos	remedir	VMMPE
remedídnoslos	remedir	VMMPE
remedíoslos	remedir	VMMPE
remedídmela	remedir	VMFSE
remedídsela	remedir	VMFSE
remedídnosla	remedir	VMFSE
remedíosla	remedir	VMFSE
remedídmelas	remedir	VMFPE
remedídselas	remedir	VMFPE
remedídnoslas	remedir	VMFPE
remedíoslas	remedir	VMFPE
remedido	remedir	VPM
remedidos	remedir	VPMP
remedida	remedir	VPF
remedidas	remedir	VPFP
remidiendo	remedir	VG
remidiéndome	remedir	VGSE
remidiéndote	remedir	VGSE
remidiéndole	remedir	VGSE
remidiéndonos	remedir	VGPE
remidiéndoos	remedir	VGPE
remidiéndolo	remedir	VGMSE
remidiéndola	remedir	VGFSE
remidiéndolos	remedir	VGMPE
remidiéndolas	remedir	VGFPE
remidiéndomelo	remedir	VGMSE
remidiéndotelo	remedir	VGMSE
remidiéndoselo	remedir	VGMSE
remidiéndonoslo	remedir	VGMSE
remidiéndooslo	remedir	VGMSE
remidiéndomelos	remedir	VGMPE
remidiéndotelos	remedir	VGMPE
remidiéndoselos	remedir	VGMPE
remidiéndonoslos	remedir	VGMPE
remidiéndooslos	remedir	VGMPE
remidiéndomela	remedir	VGFSE
remidiéndotela	remedir	VGFSE
remidiéndosela	remedir	VGFSE
remidiéndonosla	remedir	VGFSE
remidiéndoosla	remedir	VGFSE
remidiéndomelas	remedir	VGFPE
remidiéndotelas	remedir	VGFPE
remidiéndoselas	remedir	VGFPE
remidiéndonoslas	remedir	VGFPE
remidiéndooslas	remedir	VGFPE
remitir	remitir	O
remito	remitir	VIP1
remites	remitir	VIP2
remite	remitir	VIP3
remitimos	remitir	VIP4
remitís	remitir	VIP5
remiten	remitir	VIP6
remitía	remitir	VII1
remitías	remitir	VII2
remitíamos	remitir	VII4
remitíais	remitir	VII5
remitían	remitir	VII6
remitiré	remitir	VIF1
remitirás	remitir	VIF2
remitirá	remitir	VIF3
remitiremos	remitir	VIF4
remitiréis	remitir	VIF5
remitirán	remitir	VIF6
remitiría	remitir	VIC1
remitirías	remitir	VIC2
remitiría	remitir	VIC3
remitiríamos	remitir	VIC4
remitiríais	remitir	VIC5
remitirían	remitir	VIC6
remití	remitir	VIX1
remitíste	remitir	VIX2
remitió	remitir	VIX3
remitisteis	remitir	VIX5
remitieron	remitir	VIX6
remita	remitir	VSP1
remitas	remitir	VSP2
remitamos	remitir	VSP4
remitáis	remitir	VSP5
remitan	remitir	VSP6
remitiera	remitir	VSX1
remitieras	remitir	VSX2
remitiéramos	remitir	VSX4
remitierais	remitir	VSX5
remitieran	remitir	VSX6
remitiere	remitir	VSF1
remitieres	remitir	VSF2
remitiéremos	remitir	VSF4
remitiereis	remitir	VSF5
remitieren	remitir	VSF6
remitiese	remitir	VSI1
remitieses	remitir	VSI2
remitiésemos	remitir	VSI4
remitieseis	remitir	VSI5
remitiesen	remitir	VSI6
remitid	remitir	VMP
remitidme	remitir	VMSE
remitidle	remitir	VMSE
remitidnos	remitir	VMPE
remitios	remitir	VMPE
remitidles	remitir	VMPE
remitidlo	remitir	VMMSE
remitidla	remitir	VMFSE
remitidlos	remitir	VMMPE
remitidlas	remitir	VMFPE
remitídmelo	remitir	VMMSE
remitídselo	remitir	VMMSE
remitídnoslo	remitir	VMMSE
remitíoslo	remitir	VMMSE
remitídmelos	remitir	VMMPE
remitídselos	remitir	VMMPE
remitídnoslos	remitir	VMMPE
remitíoslos	remitir	VMMPE
remitídmela	remitir	VMFSE
remitídsela	remitir	VMFSE
remitídnosla	remitir	VMFSE
remitíosla	remitir	VMFSE
remitídmelas	remitir	VMFPE
remitídselas	remitir	VMFPE
remitídnoslas	remitir	VMFPE
remitíoslas	remitir	VMFPE
remitido	remitir	VPM
remitidos	remitir	VPMP
remitida	remitir	VPF
remitidas	remitir	VPFP
remitiendo	remitir	VG
remitiéndome	remitir	VGSE
remitiéndote	remitir	VGSE
remitiéndole	remitir	VGSE
remitiéndonos	remitir	VGPE
remitiéndoos	remitir	VGPE
remitiéndolo	remitir	VGMSE
remitiéndola	remitir	VGFSE
remitiéndolos	remitir	VGMPE
remitiéndolas	remitir	VGFPE
remitiéndomelo	remitir	VGMSE
remitiéndotelo	remitir	VGMSE
remitiéndoselo	remitir	VGMSE
remitiéndonoslo	remitir	VGMSE
remitiéndooslo	remitir	VGMSE
remitiéndomelos	remitir	VGMPE
remitiéndotelos	remitir	VGMPE
remitiéndoselos	remitir	VGMPE
remitiéndonoslos	remitir	VGMPE
remitiéndooslos	remitir	VGMPE
remitiéndomela	remitir	VGFSE
remitiéndotela	remitir	VGFSE
remitiéndosela	remitir	VGFSE
remitiéndonosla	remitir	VGFSE
remitiéndoosla	remitir	VGFSE
remitiéndomelas	remitir	VGFPE
remitiéndotelas	remitir	VGFPE
remitiéndoselas	remitir	VGFPE
remitiéndonoslas	remitir	VGFPE
remitiéndooslas	remitir	VGFPE
remitires	remitir	P
remullir	remullir	O
remullo	remullir	VIP1
remulles	remullir	VIP2
remulle	remullir	VIP3
remullimos	remullir	VIP4
remullís	remullir	VIP5
remullen	remullir	VIP6
remullía	remullir	VII1
remullías	remullir	VII2
remullíamos	remullir	VII4
remullíais	remullir	VII5
remullían	remullir	VII6
remulliré	remullir	VIF1
remullirás	remullir	VIF2
remullirá	remullir	VIF3
remulliremos	remullir	VIF4
remulliréis	remullir	VIF5
remullirán	remullir	VIF6
remulliría	remullir	VIC1
remullirías	remullir	VIC2
remulliría	remullir	VIC3
remulliríamos	remullir	VIC4
remulliríais	remullir	VIC5
remullirían	remullir	VIC6
remullí	remullir	VIX1
remulliste	remullir	VIX2
remulló	remullir	VIX3
remullisteis	remullir	VIX5
remulleron	remullir	VIX6
remulla	remullir	VSP1
remullas	remullir	VSP2
remullamos	remullir	VSP4
remulláis	remullir	VSP5
remullan	remullir	VSP6
remullera	remullir	VSX1
remulleras	remullir	VSX2
remulléramos	remullir	VSX4
remullerais	remullir	VSX5
remulleran	remullir	VSX6
remullere	remullir	VSF1
remulleres	remullir	VSF2
remulléremos	remullir	VSF4
remullereis	remullir	VSF5
remulleren	remullir	VSF6
remullese	remullir	VSI1
remulleses	remullir	VSI2
remullésemos	remullir	VSI4
remulleseis	remullir	VSI5
remullesen	remullir	VSI6
remullid	remullir	VMP
remullidme	remullir	VMSE
remullidle	remullir	VMSE
remullidnos	remullir	VMPE
remullios	remullir	VMPE
remullidles	remullir	VMPE
remullidlo	remullir	VMMSE
remullidla	remullir	VMFSE
remullidlos	remullir	VMMPE
remullidlas	remullir	VMFPE
remullídmelo	remullir	VMMSE
remullídselo	remullir	VMMSE
remullídnoslo	remullir	VMMSE
remullíoslo	remullir	VMMSE
remullídmelos	remullir	VMMPE
remullídselos	remullir	VMMPE
remullídnoslos	remullir	VMMPE
remullíoslos	remullir	VMMPE
remullídmela	remullir	VMFSE
remullídsela	remullir	VMFSE
remullídnosla	remullir	VMFSE
remullíosla	remullir	VMFSE
remullídmelas	remullir	VMFPE
remullídselas	remullir	VMFPE
remullídnoslas	remullir	VMFPE
remullíoslas	remullir	VMFPE
remullido	remullir	VPM
remullidos	remullir	VPMP
remullida	remullir	VPF
remullidas	remullir	VPFP
remulliendo	remullir	VG
remulliéndome	remullir	VGSE
remulliéndote	remullir	VGSE
remulliéndole	remullir	VGSE
remulliéndonos	remullir	VGPE
remulliéndoos	remullir	VGPE
remulliéndolo	remullir	VGMSE
remulliéndola	remullir	VGFSE
remulliéndolos	remullir	VGMPE
remulliéndolas	remullir	VGFPE
remulliéndomelo	remullir	VGMSE
remulliéndotelo	remullir	VGMSE
remulliéndoselo	remullir	VGMSE
remulliéndonoslo	remullir	VGMSE
remulliéndooslo	remullir	VGMSE
remulliéndomelos	remullir	VGMPE
remulliéndotelos	remullir	VGMPE
remulliéndoselos	remullir	VGMPE
remulliéndonoslos	remullir	VGMPE
remulliéndooslos	remullir	VGMPE
remulliéndomela	remullir	VGFSE
remulliéndotela	remullir	VGFSE
remulliéndosela	remullir	VGFSE
remulliéndonosla	remullir	VGFSE
remulliéndoosla	remullir	VGFSE
remulliéndomelas	remullir	VGFPE
remulliéndotelas	remullir	VGFPE
remulliéndoselas	remullir	VGFPE
remulliéndonoslas	remullir	VGFPE
remulliéndooslas	remullir	VGFPE
remanecer	remanecer	O
remanezco	remanecer	VIP1
remaneces	remanecer	VIP2
remanece	remanecer	VIP3
remanecemos	remanecer	VIP4
remanecéis	remanecer	VIP5
remanecen	remanecer	VIP6
remanecía	remanecer	VII1
remanecías	remanecer	VII2
remanecíamos	remanecer	VII4
remanecíais	remanecer	VII5
remanecían	remanecer	VII6
remaneceré	remanecer	VIF1
remanecerás	remanecer	VIF2
remanecerá	remanecer	VIF3
remaneceremos	remanecer	VIF4
remaneceréis	remanecer	VIF5
remanecerán	remanecer	VIF6
remanecería	remanecer	VIC1
remanecerías	remanecer	VIC2
remanecería	remanecer	VIC3
remaneceríamos	remanecer	VIC4
remaneceríais	remanecer	VIC5
remanecerían	remanecer	VIC6
remanecí	remanecer	VIX1
remanecíste	remanecer	VIX2
remaneció	remanecer	VIX3
remanecisteis	remanecer	VIX5
remanecieron	remanecer	VIX6
remanezca	remanecer	VSP1
remanezcas	remanecer	VSP2
remanezcamos	remanecer	VSP4
remanezcáis	remanecer	VSP5
remanezcan	remanecer	VSP6
remaneciera	remanecer	VSX1
remanecieras	remanecer	VSX2
remaneciéramos	remanecer	VSX4
remanecierais	remanecer	VSX5
remanecieran	remanecer	VSX6
remaneciere	remanecer	VSF1
remanecieres	remanecer	VSF2
remaneciéremos	remanecer	VSF4
remaneciereis	remanecer	VSF5
remanecieren	remanecer	VSF6
remaneciese	remanecer	VSI1
remanecieses	remanecer	VSI2
remaneciésemos	remanecer	VSI4
remanecieseis	remanecer	VSI5
remaneciesen	remanecer	VSI6
remaneced	remanecer	VMP
remanecedme	remanecer	VMSE
remanecedle	remanecer	VMSE
remanecednos	remanecer	VMPE
remaneceos	remanecer	VMPE
remanecedles	remanecer	VMPE
remanecido	remanecer	VPM
remanecidos	remanecer	VPMP
remanecida	remanecer	VPF
remanecidas	remanecer	VPFP
remaneciendo	remanecer	VG
remaneciéndome	remanecer	VGSE
remaneciéndote	remanecer	VGSE
remaneciéndole	remanecer	VGSE
remaneciéndonos	remanecer	VGPE
remaneciéndoos	remanecer	VGPE
remecer	remecer	O
remeco	remecer	VIP1
remeces	remecer	VIP2
remece	remecer	VIP3
remecemos	remecer	VIP4
remecéis	remecer	VIP5
remecen	remecer	VIP6
remecía	remecer	VII1
remecías	remecer	VII2
remecíamos	remecer	VII4
remecíais	remecer	VII5
remecían	remecer	VII6
remeceré	remecer	VIF1
remecerás	remecer	VIF2
remecerá	remecer	VIF3
remeceremos	remecer	VIF4
remeceréis	remecer	VIF5
remecerán	remecer	VIF6
remecería	remecer	VIC1
remecerías	remecer	VIC2
remecería	remecer	VIC3
remeceríamos	remecer	VIC4
remeceríais	remecer	VIC5
remecerían	remecer	VIC6
remecí	remecer	VIX1
remecíste	remecer	VIX2
remeció	remecer	VIX3
remecisteis	remecer	VIX5
remecieron	remecer	VIX6
remeca	remecer	VSP1
remecas	remecer	VSP2
remecamos	remecer	VSP4
remecáis	remecer	VSP5
remecan	remecer	VSP6
remeciera	remecer	VSX1
remecieras	remecer	VSX2
remeciéramos	remecer	VSX4
remecierais	remecer	VSX5
remecieran	remecer	VSX6
remeciere	remecer	VSF1
remecieres	remecer	VSF2
remeciéremos	remecer	VSF4
remeciereis	remecer	VSF5
remecieren	remecer	VSF6
remeciese	remecer	VSI1
remecieses	remecer	VSI2
remeciésemos	remecer	VSI4
remecieseis	remecer	VSI5
remeciesen	remecer	VSI6
remeced	remecer	VMP
remecedme	remecer	VMSE
remecedle	remecer	VMSE
remecednos	remecer	VMPE
remeceos	remecer	VMPE
remecedles	remecer	VMPE
remecedlo	remecer	VMMSE
remecedla	remecer	VMFSE
remecedlos	remecer	VMMPE
remecedlas	remecer	VMFPE
remecédmelo	remecer	VMMSE
remecédselo	remecer	VMMSE
remecédnoslo	remecer	VMMSE
remecéoslo	remecer	VMMSE
remecédmelos	remecer	VMMPE
remecédselos	remecer	VMMPE
remecédnoslos	remecer	VMMPE
remecéoslos	remecer	VMMPE
remecédmela	remecer	VMFSE
remecédsela	remecer	VMFSE
remecédnosla	remecer	VMFSE
remecéosla	remecer	VMFSE
remecédmelas	remecer	VMFPE
remecédselas	remecer	VMFPE
remecédnoslas	remecer	VMFPE
remecéoslas	remecer	VMFPE
remecido	remecer	VPM
remecidos	remecer	VPMP
remecida	remecer	VPF
remecidas	remecer	VPFP
remeciendo	remecer	VG
remeciéndome	remecer	VGSE
remeciéndote	remecer	VGSE
remeciéndole	remecer	VGSE
remeciéndonos	remecer	VGPE
remeciéndoos	remecer	VGPE
remeciéndolo	remecer	VGMSE
remeciéndola	remecer	VGFSE
remeciéndolos	remecer	VGMPE
remeciéndolas	remecer	VGFPE
remeciéndomelo	remecer	VGMSE
remeciéndotelo	remecer	VGMSE
remeciéndoselo	remecer	VGMSE
remeciéndonoslo	remecer	VGMSE
remeciéndooslo	remecer	VGMSE
remeciéndomelos	remecer	VGMPE
remeciéndotelos	remecer	VGMPE
remeciéndoselos	remecer	VGMPE
remeciéndonoslos	remecer	VGMPE
remeciéndooslos	remecer	VGMPE
remeciéndomela	remecer	VGFSE
remeciéndotela	remecer	VGFSE
remeciéndosela	remecer	VGFSE
remeciéndonosla	remecer	VGFSE
remeciéndoosla	remecer	VGFSE
remeciéndomelas	remecer	VGFPE
remeciéndotelas	remecer	VGFPE
remeciéndoselas	remecer	VGFPE
remeciéndonoslas	remecer	VGFPE
remeciéndooslas	remecer	VGFPE
remejer	remejer	O
remejo	remejer	VIP1
remejes	remejer	VIP2
remeje	remejer	VIP3
remejemos	remejer	VIP4
remejéis	remejer	VIP5
remejen	remejer	VIP6
remejía	remejer	VII1
remejías	remejer	VII2
remejíamos	remejer	VII4
remejíais	remejer	VII5
remejían	remejer	VII6
remejeré	remejer	VIF1
remejerás	remejer	VIF2
remejerá	remejer	VIF3
remejeremos	remejer	VIF4
remejeréis	remejer	VIF5
remejerán	remejer	VIF6
remejería	remejer	VIC1
remejerías	remejer	VIC2
remejería	remejer	VIC3
remejeríamos	remejer	VIC4
remejeríais	remejer	VIC5
remejerían	remejer	VIC6
remejí	remejer	VIX1
remejíste	remejer	VIX2
remejió	remejer	VIX3
remejisteis	remejer	VIX5
remejieron	remejer	VIX6
remeja	remejer	VSP1
remejas	remejer	VSP2
remejamos	remejer	VSP4
remejáis	remejer	VSP5
remejan	remejer	VSP6
remejiera	remejer	VSX1
remejieras	remejer	VSX2
remejiéramos	remejer	VSX4
remejierais	remejer	VSX5
remejieran	remejer	VSX6
remejiere	remejer	VSF1
remejieres	remejer	VSF2
remejiéremos	remejer	VSF4
remejiereis	remejer	VSF5
remejieren	remejer	VSF6
remejiese	remejer	VSI1
remejieses	remejer	VSI2
remejiésemos	remejer	VSI4
remejieseis	remejer	VSI5
remejiesen	remejer	VSI6
remejed	remejer	VMP
remejedme	remejer	VMSE
remejedle	remejer	VMSE
remejednos	remejer	VMPE
remejeos	remejer	VMPE
remejedles	remejer	VMPE
remejedlo	remejer	VMMSE
remejedla	remejer	VMFSE
remejedlos	remejer	VMMPE
remejedlas	remejer	VMFPE
remejédmelo	remejer	VMMSE
remejédselo	remejer	VMMSE
remejédnoslo	remejer	VMMSE
remejéoslo	remejer	VMMSE
remejédmelos	remejer	VMMPE
remejédselos	remejer	VMMPE
remejédnoslos	remejer	VMMPE
remejéoslos	remejer	VMMPE
remejédmela	remejer	VMFSE
remejédsela	remejer	VMFSE
remejédnosla	remejer	VMFSE
remejéosla	remejer	VMFSE
remejédmelas	remejer	VMFPE
remejédselas	remejer	VMFPE
remejédnoslas	remejer	VMFPE
remejéoslas	remejer	VMFPE
remejido	remejer	VPM
remejidos	remejer	VPMP
remejida	remejer	VPF
remejidas	remejer	VPFP
remejiendo	remejer	VG
remejiéndome	remejer	VGSE
remejiéndote	remejer	VGSE
remejiéndole	remejer	VGSE
remejiéndonos	remejer	VGPE
remejiéndoos	remejer	VGPE
remejiéndolo	remejer	VGMSE
remejiéndola	remejer	VGFSE
remejiéndolos	remejer	VGMPE
remejiéndolas	remejer	VGFPE
remejiéndomelo	remejer	VGMSE
remejiéndotelo	remejer	VGMSE
remejiéndoselo	remejer	VGMSE
remejiéndonoslo	remejer	VGMSE
remejiéndooslo	remejer	VGMSE
remejiéndomelos	remejer	VGMPE
remejiéndotelos	remejer	VGMPE
remejiéndoselos	remejer	VGMPE
remejiéndonoslos	remejer	VGMPE
remejiéndooslos	remejer	VGMPE
remejiéndomela	remejer	VGFSE
remejiéndotela	remejer	VGFSE
remejiéndosela	remejer	VGFSE
remejiéndonosla	remejer	VGFSE
remejiéndoosla	remejer	VGFSE
remejiéndomelas	remejer	VGFPE
remejiéndotelas	remejer	VGFPE
remejiéndoselas	remejer	VGFPE
remejiéndonoslas	remejer	VGFPE
remejiéndooslas	remejer	VGFPE
remeter	remeter	O
remeto	remeter	VIP1
remetes	remeter	VIP2
remete	remeter	VIP3
remetemos	remeter	VIP4
remetéis	remeter	VIP5
remeten	remeter	VIP6
remetía	remeter	VII1
remetías	remeter	VII2
remetíamos	remeter	VII4
remetíais	remeter	VII5
remetían	remeter	VII6
remeteré	remeter	VIF1
remeterás	remeter	VIF2
remeterá	remeter	VIF3
remeteremos	remeter	VIF4
remeteréis	remeter	VIF5
remeterán	remeter	VIF6
remetería	remeter	VIC1
remeterías	remeter	VIC2
remetería	remeter	VIC3
remeteríamos	remeter	VIC4
remeteríais	remeter	VIC5
remeterían	remeter	VIC6
remetí	remeter	VIX1
remetíste	remeter	VIX2
remetió	remeter	VIX3
remetisteis	remeter	VIX5
remetieron	remeter	VIX6
remeta	remeter	VSP1
remetas	remeter	VSP2
remetamos	remeter	VSP4
remetáis	remeter	VSP5
remetan	remeter	VSP6
remetiera	remeter	VSX1
remetieras	remeter	VSX2
remetiéramos	remeter	VSX4
remetierais	remeter	VSX5
remetieran	remeter	VSX6
remetiere	remeter	VSF1
remetieres	remeter	VSF2
remetiéremos	remeter	VSF4
remetiereis	remeter	VSF5
remetieren	remeter	VSF6
remetiese	remeter	VSI1
remetieses	remeter	VSI2
remetiésemos	remeter	VSI4
remetieseis	remeter	VSI5
remetiesen	remeter	VSI6
remeted	remeter	VMP
remetedme	remeter	VMSE
remetedle	remeter	VMSE
remetednos	remeter	VMPE
remeteos	remeter	VMPE
remetedles	remeter	VMPE
remetedlo	remeter	VMMSE
remetedla	remeter	VMFSE
remetedlos	remeter	VMMPE
remetedlas	remeter	VMFPE
remetédmelo	remeter	VMMSE
remetédselo	remeter	VMMSE
remetédnoslo	remeter	VMMSE
remetéoslo	remeter	VMMSE
remetédmelos	remeter	VMMPE
remetédselos	remeter	VMMPE
remetédnoslos	remeter	VMMPE
remetéoslos	remeter	VMMPE
remetédmela	remeter	VMFSE
remetédsela	remeter	VMFSE
remetédnosla	remeter	VMFSE
remetéosla	remeter	VMFSE
remetédmelas	remeter	VMFPE
remetédselas	remeter	VMFPE
remetédnoslas	remeter	VMFPE
remetéoslas	remeter	VMFPE
remetido	remeter	VPM
remetidos	remeter	VPMP
remetida	remeter	VPF
remetidas	remeter	VPFP
remetiendo	remeter	VG
remetiéndome	remeter	VGSE
remetiéndote	remeter	VGSE
remetiéndole	remeter	VGSE
remetiéndonos	remeter	VGPE
remetiéndoos	remeter	VGPE
remetiéndolo	remeter	VGMSE
remetiéndola	remeter	VGFSE
remetiéndolos	remeter	VGMPE
remetiéndolas	remeter	VGFPE
remetiéndomelo	remeter	VGMSE
remetiéndotelo	remeter	VGMSE
remetiéndoselo	remeter	VGMSE
remetiéndonoslo	remeter	VGMSE
remetiéndooslo	remeter	VGMSE
remetiéndomelos	remeter	VGMPE
remetiéndotelos	remeter	VGMPE
remetiéndoselos	remeter	VGMPE
remetiéndonoslos	remeter	VGMPE
remetiéndooslos	remeter	VGMPE
remetiéndomela	remeter	VGFSE
remetiéndotela	remeter	VGFSE
remetiéndosela	remeter	VGFSE
remetiéndonosla	remeter	VGFSE
remetiéndoosla	remeter	VGFSE
remetiéndomelas	remeter	VGFPE
remetiéndotelas	remeter	VGFPE
remetiéndoselas	remeter	VGFPE
remetiéndonoslas	remeter	VGFPE
remetiéndooslas	remeter	VGFPE
remoler	remoler	O
remuelo	remoler	VIP1
remueles	remoler	VIP2
remuele	remoler	VIP3
remolemos	remoler	VIP4
remoléis	remoler	VIP5
remuelen	remoler	VIP6
remolía	remoler	VII1
remolías	remoler	VII2
remolíamos	remoler	VII4
remolíais	remoler	VII5
remolían	remoler	VII6
remoleré	remoler	VIF1
remolerás	remoler	VIF2
remolerá	remoler	VIF3
remoleremos	remoler	VIF4
remoleréis	remoler	VIF5
remolerán	remoler	VIF6
remolería	remoler	VIC1
remolerías	remoler	VIC2
remolería	remoler	VIC3
remoleríamos	remoler	VIC4
remoleríais	remoler	VIC5
remolerían	remoler	VIC6
remolí	remoler	VIX1
remolíste	remoler	VIX2
remolió	remoler	VIX3
remolisteis	remoler	VIX5
remolieron	remoler	VIX6
remuela	remoler	VSP1
remuelas	remoler	VSP2
remolamos	remoler	VSP4
remoláis	remoler	VSP5
remuelan	remoler	VSP6
remoliera	remoler	VSX1
remolieras	remoler	VSX2
remoliéramos	remoler	VSX4
remolierais	remoler	VSX5
remolieran	remoler	VSX6
remoliere	remoler	VSF1
remolieres	remoler	VSF2
remoliéremos	remoler	VSF4
remoliereis	remoler	VSF5
remolieren	remoler	VSF6
remoliese	remoler	VSI1
remolieses	remoler	VSI2
remoliésemos	remoler	VSI4
remolieseis	remoler	VSI5
remoliesen	remoler	VSI6
remoled	remoler	VMP
remoledme	remoler	VMSE
remoledle	remoler	VMSE
remolednos	remoler	VMPE
remoleos	remoler	VMPE
remoledles	remoler	VMPE
remoledlo	remoler	VMMSE
remoledla	remoler	VMFSE
remoledlos	remoler	VMMPE
remoledlas	remoler	VMFPE
remolédmelo	remoler	VMMSE
remolédselo	remoler	VMMSE
remolédnoslo	remoler	VMMSE
remoléoslo	remoler	VMMSE
remolédmelos	remoler	VMMPE
remolédselos	remoler	VMMPE
remolédnoslos	remoler	VMMPE
remoléoslos	remoler	VMMPE
remolédmela	remoler	VMFSE
remolédsela	remoler	VMFSE
remolédnosla	remoler	VMFSE
remoléosla	remoler	VMFSE
remolédmelas	remoler	VMFPE
remolédselas	remoler	VMFPE
remolédnoslas	remoler	VMFPE
remoléoslas	remoler	VMFPE
remolido	remoler	VPM
remolidos	remoler	VPMP
remolida	remoler	VPF
remolidas	remoler	VPFP
remoliendo	remoler	VG
remoliéndome	remoler	VGSE
remoliéndote	remoler	VGSE
remoliéndole	remoler	VGSE
remoliéndonos	remoler	VGPE
remoliéndoos	remoler	VGPE
remoliéndolo	remoler	VGMSE
remoliéndola	remoler	VGFSE
remoliéndolos	remoler	VGMPE
remoliéndolas	remoler	VGFPE
remoliéndomelo	remoler	VGMSE
remoliéndotelo	remoler	VGMSE
remoliéndoselo	remoler	VGMSE
remoliéndonoslo	remoler	VGMSE
remoliéndooslo	remoler	VGMSE
remoliéndomelos	remoler	VGMPE
remoliéndotelos	remoler	VGMPE
remoliéndoselos	remoler	VGMPE
remoliéndonoslos	remoler	VGMPE
remoliéndooslos	remoler	VGMPE
remoliéndomela	remoler	VGFSE
remoliéndotela	remoler	VGFSE
remoliéndosela	remoler	VGFSE
remoliéndonosla	remoler	VGFSE
remoliéndoosla	remoler	VGFSE
remoliéndomelas	remoler	VGFPE
remoliéndotelas	remoler	VGFPE
remoliéndoselas	remoler	VGFPE
remoliéndonoslas	remoler	VGFPE
remoliéndooslas	remoler	VGFPE
remorder	remorder	O
remuerdo	remorder	VIP1
remuerdes	remorder	VIP2
remuerde	remorder	VIP3
remordemos	remorder	VIP4
remordéis	remorder	VIP5
remuerden	remorder	VIP6
remordía	remorder	VII1
remordías	remorder	VII2
remordíamos	remorder	VII4
remordíais	remorder	VII5
remordían	remorder	VII6
remorderé	remorder	VIF1
remorderás	remorder	VIF2
remorderá	remorder	VIF3
remorderemos	remorder	VIF4
remorderéis	remorder	VIF5
remorderán	remorder	VIF6
remordería	remorder	VIC1
remorderías	remorder	VIC2
remordería	remorder	VIC3
remorderíamos	remorder	VIC4
remorderíais	remorder	VIC5
remorderían	remorder	VIC6
remordí	remorder	VIX1
remordiste	remorder	VIX2
remordió	remorder	VIX3
remordisteis	remorder	VIX5
remordieron	remorder	VIX6
remuerda	remorder	VSP1
remuerdas	remorder	VSP2
remordamos	remorder	VSP4
remordáis	remorder	VSP5
remuerdan	remorder	VSP6
remordiera	remorder	VSX1
remordieras	remorder	VSX2
remordiéramos	remorder	VSX4
remordierais	remorder	VSX5
remordieran	remorder	VSX6
remordiere	remorder	VSF1
remordieres	remorder	VSF2
remordiéremos	remorder	VSF4
remordiereis	remorder	VSF5
remordieren	remorder	VSF6
remordiese	remorder	VSI1
remordieses	remorder	VSI2
remordiésemos	remorder	VSI4
remordieseis	remorder	VSI5
remordiesen	remorder	VSI6
remorded	remorder	VMP
remordedme	remorder	VMSE
remordedle	remorder	VMSE
remordednos	remorder	VMPE
remordeos	remorder	VMPE
remordedles	remorder	VMPE
remordedlo	remorder	VMMSE
remordedla	remorder	VMFSE
remordedlos	remorder	VMMPE
remordedlas	remorder	VMFPE
remordédmelo	remorder	VMMSE
remordédselo	remorder	VMMSE
remordédnoslo	remorder	VMMSE
remordéoslo	remorder	VMMSE
remordédmelos	remorder	VMMPE
remordédselos	remorder	VMMPE
remordédnoslos	remorder	VMMPE
remordéoslos	remorder	VMMPE
remordédmela	remorder	VMFSE
remordédsela	remorder	VMFSE
remordédnosla	remorder	VMFSE
remordéosla	remorder	VMFSE
remordédmelas	remorder	VMFPE
remordédselas	remorder	VMFPE
remordédnoslas	remorder	VMFPE
remordéoslas	remorder	VMFPE
remordido	remorder	VPM
remordidos	remorder	VPMP
remordida	remorder	VPF
remordidas	remorder	VPFP
remordiendo	remorder	VG
remordiéndome	remorder	VGSE
remordiéndote	remorder	VGSE
remordiéndole	remorder	VGSE
remordiéndonos	remorder	VGPE
remordiéndoos	remorder	VGPE
remordiéndolo	remorder	VGMSE
remordiéndola	remorder	VGFSE
remordiéndolos	remorder	VGMPE
remordiéndolas	remorder	VGFPE
remordiéndomelo	remorder	VGMSE
remordiéndotelo	remorder	VGMSE
remordiéndoselo	remorder	VGMSE
remordiéndonoslo	remorder	VGMSE
remordiéndooslo	remorder	VGMSE
remordiéndomelos	remorder	VGMPE
remordiéndotelos	remorder	VGMPE
remordiéndoselos	remorder	VGMPE
remordiéndonoslos	remorder	VGMPE
remordiéndooslos	remorder	VGMPE
remordiéndomela	remorder	VGFSE
remordiéndotela	remorder	VGFSE
remordiéndosela	remorder	VGFSE
remordiéndonosla	remorder	VGFSE
remordiéndoosla	remorder	VGFSE
remordiéndomelas	remorder	VGFPE
remordiéndotelas	remorder	VGFPE
remordiéndoselas	remorder	VGFPE
remordiéndonoslas	remorder	VGFPE
remordiéndooslas	remorder	VGFPE
remostecer	remostecer	O
remostezco	remostecer	VIP1
remosteces	remostecer	VIP2
remostece	remostecer	VIP3
remostecemos	remostecer	VIP4
remostecéis	remostecer	VIP5
remostecen	remostecer	VIP6
remostecía	remostecer	VII1
remostecías	remostecer	VII2
remostecíamos	remostecer	VII4
remostecíais	remostecer	VII5
remostecían	remostecer	VII6
remosteceré	remostecer	VIF1
remostecerás	remostecer	VIF2
remostecerá	remostecer	VIF3
remosteceremos	remostecer	VIF4
remosteceréis	remostecer	VIF5
remostecerán	remostecer	VIF6
remostecería	remostecer	VIC1
remostecerías	remostecer	VIC2
remostecería	remostecer	VIC3
remosteceríamos	remostecer	VIC4
remosteceríais	remostecer	VIC5
remostecerían	remostecer	VIC6
remostecí	remostecer	VIX1
remosteciste	remostecer	VIX2
remosteció	remostecer	VIX3
remostecisteis	remostecer	VIX5
remostecieron	remostecer	VIX6
remostezca	remostecer	VSP1
remostezcas	remostecer	VSP2
remostezcamos	remostecer	VSP4
remostezcáis	remostecer	VSP5
remostezcan	remostecer	VSP6
remosteciera	remostecer	VSX1
remostecieras	remostecer	VSX2
remosteciéramos	remostecer	VSX4
remostecierais	remostecer	VSX5
remostecieran	remostecer	VSX6
remosteciere	remostecer	VSF1
remostecieres	remostecer	VSF2
remosteciéremos	remostecer	VSF4
remosteciereis	remostecer	VSF5
remostecieren	remostecer	VSF6
remosteciese	remostecer	VSI1
remostecieses	remostecer	VSI2
remosteciésemos	remostecer	VSI4
remostecieseis	remostecer	VSI5
remosteciesen	remostecer	VSI6
remosteced	remostecer	VMP
remostecedme	remostecer	VMSE
remostecedle	remostecer	VMSE
remostecednos	remostecer	VMPE
remosteceos	remostecer	VMPE
remostecedles	remostecer	VMPE
remostecido	remostecer	VPM
remostecidos	remostecer	VPMP
remostecida	remostecer	VPF
remostecidas	remostecer	VPFP
remosteciendo	remostecer	VG
remosteciéndome	remostecer	VGSE
remosteciéndote	remostecer	VGSE
remosteciéndole	remostecer	VGSE
remosteciéndonos	remostecer	VGPE
remosteciéndoos	remostecer	VGPE
remover	remover	O
remuevo	remover	VIP1
remueves	remover	VIP2
remueve	remover	VIP3
removemos	remover	VIP4
removéis	remover	VIP5
remueven	remover	VIP6
removía	remover	VII1
removías	remover	VII2
removíamos	remover	VII4
removíais	remover	VII5
removían	remover	VII6
removeré	remover	VIF1
removerás	remover	VIF2
removerá	remover	VIF3
removeremos	remover	VIF4
removeréis	remover	VIF5
removerán	remover	VIF6
removería	remover	VIC1
removerías	remover	VIC2
removería	remover	VIC3
removeríamos	remover	VIC4
removeríais	remover	VIC5
removerían	remover	VIC6
removí	remover	VIX1
removíste	remover	VIX2
removió	remover	VIX3
removisteis	remover	VIX5
removieron	remover	VIX6
remueva	remover	VSP1
remuevas	remover	VSP2
removamos	remover	VSP4
remováis	remover	VSP5
remuevan	remover	VSP6
removiera	remover	VSX1
removieras	remover	VSX2
removiéramos	remover	VSX4
removierais	remover	VSX5
removieran	remover	VSX6
removiere	remover	VSF1
removieres	remover	VSF2
removiéremos	remover	VSF4
removiereis	remover	VSF5
removieren	remover	VSF6
removiese	remover	VSI1
removieses	remover	VSI2
removiésemos	remover	VSI4
removieseis	remover	VSI5
removiesen	remover	VSI6
removed	remover	VMP
removedme	remover	VMSE
removedle	remover	VMSE
removednos	remover	VMPE
removeos	remover	VMPE
removedles	remover	VMPE
removedlo	remover	VMMSE
removedla	remover	VMFSE
removedlos	remover	VMMPE
removedlas	remover	VMFPE
removédmelo	remover	VMMSE
removédselo	remover	VMMSE
removédnoslo	remover	VMMSE
removéoslo	remover	VMMSE
removédmelos	remover	VMMPE
removédselos	remover	VMMPE
removédnoslos	remover	VMMPE
removéoslos	remover	VMMPE
removédmela	remover	VMFSE
removédsela	remover	VMFSE
removédnosla	remover	VMFSE
removéosla	remover	VMFSE
removédmelas	remover	VMFPE
removédselas	remover	VMFPE
removédnoslas	remover	VMFPE
removéoslas	remover	VMFPE
removido	remover	VPM
removidos	remover	VPMP
removida	remover	VPF
removidas	remover	VPFP
removiendo	remover	VG
removiéndome	remover	VGSE
removiéndote	remover	VGSE
removiéndole	remover	VGSE
removiéndonos	remover	VGPE
removiéndoos	remover	VGPE
removiéndolo	remover	VGMSE
removiéndola	remover	VGFSE
removiéndolos	remover	VGMPE
removiéndolas	remover	VGFPE
removiéndomelo	remover	VGMSE
removiéndotelo	remover	VGMSE
removiéndoselo	remover	VGMSE
removiéndonoslo	remover	VGMSE
removiéndooslo	remover	VGMSE
removiéndomelos	remover	VGMPE
removiéndotelos	remover	VGMPE
removiéndoselos	remover	VGMPE
removiéndonoslos	remover	VGMPE
removiéndooslos	remover	VGMPE
removiéndomela	remover	VGFSE
removiéndotela	remover	VGFSE
removiéndosela	remover	VGFSE
removiéndonosla	remover	VGFSE
removiéndoosla	remover	VGFSE
removiéndomelas	remover	VGFPE
removiéndotelas	remover	VGFPE
removiéndoselas	remover	VGFPE
removiéndonoslas	remover	VGFPE
removiéndooslas	remover	VGFPE
remachar	remachar	O
remacho	remachar	VIP1
remachas	remachar	VIP2
remacha	remachar	VIP3
remachamos	remachar	VIP4
remacháis	remachar	VIP5
remachan	remachar	VIP6
remachaba	remachar	VII1
remachabas	remachar	VII2
remachábamos	remachar	VII4
remachabais	remachar	VII5
remachaban	remachar	VII6
remacharé	remachar	VIF1
remacharás	remachar	VIF2
remachará	remachar	VIF3
remacharemos	remachar	VIF4
remacharéis	remachar	VIF5
remacharán	remachar	VIF6
remacharía	remachar	VIC1
remacharías	remachar	VIC2
remacharía	remachar	VIC3
remacharíamos	remachar	VIC4
remacharíais	remachar	VIC5
remacharían	remachar	VIC6
remaché	remachar	VIX1
remachaste	remachar	VIX2
remachó	remachar	VIX3
remachasteis	remachar	VIX5
remacharon	remachar	VIX6
remache	remachar	VSP1
remaches	remachar	VSP2
remachemos	remachar	VSP4
remachéis	remachar	VSP5
remachen	remachar	VSP6
remachara	remachar	VSX1
remacharas	remachar	VSX2
remacháramos	remachar	VSX4
remacharais	remachar	VSX5
remacharan	remachar	VSX6
remachare	remachar	VSF1
remachares	remachar	VSF2
remacháremos	remachar	VSF4
remachareis	remachar	VSF5
remacharen	remachar	VSF6
remachase	remachar	VSI1
remachases	remachar	VSI2
remachásemos	remachar	VSI4
remachaseis	remachar	VSI5
remachasen	remachar	VSI6
remachad	remachar	VMP
remachadme	remachar	VMSE
remachadle	remachar	VMSE
remachadnos	remachar	VMPE
remachaos	remachar	VMPE
remachadles	remachar	VMPE
remachadlo	remachar	VMMSE
remachadla	remachar	VMFSE
remachadlos	remachar	VMMPE
remachadlas	remachar	VMFPE
remachádmelo	remachar	VMMSE
remachádselo	remachar	VMMSE
remachádnoslo	remachar	VMMSE
remacháoslo	remachar	VMMSE
remachádmelos	remachar	VMMPE
remachádselos	remachar	VMMPE
remachádnoslos	remachar	VMMPE
remacháoslos	remachar	VMMPE
remachádmela	remachar	VMFSE
remachádsela	remachar	VMFSE
remachádnosla	remachar	VMFSE
remacháosla	remachar	VMFSE
remachádmelas	remachar	VMFPE
remachádselas	remachar	VMFPE
remachádnoslas	remachar	VMFPE
remacháoslas	remachar	VMFPE
remachado	remachar	VPM
remachados	remachar	VPMP
remachada	remachar	VPF
remachadas	remachar	VPFP
remachando	remachar	VG
remachándome	remachar	VGSE
remachándote	remachar	VGSE
remachándole	remachar	VGSE
remachándonos	remachar	VGPE
remachándoos	remachar	VGPE
remachándolo	remachar	VGMSE
remachándola	remachar	VGFSE
remachándolos	remachar	VGMPE
remachándolas	remachar	VGFPE
remachándomelo	remachar	VGMSE
remachándotelo	remachar	VGMSE
remachándoselo	remachar	VGMSE
remachándonoslo	remachar	VGMSE
remachándooslo	remachar	VGMSE
remachándomelos	remachar	VGMPE
remachándotelos	remachar	VGMPE
remachándoselos	remachar	VGMPE
remachándonoslos	remachar	VGMPE
remachándooslos	remachar	VGMPE
remachándomela	remachar	VGFSE
remachándotela	remachar	VGFSE
remachándosela	remachar	VGFSE
remachándonosla	remachar	VGFSE
remachándoosla	remachar	VGFSE
remachándomelas	remachar	VGFPE
remachándotelas	remachar	VGFPE
remachándoselas	remachar	VGFPE
remachándonoslas	remachar	VGFPE
remachándooslas	remachar	VGFPE
remallar	remallar	O
remallo	remallar	VIP1
remallas	remallar	VIP2
remalla	remallar	VIP3
remallamos	remallar	VIP4
remalláis	remallar	VIP5
remallan	remallar	VIP6
remallaba	remallar	VII1
remallabas	remallar	VII2
remallábamos	remallar	VII4
remallabais	remallar	VII5
remallaban	remallar	VII6
remallaré	remallar	VIF1
remallarás	remallar	VIF2
remallará	remallar	VIF3
remallaremos	remallar	VIF4
remallaréis	remallar	VIF5
remallarán	remallar	VIF6
remallaría	remallar	VIC1
remallarías	remallar	VIC2
remallaría	remallar	VIC3
remallaríamos	remallar	VIC4
remallaríais	remallar	VIC5
remallarían	remallar	VIC6
remallé	remallar	VIX1
remallaste	remallar	VIX2
remalló	remallar	VIX3
remallasteis	remallar	VIX5
remallaron	remallar	VIX6
remalle	remallar	VSP1
remalles	remallar	VSP2
remallemos	remallar	VSP4
remalléis	remallar	VSP5
remallen	remallar	VSP6
remallara	remallar	VSX1
remallaras	remallar	VSX2
remalláramos	remallar	VSX4
remallarais	remallar	VSX5
remallaran	remallar	VSX6
remallare	remallar	VSF1
remallares	remallar	VSF2
remalláremos	remallar	VSF4
remallareis	remallar	VSF5
remallaren	remallar	VSF6
remallase	remallar	VSI1
remallases	remallar	VSI2
remallásemos	remallar	VSI4
remallaseis	remallar	VSI5
remallasen	remallar	VSI6
remallad	remallar	VMP
remalladme	remallar	VMSE
remalladle	remallar	VMSE
remalladnos	remallar	VMPE
remallaos	remallar	VMPE
remalladles	remallar	VMPE
remalladlo	remallar	VMMSE
remalladla	remallar	VMFSE
remalladlos	remallar	VMMPE
remalladlas	remallar	VMFPE
remalládmelo	remallar	VMMSE
remalládselo	remallar	VMMSE
remalládnoslo	remallar	VMMSE
remalláoslo	remallar	VMMSE
remalládmelos	remallar	VMMPE
remalládselos	remallar	VMMPE
remalládnoslos	remallar	VMMPE
remalláoslos	remallar	VMMPE
remalládmela	remallar	VMFSE
remalládsela	remallar	VMFSE
remalládnosla	remallar	VMFSE
remalláosla	remallar	VMFSE
remalládmelas	remallar	VMFPE
remalládselas	remallar	VMFPE
remalládnoslas	remallar	VMFPE
remalláoslas	remallar	VMFPE
remallado	remallar	VPM
remallados	remallar	VPMP
remallada	remallar	VPF
remalladas	remallar	VPFP
remallando	remallar	VG
remallándome	remallar	VGSE
remallándote	remallar	VGSE
remallándole	remallar	VGSE
remallándonos	remallar	VGPE
remallándoos	remallar	VGPE
remallándolo	remallar	VGMSE
remallándola	remallar	VGFSE
remallándolos	remallar	VGMPE
remallándolas	remallar	VGFPE
remallándomelo	remallar	VGMSE
remallándotelo	remallar	VGMSE
remallándoselo	remallar	VGMSE
remallándonoslo	remallar	VGMSE
remallándooslo	remallar	VGMSE
remallándomelos	remallar	VGMPE
remallándotelos	remallar	VGMPE
remallándoselos	remallar	VGMPE
remallándonoslos	remallar	VGMPE
remallándooslos	remallar	VGMPE
remallándomela	remallar	VGFSE
remallándotela	remallar	VGFSE
remallándosela	remallar	VGFSE
remallándonosla	remallar	VGFSE
remallándoosla	remallar	VGFSE
remallándomelas	remallar	VGFPE
remallándotelas	remallar	VGFPE
remallándoselas	remallar	VGFPE
remallándonoslas	remallar	VGFPE
remallándooslas	remallar	VGFPE
remanar	remanar	O
remano	remanar	VIP1
remanas	remanar	VIP2
remana	remanar	VIP3
remanamos	remanar	VIP4
remanáis	remanar	VIP5
remanan	remanar	VIP6
remanaba	remanar	VII1
remanabas	remanar	VII2
remanábamos	remanar	VII4
remanabais	remanar	VII5
remanaban	remanar	VII6
remanaré	remanar	VIF1
remanarás	remanar	VIF2
remanará	remanar	VIF3
remanaremos	remanar	VIF4
remanaréis	remanar	VIF5
remanarán	remanar	VIF6
remanaría	remanar	VIC1
remanarías	remanar	VIC2
remanaría	remanar	VIC3
remanaríamos	remanar	VIC4
remanaríais	remanar	VIC5
remanarían	remanar	VIC6
remané	remanar	VIX1
remanaste	remanar	VIX2
remanó	remanar	VIX3
remanasteis	remanar	VIX5
remanaron	remanar	VIX6
remane	remanar	VSP1
remanes	remanar	VSP2
remanemos	remanar	VSP4
remanéis	remanar	VSP5
remanen	remanar	VSP6
remanara	remanar	VSX1
remanaras	remanar	VSX2
remanáramos	remanar	VSX4
remanarais	remanar	VSX5
remanaran	remanar	VSX6
remanare	remanar	VSF1
remanares	remanar	VSF2
remanáremos	remanar	VSF4
remanareis	remanar	VSF5
remanaren	remanar	VSF6
remanase	remanar	VSI1
remanases	remanar	VSI2
remanásemos	remanar	VSI4
remanaseis	remanar	VSI5
remanasen	remanar	VSI6
remanad	remanar	VMP
remanadme	remanar	VMSE
remanadle	remanar	VMSE
remanadnos	remanar	VMPE
remanaos	remanar	VMPE
remanadles	remanar	VMPE
remanado	remanar	VPM
remanados	remanar	VPMP
remanada	remanar	VPF
remanadas	remanar	VPFP
remanando	remanar	VG
remanándome	remanar	VGSE
remanándote	remanar	VGSE
remanándole	remanar	VGSE
remanándonos	remanar	VGPE
remanándoos	remanar	VGPE
remandar	remandar	O
remando	remandar	VIP1
remandas	remandar	VIP2
remanda	remandar	VIP3
remandamos	remandar	VIP4
remandáis	remandar	VIP5
remandan	remandar	VIP6
remandaba	remandar	VII1
remandabas	remandar	VII2
remandábamos	remandar	VII4
remandabais	remandar	VII5
remandaban	remandar	VII6
remandaré	remandar	VIF1
remandarás	remandar	VIF2
remandará	remandar	VIF3
remandaremos	remandar	VIF4
remandaréis	remandar	VIF5
remandarán	remandar	VIF6
remandaría	remandar	VIC1
remandarías	remandar	VIC2
remandaría	remandar	VIC3
remandaríamos	remandar	VIC4
remandaríais	remandar	VIC5
remandarían	remandar	VIC6
remandé	remandar	VIX1
remandaste	remandar	VIX2
remandó	remandar	VIX3
remandasteis	remandar	VIX5
remandaron	remandar	VIX6
remande	remandar	VSP1
remandes	remandar	VSP2
remandemos	remandar	VSP4
remandéis	remandar	VSP5
remanden	remandar	VSP6
remandara	remandar	VSX1
remandaras	remandar	VSX2
remandáramos	remandar	VSX4
remandarais	remandar	VSX5
remandaran	remandar	VSX6
remandare	remandar	VSF1
remandares	remandar	VSF2
remandáremos	remandar	VSF4
remandareis	remandar	VSF5
remandaren	remandar	VSF6
remandase	remandar	VSI1
remandases	remandar	VSI2
remandásemos	remandar	VSI4
remandaseis	remandar	VSI5
remandasen	remandar	VSI6
remandad	remandar	VMP
remandadme	remandar	VMSE
remandadle	remandar	VMSE
remandadnos	remandar	VMPE
remandaos	remandar	VMPE
remandadles	remandar	VMPE
remandadlo	remandar	VMMSE
remandadla	remandar	VMFSE
remandadlos	remandar	VMMPE
remandadlas	remandar	VMFPE
remandádmelo	remandar	VMMSE
remandádselo	remandar	VMMSE
remandádnoslo	remandar	VMMSE
remandáoslo	remandar	VMMSE
remandádmelos	remandar	VMMPE
remandádselos	remandar	VMMPE
remandádnoslos	remandar	VMMPE
remandáoslos	remandar	VMMPE
remandádmela	remandar	VMFSE
remandádsela	remandar	VMFSE
remandádnosla	remandar	VMFSE
remandáosla	remandar	VMFSE
remandádmelas	remandar	VMFPE
remandádselas	remandar	VMFPE
remandádnoslas	remandar	VMFPE
remandáoslas	remandar	VMFPE
remandado	remandar	VPM
remandados	remandar	VPMP
remandada	remandar	VPF
remandadas	remandar	VPFP
remandando	remandar	VG
remandándome	remandar	VGSE
remandándote	remandar	VGSE
remandándole	remandar	VGSE
remandándonos	remandar	VGPE
remandándoos	remandar	VGPE
remandándolo	remandar	VGMSE
remandándola	remandar	VGFSE
remandándolos	remandar	VGMPE
remandándolas	remandar	VGFPE
remandándomelo	remandar	VGMSE
remandándotelo	remandar	VGMSE
remandándoselo	remandar	VGMSE
remandándonoslo	remandar	VGMSE
remandándooslo	remandar	VGMSE
remandándomelos	remandar	VGMPE
remandándotelos	remandar	VGMPE
remandándoselos	remandar	VGMPE
remandándonoslos	remandar	VGMPE
remandándooslos	remandar	VGMPE
remandándomela	remandar	VGFSE
remandándotela	remandar	VGFSE
remandándosela	remandar	VGFSE
remandándonosla	remandar	VGFSE
remandándoosla	remandar	VGFSE
remandándomelas	remandar	VGFPE
remandándotelas	remandar	VGFPE
remandándoselas	remandar	VGFPE
remandándonoslas	remandar	VGFPE
remandándooslas	remandar	VGFPE
remangar	remangar	O
remango	remangar	VIP1
remangas	remangar	VIP2
remanga	remangar	VIP3
remangamos	remangar	VIP4
remangáis	remangar	VIP5
remangan	remangar	VIP6
remangaba	remangar	VII1
remangabas	remangar	VII2
remangábamos	remangar	VII4
remangabais	remangar	VII5
remangaban	remangar	VII6
remangaré	remangar	VIF1
remangarás	remangar	VIF2
remangará	remangar	VIF3
remangaremos	remangar	VIF4
remangaréis	remangar	VIF5
remangarán	remangar	VIF6
remangaría	remangar	VIC1
remangarías	remangar	VIC2
remangaría	remangar	VIC3
remangaríamos	remangar	VIC4
remangaríais	remangar	VIC5
remangarían	remangar	VIC6
remangé	remangar	VIX1
remangaste	remangar	VIX2
remangó	remangar	VIX3
remangasteis	remangar	VIX5
remangaron	remangar	VIX6
remangue	remangar	VSP1
remangues	remangar	VSP2
remanguemos	remangar	VSP4
remanguéis	remangar	VSP5
remanguen	remangar	VSP6
remangara	remangar	VSX1
remangaras	remangar	VSX2
remangáramos	remangar	VSX4
remangarais	remangar	VSX5
remangaran	remangar	VSX6
remangare	remangar	VSF1
remangares	remangar	VSF2
remangáremos	remangar	VSF4
remangareis	remangar	VSF5
remangaren	remangar	VSF6
remangase	remangar	VSI1
remangases	remangar	VSI2
remangásemos	remangar	VSI4
remangaseis	remangar	VSI5
remangasen	remangar	VSI6
remangad	remangar	VMP
remangadme	remangar	VMSE
remangadle	remangar	VMSE
remangadnos	remangar	VMPE
remangaos	remangar	VMPE
remangadles	remangar	VMPE
remangadlo	remangar	VMMSE
remangadla	remangar	VMFSE
remangadlos	remangar	VMMPE
remangadlas	remangar	VMFPE
remangádmelo	remangar	VMMSE
remangádselo	remangar	VMMSE
remangádnoslo	remangar	VMMSE
remangáoslo	remangar	VMMSE
remangádmelos	remangar	VMMPE
remangádselos	remangar	VMMPE
remangádnoslos	remangar	VMMPE
remangáoslos	remangar	VMMPE
remangádmela	remangar	VMFSE
remangádsela	remangar	VMFSE
remangádnosla	remangar	VMFSE
remangáosla	remangar	VMFSE
remangádmelas	remangar	VMFPE
remangádselas	remangar	VMFPE
remangádnoslas	remangar	VMFPE
remangáoslas	remangar	VMFPE
remangado	remangar	VPM
remangados	remangar	VPMP
remangada	remangar	VPF
remangadas	remangar	VPFP
remangando	remangar	VG
remangándome	remangar	VGSE
remangándote	remangar	VGSE
remangándole	remangar	VGSE
remangándonos	remangar	VGPE
remangándoos	remangar	VGPE
remangándolo	remangar	VGMSE
remangándola	remangar	VGFSE
remangándolos	remangar	VGMPE
remangándolas	remangar	VGFPE
remangándomelo	remangar	VGMSE
remangándotelo	remangar	VGMSE
remangándoselo	remangar	VGMSE
remangándonoslo	remangar	VGMSE
remangándooslo	remangar	VGMSE
remangándomelos	remangar	VGMPE
remangándotelos	remangar	VGMPE
remangándoselos	remangar	VGMPE
remangándonoslos	remangar	VGMPE
remangándooslos	remangar	VGMPE
remangándomela	remangar	VGFSE
remangándotela	remangar	VGFSE
remangándosela	remangar	VGFSE
remangándonosla	remangar	VGFSE
remangándoosla	remangar	VGFSE
remangándomelas	remangar	VGFPE
remangándotelas	remangar	VGFPE
remangándoselas	remangar	VGFPE
remangándonoslas	remangar	VGFPE
remangándooslas	remangar	VGFPE
remansar	remansar	O
remanso	remansar	VIP1
remansas	remansar	VIP2
remansa	remansar	VIP3
remansamos	remansar	VIP4
remansáis	remansar	VIP5
remansan	remansar	VIP6
remansaba	remansar	VII1
remansabas	remansar	VII2
remansábamos	remansar	VII4
remansabais	remansar	VII5
remansaban	remansar	VII6
remansaré	remansar	VIF1
remansarás	remansar	VIF2
remansará	remansar	VIF3
remansaremos	remansar	VIF4
remansaréis	remansar	VIF5
remansarán	remansar	VIF6
remansaría	remansar	VIC1
remansarías	remansar	VIC2
remansaría	remansar	VIC3
remansaríamos	remansar	VIC4
remansaríais	remansar	VIC5
remansarían	remansar	VIC6
remansé	remansar	VIX1
remansaste	remansar	VIX2
remansó	remansar	VIX3
remansasteis	remansar	VIX5
remansaron	remansar	VIX6
remanse	remansar	VSP1
remanses	remansar	VSP2
remansemos	remansar	VSP4
remanséis	remansar	VSP5
remansen	remansar	VSP6
remansara	remansar	VSX1
remansaras	remansar	VSX2
remansáramos	remansar	VSX4
remansarais	remansar	VSX5
remansaran	remansar	VSX6
remansare	remansar	VSF1
remansares	remansar	VSF2
remansáremos	remansar	VSF4
remansareis	remansar	VSF5
remansaren	remansar	VSF6
remansase	remansar	VSI1
remansases	remansar	VSI2
remansásemos	remansar	VSI4
remansaseis	remansar	VSI5
remansasen	remansar	VSI6
remansad	remansar	VMP
remansadme	remansar	VMSE
remansadle	remansar	VMSE
remansadnos	remansar	VMPE
remansaos	remansar	VMPE
remansadles	remansar	VMPE
remansado	remansar	VPM
remansados	remansar	VPMP
remansada	remansar	VPF
remansadas	remansar	VPFP
remansando	remansar	VG
remansándome	remansar	VGSE
remansándote	remansar	VGSE
remansándole	remansar	VGSE
remansándonos	remansar	VGPE
remansándoos	remansar	VGPE
remar	remar	O
remo	remar	VIP1
remas	remar	VIP2
rema	remar	VIP3
remamos	remar	VIP4
remáis	remar	VIP5
reman	remar	VIP6
remaba	remar	VII1
remabas	remar	VII2
remábamos	remar	VII4
remabais	remar	VII5
remaban	remar	VII6
remaré	remar	VIF1
remarás	remar	VIF2
remará	remar	VIF3
remaremos	remar	VIF4
remaréis	remar	VIF5
remarán	remar	VIF6
remaría	remar	VIC1
remarías	remar	VIC2
remaría	remar	VIC3
remaríamos	remar	VIC4
remaríais	remar	VIC5
remarían	remar	VIC6
remé	remar	VIX1
remaste	remar	VIX2
remó	remar	VIX3
remasteis	remar	VIX5
remaron	remar	VIX6
reme	remar	VSP1
remes	remar	VSP2
rememos	remar	VSP4
reméis	remar	VSP5
remen	remar	VSP6
remara	remar	VSX1
remaras	remar	VSX2
remáramos	remar	VSX4
remarais	remar	VSX5
remaran	remar	VSX6
remare	remar	VSF1
remares	remar	VSF2
remáremos	remar	VSF4
remareis	remar	VSF5
remaren	remar	VSF6
remase	remar	VSI1
remases	remar	VSI2
remásemos	remar	VSI4
remaseis	remar	VSI5
remasen	remar	VSI6
remad	remar	VMP
remadme	remar	VMSE
remadle	remar	VMSE
remadnos	remar	VMPE
remaos	remar	VMPE
remadles	remar	VMPE
remado	remar	VPM
remados	remar	VPMP
remada	remar	VPF
remadas	remar	VPFP
remando	remar	VG
remándome	remar	VGSE
remándote	remar	VGSE
remándole	remar	VGSE
remándonos	remar	VGPE
remándoos	remar	VGPE
remarcar	remarcar	O
remarco	remarcar	VIP1
remarcas	remarcar	VIP2
remarca	remarcar	VIP3
remarcamos	remarcar	VIP4
remarcáis	remarcar	VIP5
remarcan	remarcar	VIP6
remarcaba	remarcar	VII1
remarcabas	remarcar	VII2
remarcábamos	remarcar	VII4
remarcabais	remarcar	VII5
remarcaban	remarcar	VII6
remarcaré	remarcar	VIF1
remarcarás	remarcar	VIF2
remarcará	remarcar	VIF3
remarcaremos	remarcar	VIF4
remarcaréis	remarcar	VIF5
remarcarán	remarcar	VIF6
remarcaría	remarcar	VIC1
remarcarías	remarcar	VIC2
remarcaría	remarcar	VIC3
remarcaríamos	remarcar	VIC4
remarcaríais	remarcar	VIC5
remarcarían	remarcar	VIC6
remarqué	remarcar	VIX1
remarcaste	remarcar	VIX2
remarcó	remarcar	VIX3
remarcasteis	remarcar	VIX5
remarcaron	remarcar	VIX6
remarque	remarcar	VSP1
remarques	remarcar	VSP2
remarquemos	remarcar	VSP4
remarquéis	remarcar	VSP5
remarquen	remarcar	VSP6
remarcara	remarcar	VSX1
remarcaras	remarcar	VSX2
remarcáramos	remarcar	VSX4
remarcarais	remarcar	VSX5
remarcaran	remarcar	VSX6
remarcare	remarcar	VSF1
remarcares	remarcar	VSF2
remarcáremos	remarcar	VSF4
remarcareis	remarcar	VSF5
remarcaren	remarcar	VSF6
remarcase	remarcar	VSI1
remarcases	remarcar	VSI2
remarcásemos	remarcar	VSI4
remarcaseis	remarcar	VSI5
remarcasen	remarcar	VSI6
remarcad	remarcar	VMP
remarcadme	remarcar	VMSE
remarcadle	remarcar	VMSE
remarcadnos	remarcar	VMPE
remarcaos	remarcar	VMPE
remarcadles	remarcar	VMPE
remarcadlo	remarcar	VMMSE
remarcadla	remarcar	VMFSE
remarcadlos	remarcar	VMMPE
remarcadlas	remarcar	VMFPE
remarcádmelo	remarcar	VMMSE
remarcádselo	remarcar	VMMSE
remarcádnoslo	remarcar	VMMSE
remarcáoslo	remarcar	VMMSE
remarcádmelos	remarcar	VMMPE
remarcádselos	remarcar	VMMPE
remarcádnoslos	remarcar	VMMPE
remarcáoslos	remarcar	VMMPE
remarcádmela	remarcar	VMFSE
remarcádsela	remarcar	VMFSE
remarcádnosla	remarcar	VMFSE
remarcáosla	remarcar	VMFSE
remarcádmelas	remarcar	VMFPE
remarcádselas	remarcar	VMFPE
remarcádnoslas	remarcar	VMFPE
remarcáoslas	remarcar	VMFPE
remarcado	remarcar	VPM
remarcados	remarcar	VPMP
remarcada	remarcar	VPF
remarcadas	remarcar	VPFP
remarcando	remarcar	VG
remarcándome	remarcar	VGSE
remarcándote	remarcar	VGSE
remarcándole	remarcar	VGSE
remarcándonos	remarcar	VGPE
remarcándoos	remarcar	VGPE
remarcándolo	remarcar	VGMSE
remarcándola	remarcar	VGFSE
remarcándolos	remarcar	VGMPE
remarcándolas	remarcar	VGFPE
remarcándomelo	remarcar	VGMSE
remarcándotelo	remarcar	VGMSE
remarcándoselo	remarcar	VGMSE
remarcándonoslo	remarcar	VGMSE
remarcándooslo	remarcar	VGMSE
remarcándomelos	remarcar	VGMPE
remarcándotelos	remarcar	VGMPE
remarcándoselos	remarcar	VGMPE
remarcándonoslos	remarcar	VGMPE
remarcándooslos	remarcar	VGMPE
remarcándomela	remarcar	VGFSE
remarcándotela	remarcar	VGFSE
remarcándosela	remarcar	VGFSE
remarcándonosla	remarcar	VGFSE
remarcándoosla	remarcar	VGFSE
remarcándomelas	remarcar	VGFPE
remarcándotelas	remarcar	VGFPE
remarcándoselas	remarcar	VGFPE
remarcándonoslas	remarcar	VGFPE
remarcándooslas	remarcar	VGFPE
rematar	rematar	O
remato	rematar	VIP1
rematas	rematar	VIP2
remata	rematar	VIP3
rematamos	rematar	VIP4
rematáis	rematar	VIP5
rematan	rematar	VIP6
remataba	rematar	VII1
rematabas	rematar	VII2
rematábamos	rematar	VII4
rematabais	rematar	VII5
remataban	rematar	VII6
remataré	rematar	VIF1
rematarás	rematar	VIF2
rematará	rematar	VIF3
remataremos	rematar	VIF4
remataréis	rematar	VIF5
rematarán	rematar	VIF6
remataría	rematar	VIC1
rematarías	rematar	VIC2
remataría	rematar	VIC3
remataríamos	rematar	VIC4
remataríais	rematar	VIC5
rematarían	rematar	VIC6
rematé	rematar	VIX1
remataste	rematar	VIX2
remató	rematar	VIX3
rematasteis	rematar	VIX5
remataron	rematar	VIX6
remate	rematar	VSP1
remates	rematar	VSP2
rematemos	rematar	VSP4
rematéis	rematar	VSP5
rematen	rematar	VSP6
rematara	rematar	VSX1
remataras	rematar	VSX2
rematáramos	rematar	VSX4
rematarais	rematar	VSX5
remataran	rematar	VSX6
rematare	rematar	VSF1
rematares	rematar	VSF2
rematáremos	rematar	VSF4
rematareis	rematar	VSF5
remataren	rematar	VSF6
rematase	rematar	VSI1
rematases	rematar	VSI2
rematásemos	rematar	VSI4
remataseis	rematar	VSI5
rematasen	rematar	VSI6
rematad	rematar	VMP
rematadme	rematar	VMSE
rematadle	rematar	VMSE
rematadnos	rematar	VMPE
remataos	rematar	VMPE
rematadles	rematar	VMPE
rematadlo	rematar	VMMSE
rematadla	rematar	VMFSE
rematadlos	rematar	VMMPE
rematadlas	rematar	VMFPE
rematádmelo	rematar	VMMSE
rematádselo	rematar	VMMSE
rematádnoslo	rematar	VMMSE
rematáoslo	rematar	VMMSE
rematádmelos	rematar	VMMPE
rematádselos	rematar	VMMPE
rematádnoslos	rematar	VMMPE
rematáoslos	rematar	VMMPE
rematádmela	rematar	VMFSE
rematádsela	rematar	VMFSE
rematádnosla	rematar	VMFSE
rematáosla	rematar	VMFSE
rematádmelas	rematar	VMFPE
rematádselas	rematar	VMFPE
rematádnoslas	rematar	VMFPE
rematáoslas	rematar	VMFPE
rematado	rematar	VPM
rematados	rematar	VPMP
rematada	rematar	VPF
rematadas	rematar	VPFP
rematando	rematar	VG
rematándome	rematar	VGSE
rematándote	rematar	VGSE
rematándole	rematar	VGSE
rematándonos	rematar	VGPE
rematándoos	rematar	VGPE
rematándolo	rematar	VGMSE
rematándola	rematar	VGFSE
rematándolos	rematar	VGMPE
rematándolas	rematar	VGFPE
rematándomelo	rematar	VGMSE
rematándotelo	rematar	VGMSE
rematándoselo	rematar	VGMSE
rematándonoslo	rematar	VGMSE
rematándooslo	rematar	VGMSE
rematándomelos	rematar	VGMPE
rematándotelos	rematar	VGMPE
rematándoselos	rematar	VGMPE
rematándonoslos	rematar	VGMPE
rematándooslos	rematar	VGMPE
rematándomela	rematar	VGFSE
rematándotela	rematar	VGFSE
rematándosela	rematar	VGFSE
rematándonosla	rematar	VGFSE
rematándoosla	rematar	VGFSE
rematándomelas	rematar	VGFPE
rematándotelas	rematar	VGFPE
rematándoselas	rematar	VGFPE
rematándonoslas	rematar	VGFPE
rematándooslas	rematar	VGFPE
rembolsar	rembolsar	O
rembolso	rembolsar	VIP1
rembolsas	rembolsar	VIP2
rembolsa	rembolsar	VIP3
rembolsamos	rembolsar	VIP4
rembolsáis	rembolsar	VIP5
rembolsan	rembolsar	VIP6
rembolsaba	rembolsar	VII1
rembolsabas	rembolsar	VII2
rembolsábamos	rembolsar	VII4
rembolsabais	rembolsar	VII5
rembolsaban	rembolsar	VII6
rembolsaré	rembolsar	VIF1
rembolsarás	rembolsar	VIF2
rembolsará	rembolsar	VIF3
rembolsaremos	rembolsar	VIF4
rembolsaréis	rembolsar	VIF5
rembolsarán	rembolsar	VIF6
rembolsaría	rembolsar	VIC1
rembolsarías	rembolsar	VIC2
rembolsaría	rembolsar	VIC3
rembolsaríamos	rembolsar	VIC4
rembolsaríais	rembolsar	VIC5
rembolsarían	rembolsar	VIC6
rembolsé	rembolsar	VIX1
rembolsaste	rembolsar	VIX2
rembolsó	rembolsar	VIX3
rembolsasteis	rembolsar	VIX5
rembolsaron	rembolsar	VIX6
rembolse	rembolsar	VSP1
rembolses	rembolsar	VSP2
rembolsemos	rembolsar	VSP4
rembolséis	rembolsar	VSP5
rembolsen	rembolsar	VSP6
rembolsara	rembolsar	VSX1
rembolsaras	rembolsar	VSX2
rembolsáramos	rembolsar	VSX4
rembolsarais	rembolsar	VSX5
rembolsaran	rembolsar	VSX6
rembolsare	rembolsar	VSF1
rembolsares	rembolsar	VSF2
rembolsáremos	rembolsar	VSF4
rembolsareis	rembolsar	VSF5
rembolsaren	rembolsar	VSF6
rembolsase	rembolsar	VSI1
rembolsases	rembolsar	VSI2
rembolsásemos	rembolsar	VSI4
rembolsaseis	rembolsar	VSI5
rembolsasen	rembolsar	VSI6
rembolsad	rembolsar	VMP
rembolsadme	rembolsar	VMSE
rembolsadle	rembolsar	VMSE
rembolsadnos	rembolsar	VMPE
rembolsaos	rembolsar	VMPE
rembolsadles	rembolsar	VMPE
rembolsadlo	rembolsar	VMMSE
rembolsadla	rembolsar	VMFSE
rembolsadlos	rembolsar	VMMPE
rembolsadlas	rembolsar	VMFPE
rembolsádmelo	rembolsar	VMMSE
rembolsádselo	rembolsar	VMMSE
rembolsádnoslo	rembolsar	VMMSE
rembolsáoslo	rembolsar	VMMSE
rembolsádmelos	rembolsar	VMMPE
rembolsádselos	rembolsar	VMMPE
rembolsádnoslos	rembolsar	VMMPE
rembolsáoslos	rembolsar	VMMPE
rembolsádmela	rembolsar	VMFSE
rembolsádsela	rembolsar	VMFSE
rembolsádnosla	rembolsar	VMFSE
rembolsáosla	rembolsar	VMFSE
rembolsádmelas	rembolsar	VMFPE
rembolsádselas	rembolsar	VMFPE
rembolsádnoslas	rembolsar	VMFPE
rembolsáoslas	rembolsar	VMFPE
rembolsado	rembolsar	VPM
rembolsados	rembolsar	VPMP
rembolsada	rembolsar	VPF
rembolsadas	rembolsar	VPFP
rembolsando	rembolsar	VG
rembolsándome	rembolsar	VGSE
rembolsándote	rembolsar	VGSE
rembolsándole	rembolsar	VGSE
rembolsándonos	rembolsar	VGPE
rembolsándoos	rembolsar	VGPE
rembolsándolo	rembolsar	VGMSE
rembolsándola	rembolsar	VGFSE
rembolsándolos	rembolsar	VGMPE
rembolsándolas	rembolsar	VGFPE
rembolsándomelo	rembolsar	VGMSE
rembolsándotelo	rembolsar	VGMSE
rembolsándoselo	rembolsar	VGMSE
rembolsándonoslo	rembolsar	VGMSE
rembolsándooslo	rembolsar	VGMSE
rembolsándomelos	rembolsar	VGMPE
rembolsándotelos	rembolsar	VGMPE
rembolsándoselos	rembolsar	VGMPE
rembolsándonoslos	rembolsar	VGMPE
rembolsándooslos	rembolsar	VGMPE
rembolsándomela	rembolsar	VGFSE
rembolsándotela	rembolsar	VGFSE
rembolsándosela	rembolsar	VGFSE
rembolsándonosla	rembolsar	VGFSE
rembolsándoosla	rembolsar	VGFSE
rembolsándomelas	rembolsar	VGFPE
rembolsándotelas	rembolsar	VGFPE
rembolsándoselas	rembolsar	VGFPE
rembolsándonoslas	rembolsar	VGFPE
rembolsándooslas	rembolsar	VGFPE
remedar	remedar	O
remedo	remedar	VIP1
remedas	remedar	VIP2
remeda	remedar	VIP3
remedamos	remedar	VIP4
remedáis	remedar	VIP5
remedan	remedar	VIP6
remedaba	remedar	VII1
remedabas	remedar	VII2
remedábamos	remedar	VII4
remedabais	remedar	VII5
remedaban	remedar	VII6
remedaré	remedar	VIF1
remedarás	remedar	VIF2
remedará	remedar	VIF3
remedaremos	remedar	VIF4
remedaréis	remedar	VIF5
remedarán	remedar	VIF6
remedaría	remedar	VIC1
remedarías	remedar	VIC2
remedaría	remedar	VIC3
remedaríamos	remedar	VIC4
remedaríais	remedar	VIC5
remedarían	remedar	VIC6
remedé	remedar	VIX1
remedaste	remedar	VIX2
remedó	remedar	VIX3
remedasteis	remedar	VIX5
remedaron	remedar	VIX6
remede	remedar	VSP1
remedes	remedar	VSP2
remedemos	remedar	VSP4
remedéis	remedar	VSP5
remeden	remedar	VSP6
remedara	remedar	VSX1
remedaras	remedar	VSX2
remedáramos	remedar	VSX4
remedarais	remedar	VSX5
remedaran	remedar	VSX6
remedare	remedar	VSF1
remedares	remedar	VSF2
remedáremos	remedar	VSF4
remedareis	remedar	VSF5
remedaren	remedar	VSF6
remedase	remedar	VSI1
remedases	remedar	VSI2
remedásemos	remedar	VSI4
remedaseis	remedar	VSI5
remedasen	remedar	VSI6
remedad	remedar	VMP
remedadme	remedar	VMSE
remedadle	remedar	VMSE
remedadnos	remedar	VMPE
remedaos	remedar	VMPE
remedadles	remedar	VMPE
remedadlo	remedar	VMMSE
remedadla	remedar	VMFSE
remedadlos	remedar	VMMPE
remedadlas	remedar	VMFPE
remedádmelo	remedar	VMMSE
remedádselo	remedar	VMMSE
remedádnoslo	remedar	VMMSE
remedáoslo	remedar	VMMSE
remedádmelos	remedar	VMMPE
remedádselos	remedar	VMMPE
remedádnoslos	remedar	VMMPE
remedáoslos	remedar	VMMPE
remedádmela	remedar	VMFSE
remedádsela	remedar	VMFSE
remedádnosla	remedar	VMFSE
remedáosla	remedar	VMFSE
remedádmelas	remedar	VMFPE
remedádselas	remedar	VMFPE
remedádnoslas	remedar	VMFPE
remedáoslas	remedar	VMFPE
remedado	remedar	VPM
remedados	remedar	VPMP
remedada	remedar	VPF
remedadas	remedar	VPFP
remedando	remedar	VG
remedándome	remedar	VGSE
remedándote	remedar	VGSE
remedándole	remedar	VGSE
remedándonos	remedar	VGPE
remedándoos	remedar	VGPE
remedándolo	remedar	VGMSE
remedándola	remedar	VGFSE
remedándolos	remedar	VGMPE
remedándolas	remedar	VGFPE
remedándomelo	remedar	VGMSE
remedándotelo	remedar	VGMSE
remedándoselo	remedar	VGMSE
remedándonoslo	remedar	VGMSE
remedándooslo	remedar	VGMSE
remedándomelos	remedar	VGMPE
remedándotelos	remedar	VGMPE
remedándoselos	remedar	VGMPE
remedándonoslos	remedar	VGMPE
remedándooslos	remedar	VGMPE
remedándomela	remedar	VGFSE
remedándotela	remedar	VGFSE
remedándosela	remedar	VGFSE
remedándonosla	remedar	VGFSE
remedándoosla	remedar	VGFSE
remedándomelas	remedar	VGFPE
remedándotelas	remedar	VGFPE
remedándoselas	remedar	VGFPE
remedándonoslas	remedar	VGFPE
remedándooslas	remedar	VGFPE
remediar	remediar	O
remedio	remediar	VIP1
remedias	remediar	VIP2
remedia	remediar	VIP3
remediamos	remediar	VIP4
remediáis	remediar	VIP5
remedian	remediar	VIP6
remediaba	remediar	VII1
remediabas	remediar	VII2
remediábamos	remediar	VII4
remediabais	remediar	VII5
remediaban	remediar	VII6
remediaré	remediar	VIF1
remediarás	remediar	VIF2
remediará	remediar	VIF3
remediaremos	remediar	VIF4
remediaréis	remediar	VIF5
remediarán	remediar	VIF6
remediaría	remediar	VIC1
remediarías	remediar	VIC2
remediaría	remediar	VIC3
remediaríamos	remediar	VIC4
remediaríais	remediar	VIC5
remediarían	remediar	VIC6
remedié	remediar	VIX1
remediaste	remediar	VIX2
remedió	remediar	VIX3
remediasteis	remediar	VIX5
remediaron	remediar	VIX6
remedie	remediar	VSP1
remedies	remediar	VSP2
remediemos	remediar	VSP4
remediéis	remediar	VSP5
remedien	remediar	VSP6
remediara	remediar	VSX1
remediaras	remediar	VSX2
remediáramos	remediar	VSX4
remediarais	remediar	VSX5
remediaran	remediar	VSX6
remediare	remediar	VSF1
remediares	remediar	VSF2
remediáremos	remediar	VSF4
remediareis	remediar	VSF5
remediaren	remediar	VSF6
remediase	remediar	VSI1
remediases	remediar	VSI2
remediásemos	remediar	VSI4
remediaseis	remediar	VSI5
remediasen	remediar	VSI6
remediad	remediar	VMP
remediadme	remediar	VMSE
remediadle	remediar	VMSE
remediadnos	remediar	VMPE
remediaos	remediar	VMPE
remediadles	remediar	VMPE
remediadlo	remediar	VMMSE
remediadla	remediar	VMFSE
remediadlos	remediar	VMMPE
remediadlas	remediar	VMFPE
remediádmelo	remediar	VMMSE
remediádselo	remediar	VMMSE
remediádnoslo	remediar	VMMSE
remediáoslo	remediar	VMMSE
remediádmelos	remediar	VMMPE
remediádselos	remediar	VMMPE
remediádnoslos	remediar	VMMPE
remediáoslos	remediar	VMMPE
remediádmela	remediar	VMFSE
remediádsela	remediar	VMFSE
remediádnosla	remediar	VMFSE
remediáosla	remediar	VMFSE
remediádmelas	remediar	VMFPE
remediádselas	remediar	VMFPE
remediádnoslas	remediar	VMFPE
remediáoslas	remediar	VMFPE
remediado	remediar	VPM
remediados	remediar	VPMP
remediada	remediar	VPF
remediadas	remediar	VPFP
remediando	remediar	VG
remediándome	remediar	VGSE
remediándote	remediar	VGSE
remediándole	remediar	VGSE
remediándonos	remediar	VGPE
remediándoos	remediar	VGPE
remediándolo	remediar	VGMSE
remediándola	remediar	VGFSE
remediándolos	remediar	VGMPE
remediándolas	remediar	VGFPE
remediándomelo	remediar	VGMSE
remediándotelo	remediar	VGMSE
remediándoselo	remediar	VGMSE
remediándonoslo	remediar	VGMSE
remediándooslo	remediar	VGMSE
remediándomelos	remediar	VGMPE
remediándotelos	remediar	VGMPE
remediándoselos	remediar	VGMPE
remediándonoslos	remediar	VGMPE
remediándooslos	remediar	VGMPE
remediándomela	remediar	VGFSE
remediándotela	remediar	VGFSE
remediándosela	remediar	VGFSE
remediándonosla	remediar	VGFSE
remediándoosla	remediar	VGFSE
remediándomelas	remediar	VGFPE
remediándotelas	remediar	VGFPE
remediándoselas	remediar	VGFPE
remediándonoslas	remediar	VGFPE
remediándooslas	remediar	VGFPE
remellar	remellar	O
remello	remellar	VIP1
remellas	remellar	VIP2
remella	remellar	VIP3
remellamos	remellar	VIP4
remelláis	remellar	VIP5
remellan	remellar	VIP6
remellaba	remellar	VII1
remellabas	remellar	VII2
remellábamos	remellar	VII4
remellabais	remellar	VII5
remellaban	remellar	VII6
remellaré	remellar	VIF1
remellarás	remellar	VIF2
remellará	remellar	VIF3
remellaremos	remellar	VIF4
remellaréis	remellar	VIF5
remellarán	remellar	VIF6
remellaría	remellar	VIC1
remellarías	remellar	VIC2
remellaría	remellar	VIC3
remellaríamos	remellar	VIC4
remellaríais	remellar	VIC5
remellarían	remellar	VIC6
remellé	remellar	VIX1
remellaste	remellar	VIX2
remelló	remellar	VIX3
remellasteis	remellar	VIX5
remellaron	remellar	VIX6
remelle	remellar	VSP1
remelles	remellar	VSP2
remellemos	remellar	VSP4
remelléis	remellar	VSP5
remellen	remellar	VSP6
remellara	remellar	VSX1
remellaras	remellar	VSX2
remelláramos	remellar	VSX4
remellarais	remellar	VSX5
remellaran	remellar	VSX6
remellare	remellar	VSF1
remellares	remellar	VSF2
remelláremos	remellar	VSF4
remellareis	remellar	VSF5
remellaren	remellar	VSF6
remellase	remellar	VSI1
remellases	remellar	VSI2
remellásemos	remellar	VSI4
remellaseis	remellar	VSI5
remellasen	remellar	VSI6
remellad	remellar	VMP
remelladme	remellar	VMSE
remelladle	remellar	VMSE
remelladnos	remellar	VMPE
remellaos	remellar	VMPE
remelladles	remellar	VMPE
remelladlo	remellar	VMMSE
remelladla	remellar	VMFSE
remelladlos	remellar	VMMPE
remelladlas	remellar	VMFPE
remelládmelo	remellar	VMMSE
remelládselo	remellar	VMMSE
remelládnoslo	remellar	VMMSE
remelláoslo	remellar	VMMSE
remelládmelos	remellar	VMMPE
remelládselos	remellar	VMMPE
remelládnoslos	remellar	VMMPE
remelláoslos	remellar	VMMPE
remelládmela	remellar	VMFSE
remelládsela	remellar	VMFSE
remelládnosla	remellar	VMFSE
remelláosla	remellar	VMFSE
remelládmelas	remellar	VMFPE
remelládselas	remellar	VMFPE
remelládnoslas	remellar	VMFPE
remelláoslas	remellar	VMFPE
remellado	remellar	VPM
remellados	remellar	VPMP
remellada	remellar	VPF
remelladas	remellar	VPFP
remellando	remellar	VG
remellándome	remellar	VGSE
remellándote	remellar	VGSE
remellándole	remellar	VGSE
remellándonos	remellar	VGPE
remellándoos	remellar	VGPE
remellándolo	remellar	VGMSE
remellándola	remellar	VGFSE
remellándolos	remellar	VGMPE
remellándolas	remellar	VGFPE
remellándomelo	remellar	VGMSE
remellándotelo	remellar	VGMSE
remellándoselo	remellar	VGMSE
remellándonoslo	remellar	VGMSE
remellándooslo	remellar	VGMSE
remellándomelos	remellar	VGMPE
remellándotelos	remellar	VGMPE
remellándoselos	remellar	VGMPE
remellándonoslos	remellar	VGMPE
remellándooslos	remellar	VGMPE
remellándomela	remellar	VGFSE
remellándotela	remellar	VGFSE
remellándosela	remellar	VGFSE
remellándonosla	remellar	VGFSE
remellándoosla	remellar	VGFSE
remellándomelas	remellar	VGFPE
remellándotelas	remellar	VGFPE
remellándoselas	remellar	VGFPE
remellándonoslas	remellar	VGFPE
remellándooslas	remellar	VGFPE
remembrar	remembrar	O
remembro	remembrar	VIP1
remembras	remembrar	VIP2
remembra	remembrar	VIP3
remembramos	remembrar	VIP4
remembráis	remembrar	VIP5
remembran	remembrar	VIP6
remembraba	remembrar	VII1
remembrabas	remembrar	VII2
remembrábamos	remembrar	VII4
remembrabais	remembrar	VII5
remembraban	remembrar	VII6
remembraré	remembrar	VIF1
remembrarás	remembrar	VIF2
remembrará	remembrar	VIF3
remembraremos	remembrar	VIF4
remembraréis	remembrar	VIF5
remembrarán	remembrar	VIF6
remembraría	remembrar	VIC1
remembrarías	remembrar	VIC2
remembraría	remembrar	VIC3
remembraríamos	remembrar	VIC4
remembraríais	remembrar	VIC5
remembrarían	remembrar	VIC6
remembré	remembrar	VIX1
remembraste	remembrar	VIX2
remembró	remembrar	VIX3
remembrasteis	remembrar	VIX5
remembraron	remembrar	VIX6
remembre	remembrar	VSP1
remembres	remembrar	VSP2
remembremos	remembrar	VSP4
remembréis	remembrar	VSP5
remembren	remembrar	VSP6
remembrara	remembrar	VSX1
remembraras	remembrar	VSX2
remembráramos	remembrar	VSX4
remembrarais	remembrar	VSX5
remembraran	remembrar	VSX6
remembrare	remembrar	VSF1
remembrares	remembrar	VSF2
remembráremos	remembrar	VSF4
remembrareis	remembrar	VSF5
remembraren	remembrar	VSF6
remembrase	remembrar	VSI1
remembrases	remembrar	VSI2
remembrásemos	remembrar	VSI4
remembraseis	remembrar	VSI5
remembrasen	remembrar	VSI6
remembrad	remembrar	VMP
remembradme	remembrar	VMSE
remembradle	remembrar	VMSE
remembradnos	remembrar	VMPE
remembraos	remembrar	VMPE
remembradles	remembrar	VMPE
remembradlo	remembrar	VMMSE
remembradla	remembrar	VMFSE
remembradlos	remembrar	VMMPE
remembradlas	remembrar	VMFPE
remembrádmelo	remembrar	VMMSE
remembrádselo	remembrar	VMMSE
remembrádnoslo	remembrar	VMMSE
remembráoslo	remembrar	VMMSE
remembrádmelos	remembrar	VMMPE
remembrádselos	remembrar	VMMPE
remembrádnoslos	remembrar	VMMPE
remembráoslos	remembrar	VMMPE
remembrádmela	remembrar	VMFSE
remembrádsela	remembrar	VMFSE
remembrádnosla	remembrar	VMFSE
remembráosla	remembrar	VMFSE
remembrádmelas	remembrar	VMFPE
remembrádselas	remembrar	VMFPE
remembrádnoslas	remembrar	VMFPE
remembráoslas	remembrar	VMFPE
remembrado	remembrar	VPM
remembrados	remembrar	VPMP
remembrada	remembrar	VPF
remembradas	remembrar	VPFP
remembrando	remembrar	VG
remembrándome	remembrar	VGSE
remembrándote	remembrar	VGSE
remembrándole	remembrar	VGSE
remembrándonos	remembrar	VGPE
remembrándoos	remembrar	VGPE
remembrándolo	remembrar	VGMSE
remembrándola	remembrar	VGFSE
remembrándolos	remembrar	VGMPE
remembrándolas	remembrar	VGFPE
remembrándomelo	remembrar	VGMSE
remembrándotelo	remembrar	VGMSE
remembrándoselo	remembrar	VGMSE
remembrándonoslo	remembrar	VGMSE
remembrándooslo	remembrar	VGMSE
remembrándomelos	remembrar	VGMPE
remembrándotelos	remembrar	VGMPE
remembrándoselos	remembrar	VGMPE
remembrándonoslos	remembrar	VGMPE
remembrándooslos	remembrar	VGMPE
remembrándomela	remembrar	VGFSE
remembrándotela	remembrar	VGFSE
remembrándosela	remembrar	VGFSE
remembrándonosla	remembrar	VGFSE
remembrándoosla	remembrar	VGFSE
remembrándomelas	remembrar	VGFPE
remembrándotelas	remembrar	VGFPE
remembrándoselas	remembrar	VGFPE
remembrándonoslas	remembrar	VGFPE
remembrándooslas	remembrar	VGFPE
rememorar	rememorar	O
rememoro	rememorar	VIP1
rememoras	rememorar	VIP2
rememora	rememorar	VIP3
rememoramos	rememorar	VIP4
rememoráis	rememorar	VIP5
rememoran	rememorar	VIP6
rememoraba	rememorar	VII1
rememorabas	rememorar	VII2
rememorábamos	rememorar	VII4
rememorabais	rememorar	VII5
rememoraban	rememorar	VII6
rememoraré	rememorar	VIF1
rememorarás	rememorar	VIF2
rememorará	rememorar	VIF3
rememoraremos	rememorar	VIF4
rememoraréis	rememorar	VIF5
rememorarán	rememorar	VIF6
rememoraría	rememorar	VIC1
rememorarías	rememorar	VIC2
rememoraría	rememorar	VIC3
rememoraríamos	rememorar	VIC4
rememoraríais	rememorar	VIC5
rememorarían	rememorar	VIC6
rememoré	rememorar	VIX1
rememoraste	rememorar	VIX2
rememoró	rememorar	VIX3
rememorasteis	rememorar	VIX5
rememoraron	rememorar	VIX6
rememore	rememorar	VSP1
rememores	rememorar	VSP2
rememoremos	rememorar	VSP4
rememoréis	rememorar	VSP5
rememoren	rememorar	VSP6
rememorara	rememorar	VSX1
rememoraras	rememorar	VSX2
rememoráramos	rememorar	VSX4
rememorarais	rememorar	VSX5
rememoraran	rememorar	VSX6
rememorare	rememorar	VSF1
rememorares	rememorar	VSF2
rememoráremos	rememorar	VSF4
rememorareis	rememorar	VSF5
rememoraren	rememorar	VSF6
rememorase	rememorar	VSI1
rememorases	rememorar	VSI2
rememorásemos	rememorar	VSI4
rememoraseis	rememorar	VSI5
rememorasen	rememorar	VSI6
rememorad	rememorar	VMP
rememoradme	rememorar	VMSE
rememoradle	rememorar	VMSE
rememoradnos	rememorar	VMPE
rememoraos	rememorar	VMPE
rememoradles	rememorar	VMPE
rememoradlo	rememorar	VMMSE
rememoradla	rememorar	VMFSE
rememoradlos	rememorar	VMMPE
rememoradlas	rememorar	VMFPE
rememorádmelo	rememorar	VMMSE
rememorádselo	rememorar	VMMSE
rememorádnoslo	rememorar	VMMSE
rememoráoslo	rememorar	VMMSE
rememorádmelos	rememorar	VMMPE
rememorádselos	rememorar	VMMPE
rememorádnoslos	rememorar	VMMPE
rememoráoslos	rememorar	VMMPE
rememorádmela	rememorar	VMFSE
rememorádsela	rememorar	VMFSE
rememorádnosla	rememorar	VMFSE
rememoráosla	rememorar	VMFSE
rememorádmelas	rememorar	VMFPE
rememorádselas	rememorar	VMFPE
rememorádnoslas	rememorar	VMFPE
rememoráoslas	rememorar	VMFPE
rememorado	rememorar	VPM
rememorados	rememorar	VPMP
rememorada	rememorar	VPF
rememoradas	rememorar	VPFP
rememorando	rememorar	VG
rememorándome	rememorar	VGSE
rememorándote	rememorar	VGSE
rememorándole	rememorar	VGSE
rememorándonos	rememorar	VGPE
rememorándoos	rememorar	VGPE
rememorándolo	rememorar	VGMSE
rememorándola	rememorar	VGFSE
rememorándolos	rememorar	VGMPE
rememorándolas	rememorar	VGFPE
rememorándomelo	rememorar	VGMSE
rememorándotelo	rememorar	VGMSE
rememorándoselo	rememorar	VGMSE
rememorándonoslo	rememorar	VGMSE
rememorándooslo	rememorar	VGMSE
rememorándomelos	rememorar	VGMPE
rememorándotelos	rememorar	VGMPE
rememorándoselos	rememorar	VGMPE
rememorándonoslos	rememorar	VGMPE
rememorándooslos	rememorar	VGMPE
rememorándomela	rememorar	VGFSE
rememorándotela	rememorar	VGFSE
rememorándosela	rememorar	VGFSE
rememorándonosla	rememorar	VGFSE
rememorándoosla	rememorar	VGFSE
rememorándomelas	rememorar	VGFPE
rememorándotelas	rememorar	VGFPE
rememorándoselas	rememorar	VGFPE
rememorándonoslas	rememorar	VGFPE
rememorándooslas	rememorar	VGFPE
remendar	remendar	O
remiendo	remendar	VIP1
remiendas	remendar	VIP2
remienda	remendar	VIP3
remendamos	remendar	VIP4
remendáis	remendar	VIP5
remiendan	remendar	VIP6
remendaba	remendar	VII1
remendabas	remendar	VII2
remendábamos	remendar	VII4
remendabais	remendar	VII5
remendaban	remendar	VII6
remendaré	remendar	VIF1
remendarás	remendar	VIF2
remendará	remendar	VIF3
remendaremos	remendar	VIF4
remendaréis	remendar	VIF5
remendarán	remendar	VIF6
remendaría	remendar	VIC1
remendarías	remendar	VIC2
remendaría	remendar	VIC3
remendaríamos	remendar	VIC4
remendaríais	remendar	VIC5
remendarían	remendar	VIC6
remendé	remendar	VIX1
remendaste	remendar	VIX2
remendó	remendar	VIX3
remendasteis	remendar	VIX5
remendaron	remendar	VIX6
remiende	remendar	VSP1
remiendes	remendar	VSP2
remendemos	remendar	VSP4
remendéis	remendar	VSP5
remienden	remendar	VSP6
remendara	remendar	VSX1
remendaras	remendar	VSX2
remendáramos	remendar	VSX4
remendarais	remendar	VSX5
remendaran	remendar	VSX6
remendare	remendar	VSF1
remendares	remendar	VSF2
remendáremos	remendar	VSF4
remendareis	remendar	VSF5
remendaren	remendar	VSF6
remendase	remendar	VSI1
remendases	remendar	VSI2
remendásemos	remendar	VSI4
remendaseis	remendar	VSI5
remendasen	remendar	VSI6
remendad	remendar	VMP
remendadme	remendar	VMSE
remendadle	remendar	VMSE
remendadnos	remendar	VMPE
remendaos	remendar	VMPE
remendadles	remendar	VMPE
remendadlo	remendar	VMMSE
remendadla	remendar	VMFSE
remendadlos	remendar	VMMPE
remendadlas	remendar	VMFPE
remendádmelo	remendar	VMMSE
remendádselo	remendar	VMMSE
remendádnoslo	remendar	VMMSE
remendáoslo	remendar	VMMSE
remendádmelos	remendar	VMMPE
remendádselos	remendar	VMMPE
remendádnoslos	remendar	VMMPE
remendáoslos	remendar	VMMPE
remendádmela	remendar	VMFSE
remendádsela	remendar	VMFSE
remendádnosla	remendar	VMFSE
remendáosla	remendar	VMFSE
remendádmelas	remendar	VMFPE
remendádselas	remendar	VMFPE
remendádnoslas	remendar	VMFPE
remendáoslas	remendar	VMFPE
remendado	remendar	VPM
remendados	remendar	VPMP
remendada	remendar	VPF
remendadas	remendar	VPFP
remendando	remendar	VG
remendándome	remendar	VGSE
remendándote	remendar	VGSE
remendándole	remendar	VGSE
remendándonos	remendar	VGPE
remendándoos	remendar	VGPE
remendándolo	remendar	VGMSE
remendándola	remendar	VGFSE
remendándolos	remendar	VGMPE
remendándolas	remendar	VGFPE
remendándomelo	remendar	VGMSE
remendándotelo	remendar	VGMSE
remendándoselo	remendar	VGMSE
remendándonoslo	remendar	VGMSE
remendándooslo	remendar	VGMSE
remendándomelos	remendar	VGMPE
remendándotelos	remendar	VGMPE
remendándoselos	remendar	VGMPE
remendándonoslos	remendar	VGMPE
remendándooslos	remendar	VGMPE
remendándomela	remendar	VGFSE
remendándotela	remendar	VGFSE
remendándosela	remendar	VGFSE
remendándonosla	remendar	VGFSE
remendándoosla	remendar	VGFSE
remendándomelas	remendar	VGFPE
remendándotelas	remendar	VGFPE
remendándoselas	remendar	VGFPE
remendándonoslas	remendar	VGFPE
remendándooslas	remendar	VGFPE
remesar	remesar	O
remeso	remesar	VIP1
remesas	remesar	VIP2
remesa	remesar	VIP3
remesamos	remesar	VIP4
remesáis	remesar	VIP5
remesan	remesar	VIP6
remesaba	remesar	VII1
remesabas	remesar	VII2
remesábamos	remesar	VII4
remesabais	remesar	VII5
remesaban	remesar	VII6
remesaré	remesar	VIF1
remesarás	remesar	VIF2
remesará	remesar	VIF3
remesaremos	remesar	VIF4
remesaréis	remesar	VIF5
remesarán	remesar	VIF6
remesaría	remesar	VIC1
remesarías	remesar	VIC2
remesaría	remesar	VIC3
remesaríamos	remesar	VIC4
remesaríais	remesar	VIC5
remesarían	remesar	VIC6
remesé	remesar	VIX1
remesaste	remesar	VIX2
remesó	remesar	VIX3
remesasteis	remesar	VIX5
remesaron	remesar	VIX6
remese	remesar	VSP1
remeses	remesar	VSP2
remesemos	remesar	VSP4
remeséis	remesar	VSP5
remesen	remesar	VSP6
remesara	remesar	VSX1
remesaras	remesar	VSX2
remesáramos	remesar	VSX4
remesarais	remesar	VSX5
remesaran	remesar	VSX6
remesare	remesar	VSF1
remesares	remesar	VSF2
remesáremos	remesar	VSF4
remesareis	remesar	VSF5
remesaren	remesar	VSF6
remesase	remesar	VSI1
remesases	remesar	VSI2
remesásemos	remesar	VSI4
remesaseis	remesar	VSI5
remesasen	remesar	VSI6
remesad	remesar	VMP
remesadme	remesar	VMSE
remesadle	remesar	VMSE
remesadnos	remesar	VMPE
remesaos	remesar	VMPE
remesadles	remesar	VMPE
remesadlo	remesar	VMMSE
remesadla	remesar	VMFSE
remesadlos	remesar	VMMPE
remesadlas	remesar	VMFPE
remesádmelo	remesar	VMMSE
remesádselo	remesar	VMMSE
remesádnoslo	remesar	VMMSE
remesáoslo	remesar	VMMSE
remesádmelos	remesar	VMMPE
remesádselos	remesar	VMMPE
remesádnoslos	remesar	VMMPE
remesáoslos	remesar	VMMPE
remesádmela	remesar	VMFSE
remesádsela	remesar	VMFSE
remesádnosla	remesar	VMFSE
remesáosla	remesar	VMFSE
remesádmelas	remesar	VMFPE
remesádselas	remesar	VMFPE
remesádnoslas	remesar	VMFPE
remesáoslas	remesar	VMFPE
remesado	remesar	VPM
remesados	remesar	VPMP
remesada	remesar	VPF
remesadas	remesar	VPFP
remesando	remesar	VG
remesándome	remesar	VGSE
remesándote	remesar	VGSE
remesándole	remesar	VGSE
remesándonos	remesar	VGPE
remesándoos	remesar	VGPE
remesándolo	remesar	VGMSE
remesándola	remesar	VGFSE
remesándolos	remesar	VGMPE
remesándolas	remesar	VGFPE
remesándomelo	remesar	VGMSE
remesándotelo	remesar	VGMSE
remesándoselo	remesar	VGMSE
remesándonoslo	remesar	VGMSE
remesándooslo	remesar	VGMSE
remesándomelos	remesar	VGMPE
remesándotelos	remesar	VGMPE
remesándoselos	remesar	VGMPE
remesándonoslos	remesar	VGMPE
remesándooslos	remesar	VGMPE
remesándomela	remesar	VGFSE
remesándotela	remesar	VGFSE
remesándosela	remesar	VGFSE
remesándonosla	remesar	VGFSE
remesándoosla	remesar	VGFSE
remesándomelas	remesar	VGFPE
remesándotelas	remesar	VGFPE
remesándoselas	remesar	VGFPE
remesándonoslas	remesar	VGFPE
remesándooslas	remesar	VGFPE
remilgar	remilgar	O
remilgo	remilgar	VIP1
remilgas	remilgar	VIP2
remilga	remilgar	VIP3
remilgamos	remilgar	VIP4
remilgáis	remilgar	VIP5
remilgan	remilgar	VIP6
remilgaba	remilgar	VII1
remilgabas	remilgar	VII2
remilgábamos	remilgar	VII4
remilgabais	remilgar	VII5
remilgaban	remilgar	VII6
remilgaré	remilgar	VIF1
remilgarás	remilgar	VIF2
remilgará	remilgar	VIF3
remilgaremos	remilgar	VIF4
remilgaréis	remilgar	VIF5
remilgarán	remilgar	VIF6
remilgaría	remilgar	VIC1
remilgarías	remilgar	VIC2
remilgaría	remilgar	VIC3
remilgaríamos	remilgar	VIC4
remilgaríais	remilgar	VIC5
remilgarían	remilgar	VIC6
remilgé	remilgar	VIX1
remilgaste	remilgar	VIX2
remilgó	remilgar	VIX3
remilgasteis	remilgar	VIX5
remilgaron	remilgar	VIX6
remilgue	remilgar	VSP1
remilgues	remilgar	VSP2
remilguemos	remilgar	VSP4
remilguéis	remilgar	VSP5
remilguen	remilgar	VSP6
remilgara	remilgar	VSX1
remilgaras	remilgar	VSX2
remilgáramos	remilgar	VSX4
remilgarais	remilgar	VSX5
remilgaran	remilgar	VSX6
remilgare	remilgar	VSF1
remilgares	remilgar	VSF2
remilgáremos	remilgar	VSF4
remilgareis	remilgar	VSF5
remilgaren	remilgar	VSF6
remilgase	remilgar	VSI1
remilgases	remilgar	VSI2
remilgásemos	remilgar	VSI4
remilgaseis	remilgar	VSI5
remilgasen	remilgar	VSI6
remilgad	remilgar	VMP
remilgadme	remilgar	VMSE
remilgadle	remilgar	VMSE
remilgadnos	remilgar	VMPE
remilgaos	remilgar	VMPE
remilgadles	remilgar	VMPE
remilgado	remilgar	VPM
remilgados	remilgar	VPMP
remilgada	remilgar	VPF
remilgadas	remilgar	VPFP
remilgando	remilgar	VG
remilgándome	remilgar	VGSE
remilgándote	remilgar	VGSE
remilgándole	remilgar	VGSE
remilgándonos	remilgar	VGPE
remilgándoos	remilgar	VGPE
remirar	remirar	O
remiro	remirar	VIP1
remiras	remirar	VIP2
remira	remirar	VIP3
remiramos	remirar	VIP4
remiráis	remirar	VIP5
remiran	remirar	VIP6
remiraba	remirar	VII1
remirabas	remirar	VII2
remirábamos	remirar	VII4
remirabais	remirar	VII5
remiraban	remirar	VII6
remiraré	remirar	VIF1
remirarás	remirar	VIF2
remirará	remirar	VIF3
remiraremos	remirar	VIF4
remiraréis	remirar	VIF5
remirarán	remirar	VIF6
remiraría	remirar	VIC1
remirarías	remirar	VIC2
remiraría	remirar	VIC3
remiraríamos	remirar	VIC4
remiraríais	remirar	VIC5
remirarían	remirar	VIC6
remiré	remirar	VIX1
remiraste	remirar	VIX2
remiró	remirar	VIX3
remirasteis	remirar	VIX5
remiraron	remirar	VIX6
remire	remirar	VSP1
remires	remirar	VSP2
remiremos	remirar	VSP4
remiréis	remirar	VSP5
remiren	remirar	VSP6
remirara	remirar	VSX1
remiraras	remirar	VSX2
remiráramos	remirar	VSX4
remirarais	remirar	VSX5
remiraran	remirar	VSX6
remirare	remirar	VSF1
remirares	remirar	VSF2
remiráremos	remirar	VSF4
remirareis	remirar	VSF5
remiraren	remirar	VSF6
remirase	remirar	VSI1
remirases	remirar	VSI2
remirásemos	remirar	VSI4
remiraseis	remirar	VSI5
remirasen	remirar	VSI6
remirad	remirar	VMP
remiradme	remirar	VMSE
remiradle	remirar	VMSE
remiradnos	remirar	VMPE
remiraos	remirar	VMPE
remiradles	remirar	VMPE
remiradlo	remirar	VMMSE
remiradla	remirar	VMFSE
remiradlos	remirar	VMMPE
remiradlas	remirar	VMFPE
remirádmelo	remirar	VMMSE
remirádselo	remirar	VMMSE
remirádnoslo	remirar	VMMSE
remiráoslo	remirar	VMMSE
remirádmelos	remirar	VMMPE
remirádselos	remirar	VMMPE
remirádnoslos	remirar	VMMPE
remiráoslos	remirar	VMMPE
remirádmela	remirar	VMFSE
remirádsela	remirar	VMFSE
remirádnosla	remirar	VMFSE
remiráosla	remirar	VMFSE
remirádmelas	remirar	VMFPE
remirádselas	remirar	VMFPE
remirádnoslas	remirar	VMFPE
remiráoslas	remirar	VMFPE
remirado	remirar	VPM
remirados	remirar	VPMP
remirada	remirar	VPF
remiradas	remirar	VPFP
remirando	remirar	VG
remirándome	remirar	VGSE
remirándote	remirar	VGSE
remirándole	remirar	VGSE
remirándonos	remirar	VGPE
remirándoos	remirar	VGPE
remirándolo	remirar	VGMSE
remirándola	remirar	VGFSE
remirándolos	remirar	VGMPE
remirándolas	remirar	VGFPE
remirándomelo	remirar	VGMSE
remirándotelo	remirar	VGMSE
remirándoselo	remirar	VGMSE
remirándonoslo	remirar	VGMSE
remirándooslo	remirar	VGMSE
remirándomelos	remirar	VGMPE
remirándotelos	remirar	VGMPE
remirándoselos	remirar	VGMPE
remirándonoslos	remirar	VGMPE
remirándooslos	remirar	VGMPE
remirándomela	remirar	VGFSE
remirándotela	remirar	VGFSE
remirándosela	remirar	VGFSE
remirándonosla	remirar	VGFSE
remirándoosla	remirar	VGFSE
remirándomelas	remirar	VGFPE
remirándotelas	remirar	VGFPE
remirándoselas	remirar	VGFPE
remirándonoslas	remirar	VGFPE
remirándooslas	remirar	VGFPE
remodelar	remodelar	O
remodelo	remodelar	VIP1
remodelas	remodelar	VIP2
remodela	remodelar	VIP3
remodelamos	remodelar	VIP4
remodeláis	remodelar	VIP5
remodelan	remodelar	VIP6
remodelaba	remodelar	VII1
remodelabas	remodelar	VII2
remodelábamos	remodelar	VII4
remodelabais	remodelar	VII5
remodelaban	remodelar	VII6
remodelaré	remodelar	VIF1
remodelarás	remodelar	VIF2
remodelará	remodelar	VIF3
remodelaremos	remodelar	VIF4
remodelaréis	remodelar	VIF5
remodelarán	remodelar	VIF6
remodelaría	remodelar	VIC1
remodelarías	remodelar	VIC2
remodelaría	remodelar	VIC3
remodelaríamos	remodelar	VIC4
remodelaríais	remodelar	VIC5
remodelarían	remodelar	VIC6
remodelé	remodelar	VIX1
remodelaste	remodelar	VIX2
remodeló	remodelar	VIX3
remodelasteis	remodelar	VIX5
remodelaron	remodelar	VIX6
remodele	remodelar	VSP1
remodeles	remodelar	VSP2
remodelemos	remodelar	VSP4
remodeléis	remodelar	VSP5
remodelen	remodelar	VSP6
remodelara	remodelar	VSX1
remodelaras	remodelar	VSX2
remodeláramos	remodelar	VSX4
remodelarais	remodelar	VSX5
remodelaran	remodelar	VSX6
remodelare	remodelar	VSF1
remodelares	remodelar	VSF2
remodeláremos	remodelar	VSF4
remodelareis	remodelar	VSF5
remodelaren	remodelar	VSF6
remodelase	remodelar	VSI1
remodelases	remodelar	VSI2
remodelásemos	remodelar	VSI4
remodelaseis	remodelar	VSI5
remodelasen	remodelar	VSI6
remodelad	remodelar	VMP
remodeladme	remodelar	VMSE
remodeladle	remodelar	VMSE
remodeladnos	remodelar	VMPE
remodelaos	remodelar	VMPE
remodeladles	remodelar	VMPE
remodeladlo	remodelar	VMMSE
remodeladla	remodelar	VMFSE
remodeladlos	remodelar	VMMPE
remodeladlas	remodelar	VMFPE
remodeládmelo	remodelar	VMMSE
remodeládselo	remodelar	VMMSE
remodeládnoslo	remodelar	VMMSE
remodeláoslo	remodelar	VMMSE
remodeládmelos	remodelar	VMMPE
remodeládselos	remodelar	VMMPE
remodeládnoslos	remodelar	VMMPE
remodeláoslos	remodelar	VMMPE
remodeládmela	remodelar	VMFSE
remodeládsela	remodelar	VMFSE
remodeládnosla	remodelar	VMFSE
remodeláosla	remodelar	VMFSE
remodeládmelas	remodelar	VMFPE
remodeládselas	remodelar	VMFPE
remodeládnoslas	remodelar	VMFPE
remodeláoslas	remodelar	VMFPE
remodelado	remodelar	VPM
remodelados	remodelar	VPMP
remodelada	remodelar	VPF
remodeladas	remodelar	VPFP
remodelando	remodelar	VG
remodelándome	remodelar	VGSE
remodelándote	remodelar	VGSE
remodelándole	remodelar	VGSE
remodelándonos	remodelar	VGPE
remodelándoos	remodelar	VGPE
remodelándolo	remodelar	VGMSE
remodelándola	remodelar	VGFSE
remodelándolos	remodelar	VGMPE
remodelándolas	remodelar	VGFPE
remodelándomelo	remodelar	VGMSE
remodelándotelo	remodelar	VGMSE
remodelándoselo	remodelar	VGMSE
remodelándonoslo	remodelar	VGMSE
remodelándooslo	remodelar	VGMSE
remodelándomelos	remodelar	VGMPE
remodelándotelos	remodelar	VGMPE
remodelándoselos	remodelar	VGMPE
remodelándonoslos	remodelar	VGMPE
remodelándooslos	remodelar	VGMPE
remodelándomela	remodelar	VGFSE
remodelándotela	remodelar	VGFSE
remodelándosela	remodelar	VGFSE
remodelándonosla	remodelar	VGFSE
remodelándoosla	remodelar	VGFSE
remodelándomelas	remodelar	VGFPE
remodelándotelas	remodelar	VGFPE
remodelándoselas	remodelar	VGFPE
remodelándonoslas	remodelar	VGFPE
remodelándooslas	remodelar	VGFPE
remojar	remojar	O
remojo	remojar	VIP1
remojas	remojar	VIP2
remoja	remojar	VIP3
remojamos	remojar	VIP4
remojáis	remojar	VIP5
remojan	remojar	VIP6
remojaba	remojar	VII1
remojabas	remojar	VII2
remojábamos	remojar	VII4
remojabais	remojar	VII5
remojaban	remojar	VII6
remojaré	remojar	VIF1
remojarás	remojar	VIF2
remojará	remojar	VIF3
remojaremos	remojar	VIF4
remojaréis	remojar	VIF5
remojarán	remojar	VIF6
remojaría	remojar	VIC1
remojarías	remojar	VIC2
remojaría	remojar	VIC3
remojaríamos	remojar	VIC4
remojaríais	remojar	VIC5
remojarían	remojar	VIC6
remojé	remojar	VIX1
remojaste	remojar	VIX2
remojó	remojar	VIX3
remojasteis	remojar	VIX5
remojaron	remojar	VIX6
remoje	remojar	VSP1
remojes	remojar	VSP2
remojemos	remojar	VSP4
remojéis	remojar	VSP5
remojen	remojar	VSP6
remojara	remojar	VSX1
remojaras	remojar	VSX2
remojáramos	remojar	VSX4
remojarais	remojar	VSX5
remojaran	remojar	VSX6
remojare	remojar	VSF1
remojares	remojar	VSF2
remojáremos	remojar	VSF4
remojareis	remojar	VSF5
remojaren	remojar	VSF6
remojase	remojar	VSI1
remojases	remojar	VSI2
remojásemos	remojar	VSI4
remojaseis	remojar	VSI5
remojasen	remojar	VSI6
remojad	remojar	VMP
remojadme	remojar	VMSE
remojadle	remojar	VMSE
remojadnos	remojar	VMPE
remojaos	remojar	VMPE
remojadles	remojar	VMPE
remojadlo	remojar	VMMSE
remojadla	remojar	VMFSE
remojadlos	remojar	VMMPE
remojadlas	remojar	VMFPE
remojádmelo	remojar	VMMSE
remojádselo	remojar	VMMSE
remojádnoslo	remojar	VMMSE
remojáoslo	remojar	VMMSE
remojádmelos	remojar	VMMPE
remojádselos	remojar	VMMPE
remojádnoslos	remojar	VMMPE
remojáoslos	remojar	VMMPE
remojádmela	remojar	VMFSE
remojádsela	remojar	VMFSE
remojádnosla	remojar	VMFSE
remojáosla	remojar	VMFSE
remojádmelas	remojar	VMFPE
remojádselas	remojar	VMFPE
remojádnoslas	remojar	VMFPE
remojáoslas	remojar	VMFPE
remojado	remojar	VPM
remojados	remojar	VPMP
remojada	remojar	VPF
remojadas	remojar	VPFP
remojando	remojar	VG
remojándome	remojar	VGSE
remojándote	remojar	VGSE
remojándole	remojar	VGSE
remojándonos	remojar	VGPE
remojándoos	remojar	VGPE
remojándolo	remojar	VGMSE
remojándola	remojar	VGFSE
remojándolos	remojar	VGMPE
remojándolas	remojar	VGFPE
remojándomelo	remojar	VGMSE
remojándotelo	remojar	VGMSE
remojándoselo	remojar	VGMSE
remojándonoslo	remojar	VGMSE
remojándooslo	remojar	VGMSE
remojándomelos	remojar	VGMPE
remojándotelos	remojar	VGMPE
remojándoselos	remojar	VGMPE
remojándonoslos	remojar	VGMPE
remojándooslos	remojar	VGMPE
remojándomela	remojar	VGFSE
remojándotela	remojar	VGFSE
remojándosela	remojar	VGFSE
remojándonosla	remojar	VGFSE
remojándoosla	remojar	VGFSE
remojándomelas	remojar	VGFPE
remojándotelas	remojar	VGFPE
remojándoselas	remojar	VGFPE
remojándonoslas	remojar	VGFPE
remojándooslas	remojar	VGFPE
remolcar	remolcar	O
remolco	remolcar	VIP1
remolcas	remolcar	VIP2
remolca	remolcar	VIP3
remolcamos	remolcar	VIP4
remolcáis	remolcar	VIP5
remolcan	remolcar	VIP6
remolcaba	remolcar	VII1
remolcabas	remolcar	VII2
remolcábamos	remolcar	VII4
remolcabais	remolcar	VII5
remolcaban	remolcar	VII6
remolcaré	remolcar	VIF1
remolcarás	remolcar	VIF2
remolcará	remolcar	VIF3
remolcaremos	remolcar	VIF4
remolcaréis	remolcar	VIF5
remolcarán	remolcar	VIF6
remolcaría	remolcar	VIC1
remolcarías	remolcar	VIC2
remolcaría	remolcar	VIC3
remolcaríamos	remolcar	VIC4
remolcaríais	remolcar	VIC5
remolcarían	remolcar	VIC6
remolqué	remolcar	VIX1
remolcaste	remolcar	VIX2
remolcó	remolcar	VIX3
remolcasteis	remolcar	VIX5
remolcaron	remolcar	VIX6
remolque	remolcar	VSP1
remolques	remolcar	VSP2
remolquemos	remolcar	VSP4
remolquéis	remolcar	VSP5
remolquen	remolcar	VSP6
remolcara	remolcar	VSX1
remolcaras	remolcar	VSX2
remolcáramos	remolcar	VSX4
remolcarais	remolcar	VSX5
remolcaran	remolcar	VSX6
remolcare	remolcar	VSF1
remolcares	remolcar	VSF2
remolcáremos	remolcar	VSF4
remolcareis	remolcar	VSF5
remolcaren	remolcar	VSF6
remolcase	remolcar	VSI1
remolcases	remolcar	VSI2
remolcásemos	remolcar	VSI4
remolcaseis	remolcar	VSI5
remolcasen	remolcar	VSI6
remolcad	remolcar	VMP
remolcadme	remolcar	VMSE
remolcadle	remolcar	VMSE
remolcadnos	remolcar	VMPE
remolcaos	remolcar	VMPE
remolcadles	remolcar	VMPE
remolcadlo	remolcar	VMMSE
remolcadla	remolcar	VMFSE
remolcadlos	remolcar	VMMPE
remolcadlas	remolcar	VMFPE
remolcádmelo	remolcar	VMMSE
remolcádselo	remolcar	VMMSE
remolcádnoslo	remolcar	VMMSE
remolcáoslo	remolcar	VMMSE
remolcádmelos	remolcar	VMMPE
remolcádselos	remolcar	VMMPE
remolcádnoslos	remolcar	VMMPE
remolcáoslos	remolcar	VMMPE
remolcádmela	remolcar	VMFSE
remolcádsela	remolcar	VMFSE
remolcádnosla	remolcar	VMFSE
remolcáosla	remolcar	VMFSE
remolcádmelas	remolcar	VMFPE
remolcádselas	remolcar	VMFPE
remolcádnoslas	remolcar	VMFPE
remolcáoslas	remolcar	VMFPE
remolcado	remolcar	VPM
remolcados	remolcar	VPMP
remolcada	remolcar	VPF
remolcadas	remolcar	VPFP
remolcando	remolcar	VG
remolcándome	remolcar	VGSE
remolcándote	remolcar	VGSE
remolcándole	remolcar	VGSE
remolcándonos	remolcar	VGPE
remolcándoos	remolcar	VGPE
remolcándolo	remolcar	VGMSE
remolcándola	remolcar	VGFSE
remolcándolos	remolcar	VGMPE
remolcándolas	remolcar	VGFPE
remolcándomelo	remolcar	VGMSE
remolcándotelo	remolcar	VGMSE
remolcándoselo	remolcar	VGMSE
remolcándonoslo	remolcar	VGMSE
remolcándooslo	remolcar	VGMSE
remolcándomelos	remolcar	VGMPE
remolcándotelos	remolcar	VGMPE
remolcándoselos	remolcar	VGMPE
remolcándonoslos	remolcar	VGMPE
remolcándooslos	remolcar	VGMPE
remolcándomela	remolcar	VGFSE
remolcándotela	remolcar	VGFSE
remolcándosela	remolcar	VGFSE
remolcándonosla	remolcar	VGFSE
remolcándoosla	remolcar	VGFSE
remolcándomelas	remolcar	VGFPE
remolcándotelas	remolcar	VGFPE
remolcándoselas	remolcar	VGFPE
remolcándonoslas	remolcar	VGFPE
remolcándooslas	remolcar	VGFPE
remoldar	remoldar	O
remoldo	remoldar	VIP1
remoldas	remoldar	VIP2
remolda	remoldar	VIP3
remoldamos	remoldar	VIP4
remoldáis	remoldar	VIP5
remoldan	remoldar	VIP6
remoldaba	remoldar	VII1
remoldabas	remoldar	VII2
remoldábamos	remoldar	VII4
remoldabais	remoldar	VII5
remoldaban	remoldar	VII6
remoldaré	remoldar	VIF1
remoldarás	remoldar	VIF2
remoldará	remoldar	VIF3
remoldaremos	remoldar	VIF4
remoldaréis	remoldar	VIF5
remoldarán	remoldar	VIF6
remoldaría	remoldar	VIC1
remoldarías	remoldar	VIC2
remoldaría	remoldar	VIC3
remoldaríamos	remoldar	VIC4
remoldaríais	remoldar	VIC5
remoldarían	remoldar	VIC6
remoldé	remoldar	VIX1
remoldaste	remoldar	VIX2
remoldó	remoldar	VIX3
remoldasteis	remoldar	VIX5
remoldaron	remoldar	VIX6
remolde	remoldar	VSP1
remoldes	remoldar	VSP2
remoldemos	remoldar	VSP4
remoldéis	remoldar	VSP5
remolden	remoldar	VSP6
remoldara	remoldar	VSX1
remoldaras	remoldar	VSX2
remoldáramos	remoldar	VSX4
remoldarais	remoldar	VSX5
remoldaran	remoldar	VSX6
remoldare	remoldar	VSF1
remoldares	remoldar	VSF2
remoldáremos	remoldar	VSF4
remoldareis	remoldar	VSF5
remoldaren	remoldar	VSF6
remoldase	remoldar	VSI1
remoldases	remoldar	VSI2
remoldásemos	remoldar	VSI4
remoldaseis	remoldar	VSI5
remoldasen	remoldar	VSI6
remoldad	remoldar	VMP
remoldadme	remoldar	VMSE
remoldadle	remoldar	VMSE
remoldadnos	remoldar	VMPE
remoldaos	remoldar	VMPE
remoldadles	remoldar	VMPE
remoldadlo	remoldar	VMMSE
remoldadla	remoldar	VMFSE
remoldadlos	remoldar	VMMPE
remoldadlas	remoldar	VMFPE
remoldádmelo	remoldar	VMMSE
remoldádselo	remoldar	VMMSE
remoldádnoslo	remoldar	VMMSE
remoldáoslo	remoldar	VMMSE
remoldádmelos	remoldar	VMMPE
remoldádselos	remoldar	VMMPE
remoldádnoslos	remoldar	VMMPE
remoldáoslos	remoldar	VMMPE
remoldádmela	remoldar	VMFSE
remoldádsela	remoldar	VMFSE
remoldádnosla	remoldar	VMFSE
remoldáosla	remoldar	VMFSE
remoldádmelas	remoldar	VMFPE
remoldádselas	remoldar	VMFPE
remoldádnoslas	remoldar	VMFPE
remoldáoslas	remoldar	VMFPE
remoldado	remoldar	VPM
remoldados	remoldar	VPMP
remoldada	remoldar	VPF
remoldadas	remoldar	VPFP
remoldando	remoldar	VG
remoldándome	remoldar	VGSE
remoldándote	remoldar	VGSE
remoldándole	remoldar	VGSE
remoldándonos	remoldar	VGPE
remoldándoos	remoldar	VGPE
remoldándolo	remoldar	VGMSE
remoldándola	remoldar	VGFSE
remoldándolos	remoldar	VGMPE
remoldándolas	remoldar	VGFPE
remoldándomelo	remoldar	VGMSE
remoldándotelo	remoldar	VGMSE
remoldándoselo	remoldar	VGMSE
remoldándonoslo	remoldar	VGMSE
remoldándooslo	remoldar	VGMSE
remoldándomelos	remoldar	VGMPE
remoldándotelos	remoldar	VGMPE
remoldándoselos	remoldar	VGMPE
remoldándonoslos	remoldar	VGMPE
remoldándooslos	remoldar	VGMPE
remoldándomela	remoldar	VGFSE
remoldándotela	remoldar	VGFSE
remoldándosela	remoldar	VGFSE
remoldándonosla	remoldar	VGFSE
remoldándoosla	remoldar	VGFSE
remoldándomelas	remoldar	VGFPE
remoldándotelas	remoldar	VGFPE
remoldándoselas	remoldar	VGFPE
remoldándonoslas	remoldar	VGFPE
remoldándooslas	remoldar	VGFPE
remolinar	remolinar	O
remolino	remolinar	VIP1
remolinas	remolinar	VIP2
remolina	remolinar	VIP3
remolinamos	remolinar	VIP4
remolináis	remolinar	VIP5
remolinan	remolinar	VIP6
remolinaba	remolinar	VII1
remolinabas	remolinar	VII2
remolinábamos	remolinar	VII4
remolinabais	remolinar	VII5
remolinaban	remolinar	VII6
remolinaré	remolinar	VIF1
remolinarás	remolinar	VIF2
remolinará	remolinar	VIF3
remolinaremos	remolinar	VIF4
remolinaréis	remolinar	VIF5
remolinarán	remolinar	VIF6
remolinaría	remolinar	VIC1
remolinarías	remolinar	VIC2
remolinaría	remolinar	VIC3
remolinaríamos	remolinar	VIC4
remolinaríais	remolinar	VIC5
remolinarían	remolinar	VIC6
remoliné	remolinar	VIX1
remolinaste	remolinar	VIX2
remolinó	remolinar	VIX3
remolinasteis	remolinar	VIX5
remolinaron	remolinar	VIX6
remoline	remolinar	VSP1
remolines	remolinar	VSP2
remolinemos	remolinar	VSP4
remolinéis	remolinar	VSP5
remolinen	remolinar	VSP6
remolinara	remolinar	VSX1
remolinaras	remolinar	VSX2
remolináramos	remolinar	VSX4
remolinarais	remolinar	VSX5
remolinaran	remolinar	VSX6
remolinare	remolinar	VSF1
remolinares	remolinar	VSF2
remolináremos	remolinar	VSF4
remolinareis	remolinar	VSF5
remolinaren	remolinar	VSF6
remolinase	remolinar	VSI1
remolinases	remolinar	VSI2
remolinásemos	remolinar	VSI4
remolinaseis	remolinar	VSI5
remolinasen	remolinar	VSI6
remolinad	remolinar	VMP
remolinadme	remolinar	VMSE
remolinadle	remolinar	VMSE
remolinadnos	remolinar	VMPE
remolinaos	remolinar	VMPE
remolinadles	remolinar	VMPE
remolinado	remolinar	VPM
remolinados	remolinar	VPMP
remolinada	remolinar	VPF
remolinadas	remolinar	VPFP
remolinando	remolinar	VG
remolinándome	remolinar	VGSE
remolinándote	remolinar	VGSE
remolinándole	remolinar	VGSE
remolinándonos	remolinar	VGPE
remolinándoos	remolinar	VGPE
remolinear	remolinear	O
remolineo	remolinear	VIP1
remolineas	remolinear	VIP2
remolinea	remolinear	VIP3
remolineamos	remolinear	VIP4
remolineáis	remolinear	VIP5
remolinean	remolinear	VIP6
remolineaba	remolinear	VII1
remolineabas	remolinear	VII2
remolineábamos	remolinear	VII4
remolineabais	remolinear	VII5
remolineaban	remolinear	VII6
remolinearé	remolinear	VIF1
remolinearás	remolinear	VIF2
remolineará	remolinear	VIF3
remolinearemos	remolinear	VIF4
remolinearéis	remolinear	VIF5
remolinearán	remolinear	VIF6
remolinearía	remolinear	VIC1
remolinearías	remolinear	VIC2
remolinearía	remolinear	VIC3
remolinearíamos	remolinear	VIC4
remolinearíais	remolinear	VIC5
remolinearían	remolinear	VIC6
remolineé	remolinear	VIX1
remolineaste	remolinear	VIX2
remolineó	remolinear	VIX3
remolineasteis	remolinear	VIX5
remolinearon	remolinear	VIX6
remolinee	remolinear	VSP1
remolinees	remolinear	VSP2
remolineemos	remolinear	VSP4
remolineéis	remolinear	VSP5
remolineen	remolinear	VSP6
remolineara	remolinear	VSX1
remolinearas	remolinear	VSX2
remolineáramos	remolinear	VSX4
remolinearais	remolinear	VSX5
remolinearan	remolinear	VSX6
remolineare	remolinear	VSF1
remolineares	remolinear	VSF2
remolineáremos	remolinear	VSF4
remolineareis	remolinear	VSF5
remolinearen	remolinear	VSF6
remolinease	remolinear	VSI1
remolineases	remolinear	VSI2
remolineásemos	remolinear	VSI4
remolineaseis	remolinear	VSI5
remolineasen	remolinear	VSI6
remolinead	remolinear	VMP
remolineadme	remolinear	VMSE
remolineadle	remolinear	VMSE
remolineadnos	remolinear	VMPE
remolineaos	remolinear	VMPE
remolineadles	remolinear	VMPE
remolineadlo	remolinear	VMMSE
remolineadla	remolinear	VMFSE
remolineadlos	remolinear	VMMPE
remolineadlas	remolinear	VMFPE
remolineádmelo	remolinear	VMMSE
remolineádselo	remolinear	VMMSE
remolineádnoslo	remolinear	VMMSE
remolineáoslo	remolinear	VMMSE
remolineádmelos	remolinear	VMMPE
remolineádselos	remolinear	VMMPE
remolineádnoslos	remolinear	VMMPE
remolineáoslos	remolinear	VMMPE
remolineádmela	remolinear	VMFSE
remolineádsela	remolinear	VMFSE
remolineádnosla	remolinear	VMFSE
remolineáosla	remolinear	VMFSE
remolineádmelas	remolinear	VMFPE
remolineádselas	remolinear	VMFPE
remolineádnoslas	remolinear	VMFPE
remolineáoslas	remolinear	VMFPE
remolineado	remolinear	VPM
remolineados	remolinear	VPMP
remolineada	remolinear	VPF
remolineadas	remolinear	VPFP
remolineando	remolinear	VG
remolineándome	remolinear	VGSE
remolineándote	remolinear	VGSE
remolineándole	remolinear	VGSE
remolineándonos	remolinear	VGPE
remolineándoos	remolinear	VGPE
remolineándolo	remolinear	VGMSE
remolineándola	remolinear	VGFSE
remolineándolos	remolinear	VGMPE
remolineándolas	remolinear	VGFPE
remolineándomelo	remolinear	VGMSE
remolineándotelo	remolinear	VGMSE
remolineándoselo	remolinear	VGMSE
remolineándonoslo	remolinear	VGMSE
remolineándooslo	remolinear	VGMSE
remolineándomelos	remolinear	VGMPE
remolineándotelos	remolinear	VGMPE
remolineándoselos	remolinear	VGMPE
remolineándonoslos	remolinear	VGMPE
remolineándooslos	remolinear	VGMPE
remolineándomela	remolinear	VGFSE
remolineándotela	remolinear	VGFSE
remolineándosela	remolinear	VGFSE
remolineándonosla	remolinear	VGFSE
remolineándoosla	remolinear	VGFSE
remolineándomelas	remolinear	VGFPE
remolineándotelas	remolinear	VGFPE
remolineándoselas	remolinear	VGFPE
remolineándonoslas	remolinear	VGFPE
remolineándooslas	remolinear	VGFPE
remolonear	remolonear	O
remoloneo	remolonear	VIP1
remoloneas	remolonear	VIP2
remolonea	remolonear	VIP3
remoloneamos	remolonear	VIP4
remoloneáis	remolonear	VIP5
remolonean	remolonear	VIP6
remoloneaba	remolonear	VII1
remoloneabas	remolonear	VII2
remoloneábamos	remolonear	VII4
remoloneabais	remolonear	VII5
remoloneaban	remolonear	VII6
remolonearé	remolonear	VIF1
remolonearás	remolonear	VIF2
remoloneará	remolonear	VIF3
remolonearemos	remolonear	VIF4
remolonearéis	remolonear	VIF5
remolonearán	remolonear	VIF6
remolonearía	remolonear	VIC1
remolonearías	remolonear	VIC2
remolonearía	remolonear	VIC3
remolonearíamos	remolonear	VIC4
remolonearíais	remolonear	VIC5
remolonearían	remolonear	VIC6
remoloneé	remolonear	VIX1
remoloneaste	remolonear	VIX2
remoloneó	remolonear	VIX3
remoloneasteis	remolonear	VIX5
remolonearon	remolonear	VIX6
remolonee	remolonear	VSP1
remolonees	remolonear	VSP2
remoloneemos	remolonear	VSP4
remoloneéis	remolonear	VSP5
remoloneen	remolonear	VSP6
remoloneara	remolonear	VSX1
remolonearas	remolonear	VSX2
remoloneáramos	remolonear	VSX4
remolonearais	remolonear	VSX5
remolonearan	remolonear	VSX6
remoloneare	remolonear	VSF1
remoloneares	remolonear	VSF2
remoloneáremos	remolonear	VSF4
remoloneareis	remolonear	VSF5
remolonearen	remolonear	VSF6
remolonease	remolonear	VSI1
remoloneases	remolonear	VSI2
remoloneásemos	remolonear	VSI4
remoloneaseis	remolonear	VSI5
remoloneasen	remolonear	VSI6
remolonead	remolonear	VMP
remoloneadme	remolonear	VMSE
remoloneadle	remolonear	VMSE
remoloneadnos	remolonear	VMPE
remoloneaos	remolonear	VMPE
remoloneadles	remolonear	VMPE
remoloneado	remolonear	VPM
remoloneados	remolonear	VPMP
remoloneada	remolonear	VPF
remoloneadas	remolonear	VPFP
remoloneando	remolonear	VG
remoloneándome	remolonear	VGSE
remoloneándote	remolonear	VGSE
remoloneándole	remolonear	VGSE
remoloneándonos	remolonear	VGPE
remoloneándoos	remolonear	VGPE
remondar	remondar	O
remondo	remondar	VIP1
remondas	remondar	VIP2
remonda	remondar	VIP3
remondamos	remondar	VIP4
remondáis	remondar	VIP5
remondan	remondar	VIP6
remondaba	remondar	VII1
remondabas	remondar	VII2
remondábamos	remondar	VII4
remondabais	remondar	VII5
remondaban	remondar	VII6
remondaré	remondar	VIF1
remondarás	remondar	VIF2
remondará	remondar	VIF3
remondaremos	remondar	VIF4
remondaréis	remondar	VIF5
remondarán	remondar	VIF6
remondaría	remondar	VIC1
remondarías	remondar	VIC2
remondaría	remondar	VIC3
remondaríamos	remondar	VIC4
remondaríais	remondar	VIC5
remondarían	remondar	VIC6
remondé	remondar	VIX1
remondaste	remondar	VIX2
remondó	remondar	VIX3
remondasteis	remondar	VIX5
remondaron	remondar	VIX6
remonde	remondar	VSP1
remondes	remondar	VSP2
remondemos	remondar	VSP4
remondéis	remondar	VSP5
remonden	remondar	VSP6
remondara	remondar	VSX1
remondaras	remondar	VSX2
remondáramos	remondar	VSX4
remondarais	remondar	VSX5
remondaran	remondar	VSX6
remondare	remondar	VSF1
remondares	remondar	VSF2
remondáremos	remondar	VSF4
remondareis	remondar	VSF5
remondaren	remondar	VSF6
remondase	remondar	VSI1
remondases	remondar	VSI2
remondásemos	remondar	VSI4
remondaseis	remondar	VSI5
remondasen	remondar	VSI6
remondad	remondar	VMP
remondadme	remondar	VMSE
remondadle	remondar	VMSE
remondadnos	remondar	VMPE
remondaos	remondar	VMPE
remondadles	remondar	VMPE
remondadlo	remondar	VMMSE
remondadla	remondar	VMFSE
remondadlos	remondar	VMMPE
remondadlas	remondar	VMFPE
remondádmelo	remondar	VMMSE
remondádselo	remondar	VMMSE
remondádnoslo	remondar	VMMSE
remondáoslo	remondar	VMMSE
remondádmelos	remondar	VMMPE
remondádselos	remondar	VMMPE
remondádnoslos	remondar	VMMPE
remondáoslos	remondar	VMMPE
remondádmela	remondar	VMFSE
remondádsela	remondar	VMFSE
remondádnosla	remondar	VMFSE
remondáosla	remondar	VMFSE
remondádmelas	remondar	VMFPE
remondádselas	remondar	VMFPE
remondádnoslas	remondar	VMFPE
remondáoslas	remondar	VMFPE
remondado	remondar	VPM
remondados	remondar	VPMP
remondada	remondar	VPF
remondadas	remondar	VPFP
remondando	remondar	VG
remondándome	remondar	VGSE
remondándote	remondar	VGSE
remondándole	remondar	VGSE
remondándonos	remondar	VGPE
remondándoos	remondar	VGPE
remondándolo	remondar	VGMSE
remondándola	remondar	VGFSE
remondándolos	remondar	VGMPE
remondándolas	remondar	VGFPE
remondándomelo	remondar	VGMSE
remondándotelo	remondar	VGMSE
remondándoselo	remondar	VGMSE
remondándonoslo	remondar	VGMSE
remondándooslo	remondar	VGMSE
remondándomelos	remondar	VGMPE
remondándotelos	remondar	VGMPE
remondándoselos	remondar	VGMPE
remondándonoslos	remondar	VGMPE
remondándooslos	remondar	VGMPE
remondándomela	remondar	VGFSE
remondándotela	remondar	VGFSE
remondándosela	remondar	VGFSE
remondándonosla	remondar	VGFSE
remondándoosla	remondar	VGFSE
remondándomelas	remondar	VGFPE
remondándotelas	remondar	VGFPE
remondándoselas	remondar	VGFPE
remondándonoslas	remondar	VGFPE
remondándooslas	remondar	VGFPE
remontar	remontar	O
remonto	remontar	VIP1
remontas	remontar	VIP2
remonta	remontar	VIP3
remontamos	remontar	VIP4
remontáis	remontar	VIP5
remontan	remontar	VIP6
remontaba	remontar	VII1
remontabas	remontar	VII2
remontábamos	remontar	VII4
remontabais	remontar	VII5
remontaban	remontar	VII6
remontaré	remontar	VIF1
remontarás	remontar	VIF2
remontará	remontar	VIF3
remontaremos	remontar	VIF4
remontaréis	remontar	VIF5
remontarán	remontar	VIF6
remontaría	remontar	VIC1
remontarías	remontar	VIC2
remontaría	remontar	VIC3
remontaríamos	remontar	VIC4
remontaríais	remontar	VIC5
remontarían	remontar	VIC6
remonté	remontar	VIX1
remontaste	remontar	VIX2
remontó	remontar	VIX3
remontasteis	remontar	VIX5
remontaron	remontar	VIX6
remonte	remontar	VSP1
remontes	remontar	VSP2
remontemos	remontar	VSP4
remontéis	remontar	VSP5
remonten	remontar	VSP6
remontara	remontar	VSX1
remontaras	remontar	VSX2
remontáramos	remontar	VSX4
remontarais	remontar	VSX5
remontaran	remontar	VSX6
remontare	remontar	VSF1
remontares	remontar	VSF2
remontáremos	remontar	VSF4
remontareis	remontar	VSF5
remontaren	remontar	VSF6
remontase	remontar	VSI1
remontases	remontar	VSI2
remontásemos	remontar	VSI4
remontaseis	remontar	VSI5
remontasen	remontar	VSI6
remontad	remontar	VMP
remontadme	remontar	VMSE
remontadle	remontar	VMSE
remontadnos	remontar	VMPE
remontaos	remontar	VMPE
remontadles	remontar	VMPE
remontadlo	remontar	VMMSE
remontadla	remontar	VMFSE
remontadlos	remontar	VMMPE
remontadlas	remontar	VMFPE
remontádmelo	remontar	VMMSE
remontádselo	remontar	VMMSE
remontádnoslo	remontar	VMMSE
remontáoslo	remontar	VMMSE
remontádmelos	remontar	VMMPE
remontádselos	remontar	VMMPE
remontádnoslos	remontar	VMMPE
remontáoslos	remontar	VMMPE
remontádmela	remontar	VMFSE
remontádsela	remontar	VMFSE
remontádnosla	remontar	VMFSE
remontáosla	remontar	VMFSE
remontádmelas	remontar	VMFPE
remontádselas	remontar	VMFPE
remontádnoslas	remontar	VMFPE
remontáoslas	remontar	VMFPE
remontado	remontar	VPM
remontados	remontar	VPMP
remontada	remontar	VPF
remontadas	remontar	VPFP
remontando	remontar	VG
remontándome	remontar	VGSE
remontándote	remontar	VGSE
remontándole	remontar	VGSE
remontándonos	remontar	VGPE
remontándoos	remontar	VGPE
remontándolo	remontar	VGMSE
remontándola	remontar	VGFSE
remontándolos	remontar	VGMPE
remontándolas	remontar	VGFPE
remontándomelo	remontar	VGMSE
remontándotelo	remontar	VGMSE
remontándoselo	remontar	VGMSE
remontándonoslo	remontar	VGMSE
remontándooslo	remontar	VGMSE
remontándomelos	remontar	VGMPE
remontándotelos	remontar	VGMPE
remontándoselos	remontar	VGMPE
remontándonoslos	remontar	VGMPE
remontándooslos	remontar	VGMPE
remontándomela	remontar	VGFSE
remontándotela	remontar	VGFSE
remontándosela	remontar	VGFSE
remontándonosla	remontar	VGFSE
remontándoosla	remontar	VGFSE
remontándomelas	remontar	VGFPE
remontándotelas	remontar	VGFPE
remontándoselas	remontar	VGFPE
remontándonoslas	remontar	VGFPE
remontándooslas	remontar	VGFPE
remorar	remorar	O
remoro	remorar	VIP1
remoras	remorar	VIP2
remora	remorar	VIP3
remoramos	remorar	VIP4
remoráis	remorar	VIP5
remoran	remorar	VIP6
remoraba	remorar	VII1
remorabas	remorar	VII2
remorábamos	remorar	VII4
remorabais	remorar	VII5
remoraban	remorar	VII6
remoraré	remorar	VIF1
remorarás	remorar	VIF2
remorará	remorar	VIF3
remoraremos	remorar	VIF4
remoraréis	remorar	VIF5
remorarán	remorar	VIF6
remoraría	remorar	VIC1
remorarías	remorar	VIC2
remoraría	remorar	VIC3
remoraríamos	remorar	VIC4
remoraríais	remorar	VIC5
remorarían	remorar	VIC6
remoré	remorar	VIX1
remoraste	remorar	VIX2
remoró	remorar	VIX3
remorasteis	remorar	VIX5
remoraron	remorar	VIX6
remore	remorar	VSP1
remores	remorar	VSP2
remoremos	remorar	VSP4
remoréis	remorar	VSP5
remoren	remorar	VSP6
remorara	remorar	VSX1
remoraras	remorar	VSX2
remoráramos	remorar	VSX4
remorarais	remorar	VSX5
remoraran	remorar	VSX6
remorare	remorar	VSF1
remorares	remorar	VSF2
remoráremos	remorar	VSF4
remorareis	remorar	VSF5
remoraren	remorar	VSF6
remorase	remorar	VSI1
remorases	remorar	VSI2
remorásemos	remorar	VSI4
remoraseis	remorar	VSI5
remorasen	remorar	VSI6
remorad	remorar	VMP
remoradme	remorar	VMSE
remoradle	remorar	VMSE
remoradnos	remorar	VMPE
remoraos	remorar	VMPE
remoradles	remorar	VMPE
remoradlo	remorar	VMMSE
remoradla	remorar	VMFSE
remoradlos	remorar	VMMPE
remoradlas	remorar	VMFPE
remorádmelo	remorar	VMMSE
remorádselo	remorar	VMMSE
remorádnoslo	remorar	VMMSE
remoráoslo	remorar	VMMSE
remorádmelos	remorar	VMMPE
remorádselos	remorar	VMMPE
remorádnoslos	remorar	VMMPE
remoráoslos	remorar	VMMPE
remorádmela	remorar	VMFSE
remorádsela	remorar	VMFSE
remorádnosla	remorar	VMFSE
remoráosla	remorar	VMFSE
remorádmelas	remorar	VMFPE
remorádselas	remorar	VMFPE
remorádnoslas	remorar	VMFPE
remoráoslas	remorar	VMFPE
remorado	remorar	VPM
remorados	remorar	VPMP
remorada	remorar	VPF
remoradas	remorar	VPFP
remorando	remorar	VG
remorándome	remorar	VGSE
remorándote	remorar	VGSE
remorándole	remorar	VGSE
remorándonos	remorar	VGPE
remorándoos	remorar	VGPE
remorándolo	remorar	VGMSE
remorándola	remorar	VGFSE
remorándolos	remorar	VGMPE
remorándolas	remorar	VGFPE
remorándomelo	remorar	VGMSE
remorándotelo	remorar	VGMSE
remorándoselo	remorar	VGMSE
remorándonoslo	remorar	VGMSE
remorándooslo	remorar	VGMSE
remorándomelos	remorar	VGMPE
remorándotelos	remorar	VGMPE
remorándoselos	remorar	VGMPE
remorándonoslos	remorar	VGMPE
remorándooslos	remorar	VGMPE
remorándomela	remorar	VGFSE
remorándotela	remorar	VGFSE
remorándosela	remorar	VGFSE
remorándonosla	remorar	VGFSE
remorándoosla	remorar	VGFSE
remorándomelas	remorar	VGFPE
remorándotelas	remorar	VGFPE
remorándoselas	remorar	VGFPE
remorándonoslas	remorar	VGFPE
remorándooslas	remorar	VGFPE
remosquear	remosquear	O
remosqueo	remosquear	VIP1
remosqueas	remosquear	VIP2
remosquea	remosquear	VIP3
remosqueamos	remosquear	VIP4
remosqueáis	remosquear	VIP5
remosquean	remosquear	VIP6
remosqueaba	remosquear	VII1
remosqueabas	remosquear	VII2
remosqueábamos	remosquear	VII4
remosqueabais	remosquear	VII5
remosqueaban	remosquear	VII6
remosquearé	remosquear	VIF1
remosquearás	remosquear	VIF2
remosqueará	remosquear	VIF3
remosquearemos	remosquear	VIF4
remosquearéis	remosquear	VIF5
remosquearán	remosquear	VIF6
remosquearía	remosquear	VIC1
remosquearías	remosquear	VIC2
remosquearía	remosquear	VIC3
remosquearíamos	remosquear	VIC4
remosquearíais	remosquear	VIC5
remosquearían	remosquear	VIC6
remosqueé	remosquear	VIX1
remosqueaste	remosquear	VIX2
remosqueó	remosquear	VIX3
remosqueasteis	remosquear	VIX5
remosquearon	remosquear	VIX6
remosquee	remosquear	VSP1
remosquees	remosquear	VSP2
remosqueemos	remosquear	VSP4
remosqueéis	remosquear	VSP5
remosqueen	remosquear	VSP6
remosqueara	remosquear	VSX1
remosquearas	remosquear	VSX2
remosqueáramos	remosquear	VSX4
remosquearais	remosquear	VSX5
remosquearan	remosquear	VSX6
remosqueare	remosquear	VSF1
remosqueares	remosquear	VSF2
remosqueáremos	remosquear	VSF4
remosqueareis	remosquear	VSF5
remosquearen	remosquear	VSF6
remosquease	remosquear	VSI1
remosqueases	remosquear	VSI2
remosqueásemos	remosquear	VSI4
remosqueaseis	remosquear	VSI5
remosqueasen	remosquear	VSI6
remosquead	remosquear	VMP
remosqueadme	remosquear	VMSE
remosqueadle	remosquear	VMSE
remosqueadnos	remosquear	VMPE
remosqueaos	remosquear	VMPE
remosqueadles	remosquear	VMPE
remosqueado	remosquear	VPM
remosqueados	remosquear	VPMP
remosqueada	remosquear	VPF
remosqueadas	remosquear	VPFP
remosqueando	remosquear	VG
remosqueándome	remosquear	VGSE
remosqueándote	remosquear	VGSE
remosqueándole	remosquear	VGSE
remosqueándonos	remosquear	VGPE
remosqueándoos	remosquear	VGPE
remostar	remostar	O
remosto	remostar	VIP1
remostas	remostar	VIP2
remosta	remostar	VIP3
remostamos	remostar	VIP4
remostáis	remostar	VIP5
remostan	remostar	VIP6
remostaba	remostar	VII1
remostabas	remostar	VII2
remostábamos	remostar	VII4
remostabais	remostar	VII5
remostaban	remostar	VII6
remostaré	remostar	VIF1
remostarás	remostar	VIF2
remostará	remostar	VIF3
remostaremos	remostar	VIF4
remostaréis	remostar	VIF5
remostarán	remostar	VIF6
remostaría	remostar	VIC1
remostarías	remostar	VIC2
remostaría	remostar	VIC3
remostaríamos	remostar	VIC4
remostaríais	remostar	VIC5
remostarían	remostar	VIC6
remosté	remostar	VIX1
remostaste	remostar	VIX2
remostó	remostar	VIX3
remostasteis	remostar	VIX5
remostaron	remostar	VIX6
remoste	remostar	VSP1
remostes	remostar	VSP2
remostemos	remostar	VSP4
remostéis	remostar	VSP5
remosten	remostar	VSP6
remostara	remostar	VSX1
remostaras	remostar	VSX2
remostáramos	remostar	VSX4
remostarais	remostar	VSX5
remostaran	remostar	VSX6
remostare	remostar	VSF1
remostares	remostar	VSF2
remostáremos	remostar	VSF4
remostareis	remostar	VSF5
remostaren	remostar	VSF6
remostase	remostar	VSI1
remostases	remostar	VSI2
remostásemos	remostar	VSI4
remostaseis	remostar	VSI5
remostasen	remostar	VSI6
remostad	remostar	VMP
remostadme	remostar	VMSE
remostadle	remostar	VMSE
remostadnos	remostar	VMPE
remostaos	remostar	VMPE
remostadles	remostar	VMPE
remostadlo	remostar	VMMSE
remostadla	remostar	VMFSE
remostadlos	remostar	VMMPE
remostadlas	remostar	VMFPE
remostádmelo	remostar	VMMSE
remostádselo	remostar	VMMSE
remostádnoslo	remostar	VMMSE
remostáoslo	remostar	VMMSE
remostádmelos	remostar	VMMPE
remostádselos	remostar	VMMPE
remostádnoslos	remostar	VMMPE
remostáoslos	remostar	VMMPE
remostádmela	remostar	VMFSE
remostádsela	remostar	VMFSE
remostádnosla	remostar	VMFSE
remostáosla	remostar	VMFSE
remostádmelas	remostar	VMFPE
remostádselas	remostar	VMFPE
remostádnoslas	remostar	VMFPE
remostáoslas	remostar	VMFPE
remostado	remostar	VPM
remostados	remostar	VPMP
remostada	remostar	VPF
remostadas	remostar	VPFP
remostando	remostar	VG
remostándome	remostar	VGSE
remostándote	remostar	VGSE
remostándole	remostar	VGSE
remostándonos	remostar	VGPE
remostándoos	remostar	VGPE
remostándolo	remostar	VGMSE
remostándola	remostar	VGFSE
remostándolos	remostar	VGMPE
remostándolas	remostar	VGFPE
remostándomelo	remostar	VGMSE
remostándotelo	remostar	VGMSE
remostándoselo	remostar	VGMSE
remostándonoslo	remostar	VGMSE
remostándooslo	remostar	VGMSE
remostándomelos	remostar	VGMPE
remostándotelos	remostar	VGMPE
remostándoselos	remostar	VGMPE
remostándonoslos	remostar	VGMPE
remostándooslos	remostar	VGMPE
remostándomela	remostar	VGFSE
remostándotela	remostar	VGFSE
remostándosela	remostar	VGFSE
remostándonosla	remostar	VGFSE
remostándoosla	remostar	VGFSE
remostándomelas	remostar	VGFPE
remostándotelas	remostar	VGFPE
remostándoselas	remostar	VGFPE
remostándonoslas	remostar	VGFPE
remostándooslas	remostar	VGFPE
remozar	remozar	O
remozo	remozar	VIP1
remozas	remozar	VIP2
remoza	remozar	VIP3
remozamos	remozar	VIP4
remozáis	remozar	VIP5
remozan	remozar	VIP6
remozaba	remozar	VII1
remozabas	remozar	VII2
remozábamos	remozar	VII4
remozabais	remozar	VII5
remozaban	remozar	VII6
remozaré	remozar	VIF1
remozarás	remozar	VIF2
remozará	remozar	VIF3
remozaremos	remozar	VIF4
remozaréis	remozar	VIF5
remozarán	remozar	VIF6
remozaría	remozar	VIC1
remozarías	remozar	VIC2
remozaría	remozar	VIC3
remozaríamos	remozar	VIC4
remozaríais	remozar	VIC5
remozarían	remozar	VIC6
remocé	remozar	VIX1
remozaste	remozar	VIX2
remozó	remozar	VIX3
remozasteis	remozar	VIX5
remozaron	remozar	VIX6
remoce	remozar	VSP1
remoces	remozar	VSP2
remocemos	remozar	VSP4
remocéis	remozar	VSP5
remocen	remozar	VSP6
remozara	remozar	VSX1
remozaras	remozar	VSX2
remozáramos	remozar	VSX4
remozarais	remozar	VSX5
remozaran	remozar	VSX6
remozare	remozar	VSF1
remozares	remozar	VSF2
remozáremos	remozar	VSF4
remozareis	remozar	VSF5
remozaren	remozar	VSF6
remozase	remozar	VSI1
remozases	remozar	VSI2
remozásemos	remozar	VSI4
remozaseis	remozar	VSI5
remozasen	remozar	VSI6
remozad	remozar	VMP
remozadme	remozar	VMSE
remozadle	remozar	VMSE
remozadnos	remozar	VMPE
remozaos	remozar	VMPE
remozadles	remozar	VMPE
remozadlo	remozar	VMMSE
remozadla	remozar	VMFSE
remozadlos	remozar	VMMPE
remozadlas	remozar	VMFPE
remozádmelo	remozar	VMMSE
remozádselo	remozar	VMMSE
remozádnoslo	remozar	VMMSE
remozáoslo	remozar	VMMSE
remozádmelos	remozar	VMMPE
remozádselos	remozar	VMMPE
remozádnoslos	remozar	VMMPE
remozáoslos	remozar	VMMPE
remozádmela	remozar	VMFSE
remozádsela	remozar	VMFSE
remozádnosla	remozar	VMFSE
remozáosla	remozar	VMFSE
remozádmelas	remozar	VMFPE
remozádselas	remozar	VMFPE
remozádnoslas	remozar	VMFPE
remozáoslas	remozar	VMFPE
remozado	remozar	VPM
remozados	remozar	VPMP
remozada	remozar	VPF
remozadas	remozar	VPFP
remozando	remozar	VG
remozándome	remozar	VGSE
remozándote	remozar	VGSE
remozándole	remozar	VGSE
remozándonos	remozar	VGPE
remozándoos	remozar	VGPE
remozándolo	remozar	VGMSE
remozándola	remozar	VGFSE
remozándolos	remozar	VGMPE
remozándolas	remozar	VGFPE
remozándomelo	remozar	VGMSE
remozándotelo	remozar	VGMSE
remozándoselo	remozar	VGMSE
remozándonoslo	remozar	VGMSE
remozándooslo	remozar	VGMSE
remozándomelos	remozar	VGMPE
remozándotelos	remozar	VGMPE
remozándoselos	remozar	VGMPE
remozándonoslos	remozar	VGMPE
remozándooslos	remozar	VGMPE
remozándomela	remozar	VGFSE
remozándotela	remozar	VGFSE
remozándosela	remozar	VGFSE
remozándonosla	remozar	VGFSE
remozándoosla	remozar	VGFSE
remozándomelas	remozar	VGFPE
remozándotelas	remozar	VGFPE
remozándoselas	remozar	VGFPE
remozándonoslas	remozar	VGFPE
remozándooslas	remozar	VGFPE
remozares	remozar	P
remplazar	remplazar	O
remplazo	remplazar	VIP1
remplazas	remplazar	VIP2
remplaza	remplazar	VIP3
remplazamos	remplazar	VIP4
remplazáis	remplazar	VIP5
remplazan	remplazar	VIP6
remplazaba	remplazar	VII1
remplazabas	remplazar	VII2
remplazábamos	remplazar	VII4
remplazabais	remplazar	VII5
remplazaban	remplazar	VII6
remplazaré	remplazar	VIF1
remplazarás	remplazar	VIF2
remplazará	remplazar	VIF3
remplazaremos	remplazar	VIF4
remplazaréis	remplazar	VIF5
remplazarán	remplazar	VIF6
remplazaría	remplazar	VIC1
remplazarías	remplazar	VIC2
remplazaría	remplazar	VIC3
remplazaríamos	remplazar	VIC4
remplazaríais	remplazar	VIC5
remplazarían	remplazar	VIC6
remplacé	remplazar	VIX1
remplazaste	remplazar	VIX2
remplazó	remplazar	VIX3
remplazasteis	remplazar	VIX5
remplazaron	remplazar	VIX6
remplace	remplazar	VSP1
remplaces	remplazar	VSP2
remplacemos	remplazar	VSP4
remplacéis	remplazar	VSP5
remplacen	remplazar	VSP6
remplazara	remplazar	VSX1
remplazaras	remplazar	VSX2
remplazáramos	remplazar	VSX4
remplazarais	remplazar	VSX5
remplazaran	remplazar	VSX6
remplazare	remplazar	VSF1
remplazares	remplazar	VSF2
remplazáremos	remplazar	VSF4
remplazareis	remplazar	VSF5
remplazaren	remplazar	VSF6
remplazase	remplazar	VSI1
remplazases	remplazar	VSI2
remplazásemos	remplazar	VSI4
remplazaseis	remplazar	VSI5
remplazasen	remplazar	VSI6
remplazad	remplazar	VMP
remplazadme	remplazar	VMSE
remplazadle	remplazar	VMSE
remplazadnos	remplazar	VMPE
remplazaos	remplazar	VMPE
remplazadles	remplazar	VMPE
remplazadlo	remplazar	VMMSE
remplazadla	remplazar	VMFSE
remplazadlos	remplazar	VMMPE
remplazadlas	remplazar	VMFPE
remplazádmelo	remplazar	VMMSE
remplazádselo	remplazar	VMMSE
remplazádnoslo	remplazar	VMMSE
remplazáoslo	remplazar	VMMSE
remplazádmelos	remplazar	VMMPE
remplazádselos	remplazar	VMMPE
remplazádnoslos	remplazar	VMMPE
remplazáoslos	remplazar	VMMPE
remplazádmela	remplazar	VMFSE
remplazádsela	remplazar	VMFSE
remplazádnosla	remplazar	VMFSE
remplazáosla	remplazar	VMFSE
remplazádmelas	remplazar	VMFPE
remplazádselas	remplazar	VMFPE
remplazádnoslas	remplazar	VMFPE
remplazáoslas	remplazar	VMFPE
remplazado	remplazar	VPM
remplazados	remplazar	VPMP
remplazada	remplazar	VPF
remplazadas	remplazar	VPFP
remplazando	remplazar	VG
remplazándome	remplazar	VGSE
remplazándote	remplazar	VGSE
remplazándole	remplazar	VGSE
remplazándonos	remplazar	VGPE
remplazándoos	remplazar	VGPE
remplazándolo	remplazar	VGMSE
remplazándola	remplazar	VGFSE
remplazándolos	remplazar	VGMPE
remplazándolas	remplazar	VGFPE
remplazándomelo	remplazar	VGMSE
remplazándotelo	remplazar	VGMSE
remplazándoselo	remplazar	VGMSE
remplazándonoslo	remplazar	VGMSE
remplazándooslo	remplazar	VGMSE
remplazándomelos	remplazar	VGMPE
remplazándotelos	remplazar	VGMPE
remplazándoselos	remplazar	VGMPE
remplazándonoslos	remplazar	VGMPE
remplazándooslos	remplazar	VGMPE
remplazándomela	remplazar	VGFSE
remplazándotela	remplazar	VGFSE
remplazándosela	remplazar	VGFSE
remplazándonosla	remplazar	VGFSE
remplazándoosla	remplazar	VGFSE
remplazándomelas	remplazar	VGFPE
remplazándotelas	remplazar	VGFPE
remplazándoselas	remplazar	VGFPE
remplazándonoslas	remplazar	VGFPE
remplazándooslas	remplazar	VGFPE
rempujar	rempujar	O
rempujo	rempujar	VIP1
rempujas	rempujar	VIP2
rempuja	rempujar	VIP3
rempujamos	rempujar	VIP4
rempujáis	rempujar	VIP5
rempujan	rempujar	VIP6
rempujaba	rempujar	VII1
rempujabas	rempujar	VII2
rempujábamos	rempujar	VII4
rempujabais	rempujar	VII5
rempujaban	rempujar	VII6
rempujaré	rempujar	VIF1
rempujarás	rempujar	VIF2
rempujará	rempujar	VIF3
rempujaremos	rempujar	VIF4
rempujaréis	rempujar	VIF5
rempujarán	rempujar	VIF6
rempujaría	rempujar	VIC1
rempujarías	rempujar	VIC2
rempujaría	rempujar	VIC3
rempujaríamos	rempujar	VIC4
rempujaríais	rempujar	VIC5
rempujarían	rempujar	VIC6
rempujé	rempujar	VIX1
rempujaste	rempujar	VIX2
rempujó	rempujar	VIX3
rempujasteis	rempujar	VIX5
rempujaron	rempujar	VIX6
rempuje	rempujar	VSP1
rempujes	rempujar	VSP2
rempujemos	rempujar	VSP4
rempujéis	rempujar	VSP5
rempujen	rempujar	VSP6
rempujara	rempujar	VSX1
rempujaras	rempujar	VSX2
rempujáramos	rempujar	VSX4
rempujarais	rempujar	VSX5
rempujaran	rempujar	VSX6
rempujare	rempujar	VSF1
rempujares	rempujar	VSF2
rempujáremos	rempujar	VSF4
rempujareis	rempujar	VSF5
rempujaren	rempujar	VSF6
rempujase	rempujar	VSI1
rempujases	rempujar	VSI2
rempujásemos	rempujar	VSI4
rempujaseis	rempujar	VSI5
rempujasen	rempujar	VSI6
rempujad	rempujar	VMP
rempujadme	rempujar	VMSE
rempujadle	rempujar	VMSE
rempujadnos	rempujar	VMPE
rempujaos	rempujar	VMPE
rempujadles	rempujar	VMPE
rempujadlo	rempujar	VMMSE
rempujadla	rempujar	VMFSE
rempujadlos	rempujar	VMMPE
rempujadlas	rempujar	VMFPE
rempujádmelo	rempujar	VMMSE
rempujádselo	rempujar	VMMSE
rempujádnoslo	rempujar	VMMSE
rempujáoslo	rempujar	VMMSE
rempujádmelos	rempujar	VMMPE
rempujádselos	rempujar	VMMPE
rempujádnoslos	rempujar	VMMPE
rempujáoslos	rempujar	VMMPE
rempujádmela	rempujar	VMFSE
rempujádsela	rempujar	VMFSE
rempujádnosla	rempujar	VMFSE
rempujáosla	rempujar	VMFSE
rempujádmelas	rempujar	VMFPE
rempujádselas	rempujar	VMFPE
rempujádnoslas	rempujar	VMFPE
rempujáoslas	rempujar	VMFPE
rempujado	rempujar	VPM
rempujados	rempujar	VPMP
rempujada	rempujar	VPF
rempujadas	rempujar	VPFP
rempujando	rempujar	VG
rempujándome	rempujar	VGSE
rempujándote	rempujar	VGSE
rempujándole	rempujar	VGSE
rempujándonos	rempujar	VGPE
rempujándoos	rempujar	VGPE
rempujándolo	rempujar	VGMSE
rempujándola	rempujar	VGFSE
rempujándolos	rempujar	VGMPE
rempujándolas	rempujar	VGFPE
rempujándomelo	rempujar	VGMSE
rempujándotelo	rempujar	VGMSE
rempujándoselo	rempujar	VGMSE
rempujándonoslo	rempujar	VGMSE
rempujándooslo	rempujar	VGMSE
rempujándomelos	rempujar	VGMPE
rempujándotelos	rempujar	VGMPE
rempujándoselos	rempujar	VGMPE
rempujándonoslos	rempujar	VGMPE
rempujándooslos	rempujar	VGMPE
rempujándomela	rempujar	VGFSE
rempujándotela	rempujar	VGFSE
rempujándosela	rempujar	VGFSE
rempujándonosla	rempujar	VGFSE
rempujándoosla	rempujar	VGFSE
rempujándomelas	rempujar	VGFPE
rempujándotelas	rempujar	VGFPE
rempujándoselas	rempujar	VGFPE
rempujándonoslas	rempujar	VGFPE
rempujándooslas	rempujar	VGFPE
remudar	remudar	O
remudo	remudar	VIP1
remudas	remudar	VIP2
remuda	remudar	VIP3
remudamos	remudar	VIP4
remudáis	remudar	VIP5
remudan	remudar	VIP6
remudaba	remudar	VII1
remudabas	remudar	VII2
remudábamos	remudar	VII4
remudabais	remudar	VII5
remudaban	remudar	VII6
remudaré	remudar	VIF1
remudarás	remudar	VIF2
remudará	remudar	VIF3
remudaremos	remudar	VIF4
remudaréis	remudar	VIF5
remudarán	remudar	VIF6
remudaría	remudar	VIC1
remudarías	remudar	VIC2
remudaría	remudar	VIC3
remudaríamos	remudar	VIC4
remudaríais	remudar	VIC5
remudarían	remudar	VIC6
remudé	remudar	VIX1
remudaste	remudar	VIX2
remudó	remudar	VIX3
remudasteis	remudar	VIX5
remudaron	remudar	VIX6
remude	remudar	VSP1
remudes	remudar	VSP2
remudemos	remudar	VSP4
remudéis	remudar	VSP5
remuden	remudar	VSP6
remudara	remudar	VSX1
remudaras	remudar	VSX2
remudáramos	remudar	VSX4
remudarais	remudar	VSX5
remudaran	remudar	VSX6
remudare	remudar	VSF1
remudares	remudar	VSF2
remudáremos	remudar	VSF4
remudareis	remudar	VSF5
remudaren	remudar	VSF6
remudase	remudar	VSI1
remudases	remudar	VSI2
remudásemos	remudar	VSI4
remudaseis	remudar	VSI5
remudasen	remudar	VSI6
remudad	remudar	VMP
remudadme	remudar	VMSE
remudadle	remudar	VMSE
remudadnos	remudar	VMPE
remudaos	remudar	VMPE
remudadles	remudar	VMPE
remudadlo	remudar	VMMSE
remudadla	remudar	VMFSE
remudadlos	remudar	VMMPE
remudadlas	remudar	VMFPE
remudádmelo	remudar	VMMSE
remudádselo	remudar	VMMSE
remudádnoslo	remudar	VMMSE
remudáoslo	remudar	VMMSE
remudádmelos	remudar	VMMPE
remudádselos	remudar	VMMPE
remudádnoslos	remudar	VMMPE
remudáoslos	remudar	VMMPE
remudádmela	remudar	VMFSE
remudádsela	remudar	VMFSE
remudádnosla	remudar	VMFSE
remudáosla	remudar	VMFSE
remudádmelas	remudar	VMFPE
remudádselas	remudar	VMFPE
remudádnoslas	remudar	VMFPE
remudáoslas	remudar	VMFPE
remudado	remudar	VPM
remudados	remudar	VPMP
remudada	remudar	VPF
remudadas	remudar	VPFP
remudando	remudar	VG
remudándome	remudar	VGSE
remudándote	remudar	VGSE
remudándole	remudar	VGSE
remudándonos	remudar	VGPE
remudándoos	remudar	VGPE
remudándolo	remudar	VGMSE
remudándola	remudar	VGFSE
remudándolos	remudar	VGMPE
remudándolas	remudar	VGFPE
remudándomelo	remudar	VGMSE
remudándotelo	remudar	VGMSE
remudándoselo	remudar	VGMSE
remudándonoslo	remudar	VGMSE
remudándooslo	remudar	VGMSE
remudándomelos	remudar	VGMPE
remudándotelos	remudar	VGMPE
remudándoselos	remudar	VGMPE
remudándonoslos	remudar	VGMPE
remudándooslos	remudar	VGMPE
remudándomela	remudar	VGFSE
remudándotela	remudar	VGFSE
remudándosela	remudar	VGFSE
remudándonosla	remudar	VGFSE
remudándoosla	remudar	VGFSE
remudándomelas	remudar	VGFPE
remudándotelas	remudar	VGFPE
remudándoselas	remudar	VGFPE
remudándonoslas	remudar	VGFPE
remudándooslas	remudar	VGFPE
remudiar	remudiar	O
remudio	remudiar	VIP1
remudias	remudiar	VIP2
remudia	remudiar	VIP3
remudiamos	remudiar	VIP4
remudiáis	remudiar	VIP5
remudian	remudiar	VIP6
remudiaba	remudiar	VII1
remudiabas	remudiar	VII2
remudiábamos	remudiar	VII4
remudiabais	remudiar	VII5
remudiaban	remudiar	VII6
remudiaré	remudiar	VIF1
remudiarás	remudiar	VIF2
remudiará	remudiar	VIF3
remudiaremos	remudiar	VIF4
remudiaréis	remudiar	VIF5
remudiarán	remudiar	VIF6
remudiaría	remudiar	VIC1
remudiarías	remudiar	VIC2
remudiaría	remudiar	VIC3
remudiaríamos	remudiar	VIC4
remudiaríais	remudiar	VIC5
remudiarían	remudiar	VIC6
remudié	remudiar	VIX1
remudiaste	remudiar	VIX2
remudió	remudiar	VIX3
remudiasteis	remudiar	VIX5
remudiaron	remudiar	VIX6
remudie	remudiar	VSP1
remudies	remudiar	VSP2
remudiemos	remudiar	VSP4
remudiéis	remudiar	VSP5
remudien	remudiar	VSP6
remudiara	remudiar	VSX1
remudiaras	remudiar	VSX2
remudiáramos	remudiar	VSX4
remudiarais	remudiar	VSX5
remudiaran	remudiar	VSX6
remudiare	remudiar	VSF1
remudiares	remudiar	VSF2
remudiáremos	remudiar	VSF4
remudiareis	remudiar	VSF5
remudiaren	remudiar	VSF6
remudiase	remudiar	VSI1
remudiases	remudiar	VSI2
remudiásemos	remudiar	VSI4
remudiaseis	remudiar	VSI5
remudiasen	remudiar	VSI6
remudiad	remudiar	VMP
remudiadme	remudiar	VMSE
remudiadle	remudiar	VMSE
remudiadnos	remudiar	VMPE
remudiaos	remudiar	VMPE
remudiadles	remudiar	VMPE
remudiado	remudiar	VPM
remudiados	remudiar	VPMP
remudiada	remudiar	VPF
remudiadas	remudiar	VPFP
remudiando	remudiar	VG
remudiándome	remudiar	VGSE
remudiándote	remudiar	VGSE
remudiándole	remudiar	VGSE
remudiándonos	remudiar	VGPE
remudiándoos	remudiar	VGPE
remugar	remugar	O
remugo	remugar	VIP1
remugas	remugar	VIP2
remuga	remugar	VIP3
remugamos	remugar	VIP4
remugáis	remugar	VIP5
remugan	remugar	VIP6
remugaba	remugar	VII1
remugabas	remugar	VII2
remugábamos	remugar	VII4
remugabais	remugar	VII5
remugaban	remugar	VII6
remugaré	remugar	VIF1
remugarás	remugar	VIF2
remugará	remugar	VIF3
remugaremos	remugar	VIF4
remugaréis	remugar	VIF5
remugarán	remugar	VIF6
remugaría	remugar	VIC1
remugarías	remugar	VIC2
remugaría	remugar	VIC3
remugaríamos	remugar	VIC4
remugaríais	remugar	VIC5
remugarían	remugar	VIC6
remugé	remugar	VIX1
remugaste	remugar	VIX2
remugó	remugar	VIX3
remugasteis	remugar	VIX5
remugaron	remugar	VIX6
remugue	remugar	VSP1
remugues	remugar	VSP2
remuguemos	remugar	VSP4
remuguéis	remugar	VSP5
remuguen	remugar	VSP6
remugara	remugar	VSX1
remugaras	remugar	VSX2
remugáramos	remugar	VSX4
remugarais	remugar	VSX5
remugaran	remugar	VSX6
remugare	remugar	VSF1
remugares	remugar	VSF2
remugáremos	remugar	VSF4
remugareis	remugar	VSF5
remugaren	remugar	VSF6
remugase	remugar	VSI1
remugases	remugar	VSI2
remugásemos	remugar	VSI4
remugaseis	remugar	VSI5
remugasen	remugar	VSI6
remugad	remugar	VMP
remugadme	remugar	VMSE
remugadle	remugar	VMSE
remugadnos	remugar	VMPE
remugaos	remugar	VMPE
remugadles	remugar	VMPE
remugadlo	remugar	VMMSE
remugadla	remugar	VMFSE
remugadlos	remugar	VMMPE
remugadlas	remugar	VMFPE
remugádmelo	remugar	VMMSE
remugádselo	remugar	VMMSE
remugádnoslo	remugar	VMMSE
remugáoslo	remugar	VMMSE
remugádmelos	remugar	VMMPE
remugádselos	remugar	VMMPE
remugádnoslos	remugar	VMMPE
remugáoslos	remugar	VMMPE
remugádmela	remugar	VMFSE
remugádsela	remugar	VMFSE
remugádnosla	remugar	VMFSE
remugáosla	remugar	VMFSE
remugádmelas	remugar	VMFPE
remugádselas	remugar	VMFPE
remugádnoslas	remugar	VMFPE
remugáoslas	remugar	VMFPE
remugado	remugar	VPM
remugados	remugar	VPMP
remugada	remugar	VPF
remugadas	remugar	VPFP
remugando	remugar	VG
remugándome	remugar	VGSE
remugándote	remugar	VGSE
remugándole	remugar	VGSE
remugándonos	remugar	VGPE
remugándoos	remugar	VGPE
remugándolo	remugar	VGMSE
remugándola	remugar	VGFSE
remugándolos	remugar	VGMPE
remugándolas	remugar	VGFPE
remugándomelo	remugar	VGMSE
remugándotelo	remugar	VGMSE
remugándoselo	remugar	VGMSE
remugándonoslo	remugar	VGMSE
remugándooslo	remugar	VGMSE
remugándomelos	remugar	VGMPE
remugándotelos	remugar	VGMPE
remugándoselos	remugar	VGMPE
remugándonoslos	remugar	VGMPE
remugándooslos	remugar	VGMPE
remugándomela	remugar	VGFSE
remugándotela	remugar	VGFSE
remugándosela	remugar	VGFSE
remugándonosla	remugar	VGFSE
remugándoosla	remugar	VGFSE
remugándomelas	remugar	VGFPE
remugándotelas	remugar	VGFPE
remugándoselas	remugar	VGFPE
remugándonoslas	remugar	VGFPE
remugándooslas	remugar	VGFPE
remunerar	remunerar	O
remunero	remunerar	VIP1
remuneras	remunerar	VIP2
remunera	remunerar	VIP3
remuneramos	remunerar	VIP4
remuneráis	remunerar	VIP5
remuneran	remunerar	VIP6
remuneraba	remunerar	VII1
remunerabas	remunerar	VII2
remunerábamos	remunerar	VII4
remunerabais	remunerar	VII5
remuneraban	remunerar	VII6
remuneraré	remunerar	VIF1
remunerarás	remunerar	VIF2
remunerará	remunerar	VIF3
remuneraremos	remunerar	VIF4
remuneraréis	remunerar	VIF5
remunerarán	remunerar	VIF6
remuneraría	remunerar	VIC1
remunerarías	remunerar	VIC2
remuneraría	remunerar	VIC3
remuneraríamos	remunerar	VIC4
remuneraríais	remunerar	VIC5
remunerarían	remunerar	VIC6
remuneré	remunerar	VIX1
remuneraste	remunerar	VIX2
remuneró	remunerar	VIX3
remunerasteis	remunerar	VIX5
remuneraron	remunerar	VIX6
remunere	remunerar	VSP1
remuneres	remunerar	VSP2
remuneremos	remunerar	VSP4
remuneréis	remunerar	VSP5
remuneren	remunerar	VSP6
remunerara	remunerar	VSX1
remuneraras	remunerar	VSX2
remuneráramos	remunerar	VSX4
remunerarais	remunerar	VSX5
remuneraran	remunerar	VSX6
remunerare	remunerar	VSF1
remunerares	remunerar	VSF2
remuneráremos	remunerar	VSF4
remunerareis	remunerar	VSF5
remuneraren	remunerar	VSF6
remunerase	remunerar	VSI1
remunerases	remunerar	VSI2
remunerásemos	remunerar	VSI4
remuneraseis	remunerar	VSI5
remunerasen	remunerar	VSI6
remunerad	remunerar	VMP
remuneradme	remunerar	VMSE
remuneradle	remunerar	VMSE
remuneradnos	remunerar	VMPE
remuneraos	remunerar	VMPE
remuneradles	remunerar	VMPE
remuneradlo	remunerar	VMMSE
remuneradla	remunerar	VMFSE
remuneradlos	remunerar	VMMPE
remuneradlas	remunerar	VMFPE
remunerádmelo	remunerar	VMMSE
remunerádselo	remunerar	VMMSE
remunerádnoslo	remunerar	VMMSE
remuneráoslo	remunerar	VMMSE
remunerádmelos	remunerar	VMMPE
remunerádselos	remunerar	VMMPE
remunerádnoslos	remunerar	VMMPE
remuneráoslos	remunerar	VMMPE
remunerádmela	remunerar	VMFSE
remunerádsela	remunerar	VMFSE
remunerádnosla	remunerar	VMFSE
remuneráosla	remunerar	VMFSE
remunerádmelas	remunerar	VMFPE
remunerádselas	remunerar	VMFPE
remunerádnoslas	remunerar	VMFPE
remuneráoslas	remunerar	VMFPE
remunerado	remunerar	VPM
remunerados	remunerar	VPMP
remunerada	remunerar	VPF
remuneradas	remunerar	VPFP
remunerando	remunerar	VG
remunerándome	remunerar	VGSE
remunerándote	remunerar	VGSE
remunerándole	remunerar	VGSE
remunerándonos	remunerar	VGPE
remunerándoos	remunerar	VGPE
remunerándolo	remunerar	VGMSE
remunerándola	remunerar	VGFSE
remunerándolos	remunerar	VGMPE
remunerándolas	remunerar	VGFPE
remunerándomelo	remunerar	VGMSE
remunerándotelo	remunerar	VGMSE
remunerándoselo	remunerar	VGMSE
remunerándonoslo	remunerar	VGMSE
remunerándooslo	remunerar	VGMSE
remunerándomelos	remunerar	VGMPE
remunerándotelos	remunerar	VGMPE
remunerándoselos	remunerar	VGMPE
remunerándonoslos	remunerar	VGMPE
remunerándooslos	remunerar	VGMPE
remunerándomela	remunerar	VGFSE
remunerándotela	remunerar	VGFSE
remunerándosela	remunerar	VGFSE
remunerándonosla	remunerar	VGFSE
remunerándoosla	remunerar	VGFSE
remunerándomelas	remunerar	VGFPE
remunerándotelas	remunerar	VGFPE
remunerándoselas	remunerar	VGFPE
remunerándonoslas	remunerar	VGFPE
remunerándooslas	remunerar	VGFPE
remusgar	remusgar	O
remusgo	remusgar	VIP1
remusgas	remusgar	VIP2
remusga	remusgar	VIP3
remusgamos	remusgar	VIP4
remusgáis	remusgar	VIP5
remusgan	remusgar	VIP6
remusgaba	remusgar	VII1
remusgabas	remusgar	VII2
remusgábamos	remusgar	VII4
remusgabais	remusgar	VII5
remusgaban	remusgar	VII6
remusgaré	remusgar	VIF1
remusgarás	remusgar	VIF2
remusgará	remusgar	VIF3
remusgaremos	remusgar	VIF4
remusgaréis	remusgar	VIF5
remusgarán	remusgar	VIF6
remusgaría	remusgar	VIC1
remusgarías	remusgar	VIC2
remusgaría	remusgar	VIC3
remusgaríamos	remusgar	VIC4
remusgaríais	remusgar	VIC5
remusgarían	remusgar	VIC6
remusgé	remusgar	VIX1
remusgaste	remusgar	VIX2
remusgó	remusgar	VIX3
remusgasteis	remusgar	VIX5
remusgaron	remusgar	VIX6
remusgue	remusgar	VSP1
remusgues	remusgar	VSP2
remusguemos	remusgar	VSP4
remusguéis	remusgar	VSP5
remusguen	remusgar	VSP6
remusgara	remusgar	VSX1
remusgaras	remusgar	VSX2
remusgáramos	remusgar	VSX4
remusgarais	remusgar	VSX5
remusgaran	remusgar	VSX6
remusgare	remusgar	VSF1
remusgares	remusgar	VSF2
remusgáremos	remusgar	VSF4
remusgareis	remusgar	VSF5
remusgaren	remusgar	VSF6
remusgase	remusgar	VSI1
remusgases	remusgar	VSI2
remusgásemos	remusgar	VSI4
remusgaseis	remusgar	VSI5
remusgasen	remusgar	VSI6
remusgad	remusgar	VMP
remusgadme	remusgar	VMSE
remusgadle	remusgar	VMSE
remusgadnos	remusgar	VMPE
remusgaos	remusgar	VMPE
remusgadles	remusgar	VMPE
remusgado	remusgar	VPM
remusgados	remusgar	VPMP
remusgada	remusgar	VPF
remusgadas	remusgar	VPFP
remusgando	remusgar	VG
remusgándome	remusgar	VGSE
remusgándote	remusgar	VGSE
remusgándole	remusgar	VGSE
remusgándonos	remusgar	VGPE
remusgándoos	remusgar	VGPE
