requebrador	requebrador	O
requebradoras	requebrador	FP
requebradora	requebrador	F
requebradores	requebrador	P
requebrajo	requebrajo	O
requebrajos	requebrajo	P
requemado	requemado	O
requemadas	requemado	FP
requemada	requemado	F
requemados	requemado	P
requemamiento	requemamiento	O
requemamientos	requemamiento	P
requemazón	requemazón	O
requemazones	requemazón	P
requenense	requenense	O
requenenses	requenense	P
requeridor	requeridor	O
requeridoras	requeridor	FP
requeridora	requeridor	F
requeridores	requeridor	P
requerimiento	requerimiento	O
requerimientos	requerimiento	P
requesonero	requesonero	O
requesoneras	requesonero	FP
requesonera	requesonero	F
requesoneros	requesonero	P
requesón	requesón	O
requesones	requesón	P
requetebién	requetebién	O
requeté	requeté	O
requetés	requeté	P
requiebro	requiebro	O
requiebros	requiebro	P
requilorio	requilorio	O
requilorios	requilorio	P
requintador	requintador	O
requintadoras	requintador	FP
requintadora	requintador	F
requintadores	requintador	P
requinto	requinto	O
requintos	requinto	P
requirente	requirente	O
requirentes	requirente	P
requisa	requisa	O
requisas	requisa	P
requisición	requisición	O
requisiciones	requisición	P
requisito	requisito	O
requisitos	requisito	P
requisitorio	requisitorio	O
requisitorias	requisitorio	FP
requisitoria	requisitorio	F
requisitorios	requisitorio	P
requive	requive	O
requives	requive	P
réquiem	réquiem	O
réquiemes	réquiem	P
requerir	requerir	O
requiero	requerir	VIP1
requieres	requerir	VIP2
requiere	requerir	VIP3
requerimos	requerir	VIP4
requerís	requerir	VIP5
requieren	requerir	VIP6
requería	requerir	VII1
requerías	requerir	VII2
requeríamos	requerir	VII4
requeríais	requerir	VII5
requerían	requerir	VII6
requeriré	requerir	VIF1
requerirás	requerir	VIF2
requerirá	requerir	VIF3
requeriremos	requerir	VIF4
requeriréis	requerir	VIF5
requerirán	requerir	VIF6
requeriría	requerir	VIC1
requerirías	requerir	VIC2
requeriría	requerir	VIC3
requeriríamos	requerir	VIC4
requeriríais	requerir	VIC5
requerirían	requerir	VIC6
requerí	requerir	VIX1
requeriste	requerir	VIX2
requirió	requerir	VIX3
requeristeis	requerir	VIX5
requirieron	requerir	VIX6
requiera	requerir	VSP1
requieras	requerir	VSP2
requiramos	requerir	VSP4
requiráis	requerir	VSP5
requieran	requerir	VSP6
requiriera	requerir	VSX1
requirieras	requerir	VSX2
requiriéramos	requerir	VSX4
requirierais	requerir	VSX5
requirieran	requerir	VSX6
requiriere	requerir	VSF1
requirieres	requerir	VSF2
requiriéremos	requerir	VSF4
requiriereis	requerir	VSF5
requirieren	requerir	VSF6
requiriese	requerir	VSI1
requirieses	requerir	VSI2
requiriésemos	requerir	VSI4
requirieseis	requerir	VSI5
requiriesen	requerir	VSI6
requerid	requerir	VMP
requeridme	requerir	VMSE
requeridle	requerir	VMSE
requeridnos	requerir	VMPE
requerios	requerir	VMPE
requeridles	requerir	VMPE
requeridlo	requerir	VMMSE
requeridla	requerir	VMFSE
requeridlos	requerir	VMMPE
requeridlas	requerir	VMFPE
requerídmelo	requerir	VMMSE
requerídselo	requerir	VMMSE
requerídnoslo	requerir	VMMSE
requeríoslo	requerir	VMMSE
requerídmelos	requerir	VMMPE
requerídselos	requerir	VMMPE
requerídnoslos	requerir	VMMPE
requeríoslos	requerir	VMMPE
requerídmela	requerir	VMFSE
requerídsela	requerir	VMFSE
requerídnosla	requerir	VMFSE
requeríosla	requerir	VMFSE
requerídmelas	requerir	VMFPE
requerídselas	requerir	VMFPE
requerídnoslas	requerir	VMFPE
requeríoslas	requerir	VMFPE
requerido	requerir	VPM
requeridos	requerir	VPMP
requerida	requerir	VPF
requeridas	requerir	VPFP
requiriendo	requerir	VG
requiriéndome	requerir	VGSE
requiriéndote	requerir	VGSE
requiriéndole	requerir	VGSE
requiriéndonos	requerir	VGPE
requiriéndoos	requerir	VGPE
requiriéndolo	requerir	VGMSE
requiriéndola	requerir	VGFSE
requiriéndolos	requerir	VGMPE
requiriéndolas	requerir	VGFPE
requiriéndomelo	requerir	VGMSE
requiriéndotelo	requerir	VGMSE
requiriéndoselo	requerir	VGMSE
requiriéndonoslo	requerir	VGMSE
requiriéndooslo	requerir	VGMSE
requiriéndomelos	requerir	VGMPE
requiriéndotelos	requerir	VGMPE
requiriéndoselos	requerir	VGMPE
requiriéndonoslos	requerir	VGMPE
requiriéndooslos	requerir	VGMPE
requiriéndomela	requerir	VGFSE
requiriéndotela	requerir	VGFSE
requiriéndosela	requerir	VGFSE
requiriéndonosla	requerir	VGFSE
requiriéndoosla	requerir	VGFSE
requiriéndomelas	requerir	VGFPE
requiriéndotelas	requerir	VGFPE
requiriéndoselas	requerir	VGFPE
requiriéndonoslas	requerir	VGFPE
requiriéndooslas	requerir	VGFPE
requebrar	requebrar	O
requiebro	requebrar	VIP1
requiebras	requebrar	VIP2
requiebra	requebrar	VIP3
requebramos	requebrar	VIP4
requebráis	requebrar	VIP5
requiebran	requebrar	VIP6
requebraba	requebrar	VII1
requebrabas	requebrar	VII2
requebrábamos	requebrar	VII4
requebrabais	requebrar	VII5
requebraban	requebrar	VII6
requebraré	requebrar	VIF1
requebrarás	requebrar	VIF2
requebrará	requebrar	VIF3
requebraremos	requebrar	VIF4
requebraréis	requebrar	VIF5
requebrarán	requebrar	VIF6
requebraría	requebrar	VIC1
requebrarías	requebrar	VIC2
requebraría	requebrar	VIC3
requebraríamos	requebrar	VIC4
requebraríais	requebrar	VIC5
requebrarían	requebrar	VIC6
requebré	requebrar	VIX1
requebraste	requebrar	VIX2
requebró	requebrar	VIX3
requebrasteis	requebrar	VIX5
requebraron	requebrar	VIX6
requiebre	requebrar	VSP1
requiebres	requebrar	VSP2
requebremos	requebrar	VSP4
requebréis	requebrar	VSP5
requiebren	requebrar	VSP6
requebrara	requebrar	VSX1
requebraras	requebrar	VSX2
requebráramos	requebrar	VSX4
requebrarais	requebrar	VSX5
requebraran	requebrar	VSX6
requebrare	requebrar	VSF1
requebrares	requebrar	VSF2
requebráremos	requebrar	VSF4
requebrareis	requebrar	VSF5
requebraren	requebrar	VSF6
requebrase	requebrar	VSI1
requebrases	requebrar	VSI2
requebrásemos	requebrar	VSI4
requebraseis	requebrar	VSI5
requebrasen	requebrar	VSI6
requebrad	requebrar	VMP
requebradme	requebrar	VMSE
requebradle	requebrar	VMSE
requebradnos	requebrar	VMPE
requebraos	requebrar	VMPE
requebradles	requebrar	VMPE
requebradlo	requebrar	VMMSE
requebradla	requebrar	VMFSE
requebradlos	requebrar	VMMPE
requebradlas	requebrar	VMFPE
requebrádmelo	requebrar	VMMSE
requebrádselo	requebrar	VMMSE
requebrádnoslo	requebrar	VMMSE
requebráoslo	requebrar	VMMSE
requebrádmelos	requebrar	VMMPE
requebrádselos	requebrar	VMMPE
requebrádnoslos	requebrar	VMMPE
requebráoslos	requebrar	VMMPE
requebrádmela	requebrar	VMFSE
requebrádsela	requebrar	VMFSE
requebrádnosla	requebrar	VMFSE
requebráosla	requebrar	VMFSE
requebrádmelas	requebrar	VMFPE
requebrádselas	requebrar	VMFPE
requebrádnoslas	requebrar	VMFPE
requebráoslas	requebrar	VMFPE
requebrado	requebrar	VPM
requebrados	requebrar	VPMP
requebrada	requebrar	VPF
requebradas	requebrar	VPFP
requebrando	requebrar	VG
requebrándome	requebrar	VGSE
requebrándote	requebrar	VGSE
requebrándole	requebrar	VGSE
requebrándonos	requebrar	VGPE
requebrándoos	requebrar	VGPE
requebrándolo	requebrar	VGMSE
requebrándola	requebrar	VGFSE
requebrándolos	requebrar	VGMPE
requebrándolas	requebrar	VGFPE
requebrándomelo	requebrar	VGMSE
requebrándotelo	requebrar	VGMSE
requebrándoselo	requebrar	VGMSE
requebrándonoslo	requebrar	VGMSE
requebrándooslo	requebrar	VGMSE
requebrándomelos	requebrar	VGMPE
requebrándotelos	requebrar	VGMPE
requebrándoselos	requebrar	VGMPE
requebrándonoslos	requebrar	VGMPE
requebrándooslos	requebrar	VGMPE
requebrándomela	requebrar	VGFSE
requebrándotela	requebrar	VGFSE
requebrándosela	requebrar	VGFSE
requebrándonosla	requebrar	VGFSE
requebrándoosla	requebrar	VGFSE
requebrándomelas	requebrar	VGFPE
requebrándotelas	requebrar	VGFPE
requebrándoselas	requebrar	VGFPE
requebrándonoslas	requebrar	VGFPE
requebrándooslas	requebrar	VGFPE
requemar	requemar	O
requemo	requemar	VIP1
requemas	requemar	VIP2
requema	requemar	VIP3
requemamos	requemar	VIP4
requemáis	requemar	VIP5
requeman	requemar	VIP6
requemaba	requemar	VII1
requemabas	requemar	VII2
requemábamos	requemar	VII4
requemabais	requemar	VII5
requemaban	requemar	VII6
requemaré	requemar	VIF1
requemarás	requemar	VIF2
requemará	requemar	VIF3
requemaremos	requemar	VIF4
requemaréis	requemar	VIF5
requemarán	requemar	VIF6
requemaría	requemar	VIC1
requemarías	requemar	VIC2
requemaría	requemar	VIC3
requemaríamos	requemar	VIC4
requemaríais	requemar	VIC5
requemarían	requemar	VIC6
requemé	requemar	VIX1
requemaste	requemar	VIX2
requemó	requemar	VIX3
requemasteis	requemar	VIX5
requemaron	requemar	VIX6
requeme	requemar	VSP1
requemes	requemar	VSP2
requememos	requemar	VSP4
requeméis	requemar	VSP5
requemen	requemar	VSP6
requemara	requemar	VSX1
requemaras	requemar	VSX2
requemáramos	requemar	VSX4
requemarais	requemar	VSX5
requemaran	requemar	VSX6
requemare	requemar	VSF1
requemares	requemar	VSF2
requemáremos	requemar	VSF4
requemareis	requemar	VSF5
requemaren	requemar	VSF6
requemase	requemar	VSI1
requemases	requemar	VSI2
requemásemos	requemar	VSI4
requemaseis	requemar	VSI5
requemasen	requemar	VSI6
requemad	requemar	VMP
requemadme	requemar	VMSE
requemadle	requemar	VMSE
requemadnos	requemar	VMPE
requemaos	requemar	VMPE
requemadles	requemar	VMPE
requemadlo	requemar	VMMSE
requemadla	requemar	VMFSE
requemadlos	requemar	VMMPE
requemadlas	requemar	VMFPE
requemádmelo	requemar	VMMSE
requemádselo	requemar	VMMSE
requemádnoslo	requemar	VMMSE
requemáoslo	requemar	VMMSE
requemádmelos	requemar	VMMPE
requemádselos	requemar	VMMPE
requemádnoslos	requemar	VMMPE
requemáoslos	requemar	VMMPE
requemádmela	requemar	VMFSE
requemádsela	requemar	VMFSE
requemádnosla	requemar	VMFSE
requemáosla	requemar	VMFSE
requemádmelas	requemar	VMFPE
requemádselas	requemar	VMFPE
requemádnoslas	requemar	VMFPE
requemáoslas	requemar	VMFPE
requemado	requemar	VPM
requemados	requemar	VPMP
requemada	requemar	VPF
requemadas	requemar	VPFP
requemando	requemar	VG
requemándome	requemar	VGSE
requemándote	requemar	VGSE
requemándole	requemar	VGSE
requemándonos	requemar	VGPE
requemándoos	requemar	VGPE
requemándolo	requemar	VGMSE
requemándola	requemar	VGFSE
requemándolos	requemar	VGMPE
requemándolas	requemar	VGFPE
requemándomelo	requemar	VGMSE
requemándotelo	requemar	VGMSE
requemándoselo	requemar	VGMSE
requemándonoslo	requemar	VGMSE
requemándooslo	requemar	VGMSE
requemándomelos	requemar	VGMPE
requemándotelos	requemar	VGMPE
requemándoselos	requemar	VGMPE
requemándonoslos	requemar	VGMPE
requemándooslos	requemar	VGMPE
requemándomela	requemar	VGFSE
requemándotela	requemar	VGFSE
requemándosela	requemar	VGFSE
requemándonosla	requemar	VGFSE
requemándoosla	requemar	VGFSE
requemándomelas	requemar	VGFPE
requemándotelas	requemar	VGFPE
requemándoselas	requemar	VGFPE
requemándonoslas	requemar	VGFPE
requemándooslas	requemar	VGFPE
requintar	requintar	O
requinto	requintar	VIP1
requintas	requintar	VIP2
requinta	requintar	VIP3
requintamos	requintar	VIP4
requintáis	requintar	VIP5
requintan	requintar	VIP6
requintaba	requintar	VII1
requintabas	requintar	VII2
requintábamos	requintar	VII4
requintabais	requintar	VII5
requintaban	requintar	VII6
requintaré	requintar	VIF1
requintarás	requintar	VIF2
requintará	requintar	VIF3
requintaremos	requintar	VIF4
requintaréis	requintar	VIF5
requintarán	requintar	VIF6
requintaría	requintar	VIC1
requintarías	requintar	VIC2
requintaría	requintar	VIC3
requintaríamos	requintar	VIC4
requintaríais	requintar	VIC5
requintarían	requintar	VIC6
requinté	requintar	VIX1
requintaste	requintar	VIX2
requintó	requintar	VIX3
requintasteis	requintar	VIX5
requintaron	requintar	VIX6
requinte	requintar	VSP1
requintes	requintar	VSP2
requintemos	requintar	VSP4
requintéis	requintar	VSP5
requinten	requintar	VSP6
requintara	requintar	VSX1
requintaras	requintar	VSX2
requintáramos	requintar	VSX4
requintarais	requintar	VSX5
requintaran	requintar	VSX6
requintare	requintar	VSF1
requintares	requintar	VSF2
requintáremos	requintar	VSF4
requintareis	requintar	VSF5
requintaren	requintar	VSF6
requintase	requintar	VSI1
requintases	requintar	VSI2
requintásemos	requintar	VSI4
requintaseis	requintar	VSI5
requintasen	requintar	VSI6
requintad	requintar	VMP
requintadme	requintar	VMSE
requintadle	requintar	VMSE
requintadnos	requintar	VMPE
requintaos	requintar	VMPE
requintadles	requintar	VMPE
requintadlo	requintar	VMMSE
requintadla	requintar	VMFSE
requintadlos	requintar	VMMPE
requintadlas	requintar	VMFPE
requintádmelo	requintar	VMMSE
requintádselo	requintar	VMMSE
requintádnoslo	requintar	VMMSE
requintáoslo	requintar	VMMSE
requintádmelos	requintar	VMMPE
requintádselos	requintar	VMMPE
requintádnoslos	requintar	VMMPE
requintáoslos	requintar	VMMPE
requintádmela	requintar	VMFSE
requintádsela	requintar	VMFSE
requintádnosla	requintar	VMFSE
requintáosla	requintar	VMFSE
requintádmelas	requintar	VMFPE
requintádselas	requintar	VMFPE
requintádnoslas	requintar	VMFPE
requintáoslas	requintar	VMFPE
requintado	requintar	VPM
requintados	requintar	VPMP
requintada	requintar	VPF
requintadas	requintar	VPFP
requintando	requintar	VG
requintándome	requintar	VGSE
requintándote	requintar	VGSE
requintándole	requintar	VGSE
requintándonos	requintar	VGPE
requintándoos	requintar	VGPE
requintándolo	requintar	VGMSE
requintándola	requintar	VGFSE
requintándolos	requintar	VGMPE
requintándolas	requintar	VGFPE
requintándomelo	requintar	VGMSE
requintándotelo	requintar	VGMSE
requintándoselo	requintar	VGMSE
requintándonoslo	requintar	VGMSE
requintándooslo	requintar	VGMSE
requintándomelos	requintar	VGMPE
requintándotelos	requintar	VGMPE
requintándoselos	requintar	VGMPE
requintándonoslos	requintar	VGMPE
requintándooslos	requintar	VGMPE
requintándomela	requintar	VGFSE
requintándotela	requintar	VGFSE
requintándosela	requintar	VGFSE
requintándonosla	requintar	VGFSE
requintándoosla	requintar	VGFSE
requintándomelas	requintar	VGFPE
requintándotelas	requintar	VGFPE
requintándoselas	requintar	VGFPE
requintándonoslas	requintar	VGFPE
requintándooslas	requintar	VGFPE
requintear	requintear	O
requinteo	requintear	VIP1
requinteas	requintear	VIP2
requintea	requintear	VIP3
requinteamos	requintear	VIP4
requinteáis	requintear	VIP5
requintean	requintear	VIP6
requinteaba	requintear	VII1
requinteabas	requintear	VII2
requinteábamos	requintear	VII4
requinteabais	requintear	VII5
requinteaban	requintear	VII6
requintearé	requintear	VIF1
requintearás	requintear	VIF2
requinteará	requintear	VIF3
requintearemos	requintear	VIF4
requintearéis	requintear	VIF5
requintearán	requintear	VIF6
requintearía	requintear	VIC1
requintearías	requintear	VIC2
requintearía	requintear	VIC3
requintearíamos	requintear	VIC4
requintearíais	requintear	VIC5
requintearían	requintear	VIC6
requinteé	requintear	VIX1
requinteaste	requintear	VIX2
requinteó	requintear	VIX3
requinteasteis	requintear	VIX5
requintearon	requintear	VIX6
requintee	requintear	VSP1
requintees	requintear	VSP2
requinteemos	requintear	VSP4
requinteéis	requintear	VSP5
requinteen	requintear	VSP6
requinteara	requintear	VSX1
requintearas	requintear	VSX2
requinteáramos	requintear	VSX4
requintearais	requintear	VSX5
requintearan	requintear	VSX6
requinteare	requintear	VSF1
requinteares	requintear	VSF2
requinteáremos	requintear	VSF4
requinteareis	requintear	VSF5
requintearen	requintear	VSF6
requintease	requintear	VSI1
requinteases	requintear	VSI2
requinteásemos	requintear	VSI4
requinteaseis	requintear	VSI5
requinteasen	requintear	VSI6
requintead	requintear	VMP
requinteadme	requintear	VMSE
requinteadle	requintear	VMSE
requinteadnos	requintear	VMPE
requinteaos	requintear	VMPE
requinteadles	requintear	VMPE
requinteadlo	requintear	VMMSE
requinteadla	requintear	VMFSE
requinteadlos	requintear	VMMPE
requinteadlas	requintear	VMFPE
requinteádmelo	requintear	VMMSE
requinteádselo	requintear	VMMSE
requinteádnoslo	requintear	VMMSE
requinteáoslo	requintear	VMMSE
requinteádmelos	requintear	VMMPE
requinteádselos	requintear	VMMPE
requinteádnoslos	requintear	VMMPE
requinteáoslos	requintear	VMMPE
requinteádmela	requintear	VMFSE
requinteádsela	requintear	VMFSE
requinteádnosla	requintear	VMFSE
requinteáosla	requintear	VMFSE
requinteádmelas	requintear	VMFPE
requinteádselas	requintear	VMFPE
requinteádnoslas	requintear	VMFPE
requinteáoslas	requintear	VMFPE
requinteado	requintear	VPM
requinteados	requintear	VPMP
requinteada	requintear	VPF
requinteadas	requintear	VPFP
requinteando	requintear	VG
requinteándome	requintear	VGSE
requinteándote	requintear	VGSE
requinteándole	requintear	VGSE
requinteándonos	requintear	VGPE
requinteándoos	requintear	VGPE
requinteándolo	requintear	VGMSE
requinteándola	requintear	VGFSE
requinteándolos	requintear	VGMPE
requinteándolas	requintear	VGFPE
requinteándomelo	requintear	VGMSE
requinteándotelo	requintear	VGMSE
requinteándoselo	requintear	VGMSE
requinteándonoslo	requintear	VGMSE
requinteándooslo	requintear	VGMSE
requinteándomelos	requintear	VGMPE
requinteándotelos	requintear	VGMPE
requinteándoselos	requintear	VGMPE
requinteándonoslos	requintear	VGMPE
requinteándooslos	requintear	VGMPE
requinteándomela	requintear	VGFSE
requinteándotela	requintear	VGFSE
requinteándosela	requintear	VGFSE
requinteándonosla	requintear	VGFSE
requinteándoosla	requintear	VGFSE
requinteándomelas	requintear	VGFPE
requinteándotelas	requintear	VGFPE
requinteándoselas	requintear	VGFPE
requinteándonoslas	requintear	VGFPE
requinteándooslas	requintear	VGFPE
requisar	requisar	O
requiso	requisar	VIP1
requisas	requisar	VIP2
requisa	requisar	VIP3
requisamos	requisar	VIP4
requisáis	requisar	VIP5
requisan	requisar	VIP6
requisaba	requisar	VII1
requisabas	requisar	VII2
requisábamos	requisar	VII4
requisabais	requisar	VII5
requisaban	requisar	VII6
requisaré	requisar	VIF1
requisarás	requisar	VIF2
requisará	requisar	VIF3
requisaremos	requisar	VIF4
requisaréis	requisar	VIF5
requisarán	requisar	VIF6
requisaría	requisar	VIC1
requisarías	requisar	VIC2
requisaría	requisar	VIC3
requisaríamos	requisar	VIC4
requisaríais	requisar	VIC5
requisarían	requisar	VIC6
requisé	requisar	VIX1
requisaste	requisar	VIX2
requisó	requisar	VIX3
requisasteis	requisar	VIX5
requisaron	requisar	VIX6
requise	requisar	VSP1
requises	requisar	VSP2
requisemos	requisar	VSP4
requiséis	requisar	VSP5
requisen	requisar	VSP6
requisara	requisar	VSX1
requisaras	requisar	VSX2
requisáramos	requisar	VSX4
requisarais	requisar	VSX5
requisaran	requisar	VSX6
requisare	requisar	VSF1
requisares	requisar	VSF2
requisáremos	requisar	VSF4
requisareis	requisar	VSF5
requisaren	requisar	VSF6
requisase	requisar	VSI1
requisases	requisar	VSI2
requisásemos	requisar	VSI4
requisaseis	requisar	VSI5
requisasen	requisar	VSI6
requisad	requisar	VMP
requisadme	requisar	VMSE
requisadle	requisar	VMSE
requisadnos	requisar	VMPE
requisaos	requisar	VMPE
requisadles	requisar	VMPE
requisadlo	requisar	VMMSE
requisadla	requisar	VMFSE
requisadlos	requisar	VMMPE
requisadlas	requisar	VMFPE
requisádmelo	requisar	VMMSE
requisádselo	requisar	VMMSE
requisádnoslo	requisar	VMMSE
requisáoslo	requisar	VMMSE
requisádmelos	requisar	VMMPE
requisádselos	requisar	VMMPE
requisádnoslos	requisar	VMMPE
requisáoslos	requisar	VMMPE
requisádmela	requisar	VMFSE
requisádsela	requisar	VMFSE
requisádnosla	requisar	VMFSE
requisáosla	requisar	VMFSE
requisádmelas	requisar	VMFPE
requisádselas	requisar	VMFPE
requisádnoslas	requisar	VMFPE
requisáoslas	requisar	VMFPE
requisado	requisar	VPM
requisados	requisar	VPMP
requisada	requisar	VPF
requisadas	requisar	VPFP
requisando	requisar	VG
requisándome	requisar	VGSE
requisándote	requisar	VGSE
requisándole	requisar	VGSE
requisándonos	requisar	VGPE
requisándoos	requisar	VGPE
requisándolo	requisar	VGMSE
requisándola	requisar	VGFSE
requisándolos	requisar	VGMPE
requisándolas	requisar	VGFPE
requisándomelo	requisar	VGMSE
requisándotelo	requisar	VGMSE
requisándoselo	requisar	VGMSE
requisándonoslo	requisar	VGMSE
requisándooslo	requisar	VGMSE
requisándomelos	requisar	VGMPE
requisándotelos	requisar	VGMPE
requisándoselos	requisar	VGMPE
requisándonoslos	requisar	VGMPE
requisándooslos	requisar	VGMPE
requisándomela	requisar	VGFSE
requisándotela	requisar	VGFSE
requisándosela	requisar	VGFSE
requisándonosla	requisar	VGFSE
requisándoosla	requisar	VGFSE
requisándomelas	requisar	VGFPE
requisándotelas	requisar	VGFPE
requisándoselas	requisar	VGFPE
requisándonoslas	requisar	VGFPE
requisándooslas	requisar	VGFPE
