reedición	reedición	O
reediciones	reedición	P
reedificación	reedificación	O
reedificaciones	reedificación	P
reedificador	reedificador	O
reedificadoras	reedificador	FP
reedificadora	reedificador	F
reedificadores	reedificador	P
reeducación	reeducación	O
reeducaciones	reeducación	P
reelección	reelección	O
reelecciones	reelección	P
reelecto	reelecto	O
reelectas	reelecto	FP
reelecta	reelecto	F
reelegible	reelegible	O
reelegibles	reelegible	P
reembarque	reembarque	O
reembarques	reembarque	P
reembolsable	reembolsable	O
reembolsables	reembolsable	P
reembolso	reembolso	O
reembolsos	reembolso	P
reemplazable	reemplazable	O
reemplazables	reemplazable	P
reemplazante	reemplazante	O
reemplazantes	reemplazante	P
reemplazo	reemplazo	O
reemplazos	reemplazo	P
reencarnación	reencarnación	O
reencarnaciones	reencarnación	P
reencauchadora	reencauchadora	O
reencauchadoras	reencauchadora	P
reencauche	reencauche	O
reencauches	reencauche	P
reencuadernación	reencuadernación	O
reencuadernaciones	reencuadernación	P
reencuentro	reencuentro	O
reencuentros	reencuentro	P
reenganchamiento	reenganchamiento	O
reenganchamientos	reenganchamiento	P
reenganche	reenganche	O
reenganches	reenganche	P
reengendrador	reengendrador	O
reengendradoras	reengendrador	FP
reengendradora	reengendrador	F
reengendradores	reengendrador	P
reensaye	reensaye	O
reensayes	reensaye	P
reensayo	reensayo	O
reensayos	reensayo	P
reenvite	reenvite	O
reenvites	reenvite	P
reenvío	reenvío	O
reenvíos	reenvío	P
reestreno	reestreno	O
reestrenos	reestreno	P
reestructuración	reestructuración	O
reestructuraciones	reestructuración	P
reexaminación	reexaminación	O
reexaminaciones	reexaminación	P
reexpedición	reexpedición	O
reexpediciones	reexpedición	P
reelegir	reelegir	O
reeligo	reelegir	VIP1
reeliges	reelegir	VIP2
reelige	reelegir	VIP3
reelegimos	reelegir	VIP4
reelegís	reelegir	VIP5
reeligen	reelegir	VIP6
reelegía	reelegir	VII1
reelegías	reelegir	VII2
reelegíamos	reelegir	VII4
reelegíais	reelegir	VII5
reelegían	reelegir	VII6
reelegiré	reelegir	VIF1
reelegirás	reelegir	VIF2
reelegirá	reelegir	VIF3
reelegiremos	reelegir	VIF4
reelegiréis	reelegir	VIF5
reelegirán	reelegir	VIF6
reelegiría	reelegir	VIC1
reelegirías	reelegir	VIC2
reelegiría	reelegir	VIC3
reelegiríamos	reelegir	VIC4
reelegiríais	reelegir	VIC5
reelegirían	reelegir	VIC6
reelegí	reelegir	VIX1
reelegíste	reelegir	VIX2
reeligió	reelegir	VIX3
reelegisteis	reelegir	VIX5
reeligieron	reelegir	VIX6
reeliga	reelegir	VSP1
reeligas	reelegir	VSP2
reeligamos	reelegir	VSP4
reeligáis	reelegir	VSP5
reeligan	reelegir	VSP6
reeligiera	reelegir	VSX1
reeligieras	reelegir	VSX2
reeligiéramos	reelegir	VSX4
reeligierais	reelegir	VSX5
reeligieran	reelegir	VSX6
reeligiere	reelegir	VSF1
reeligieres	reelegir	VSF2
reeligiéremos	reelegir	VSF4
reeligiereis	reelegir	VSF5
reeligieren	reelegir	VSF6
reeligiese	reelegir	VSI1
reeligieses	reelegir	VSI2
reeligiésemos	reelegir	VSI4
reeligieseis	reelegir	VSI5
reeligiesen	reelegir	VSI6
reelegid	reelegir	VMP
reelegidme	reelegir	VMSE
reelegidle	reelegir	VMSE
reelegidnos	reelegir	VMPE
reelegios	reelegir	VMPE
reelegidles	reelegir	VMPE
reelegidlo	reelegir	VMMSE
reelegidla	reelegir	VMFSE
reelegidlos	reelegir	VMMPE
reelegidlas	reelegir	VMFPE
reelegídmelo	reelegir	VMMSE
reelegídselo	reelegir	VMMSE
reelegídnoslo	reelegir	VMMSE
reelegíoslo	reelegir	VMMSE
reelegídmelos	reelegir	VMMPE
reelegídselos	reelegir	VMMPE
reelegídnoslos	reelegir	VMMPE
reelegíoslos	reelegir	VMMPE
reelegídmela	reelegir	VMFSE
reelegídsela	reelegir	VMFSE
reelegídnosla	reelegir	VMFSE
reelegíosla	reelegir	VMFSE
reelegídmelas	reelegir	VMFPE
reelegídselas	reelegir	VMFPE
reelegídnoslas	reelegir	VMFPE
reelegíoslas	reelegir	VMFPE
reelegido	reelegir	VPM
reelegidos	reelegir	VPMP
reelegida	reelegir	VPF
reelegidas	reelegir	VPFP
reeligiendo	reelegir	VG
reeligiéndome	reelegir	VGSE
reeligiéndote	reelegir	VGSE
reeligiéndole	reelegir	VGSE
reeligiéndonos	reelegir	VGPE
reeligiéndoos	reelegir	VGPE
reeligiéndolo	reelegir	VGMSE
reeligiéndola	reelegir	VGFSE
reeligiéndolos	reelegir	VGMPE
reeligiéndolas	reelegir	VGFPE
reeligiéndomelo	reelegir	VGMSE
reeligiéndotelo	reelegir	VGMSE
reeligiéndoselo	reelegir	VGMSE
reeligiéndonoslo	reelegir	VGMSE
reeligiéndooslo	reelegir	VGMSE
reeligiéndomelos	reelegir	VGMPE
reeligiéndotelos	reelegir	VGMPE
reeligiéndoselos	reelegir	VGMPE
reeligiéndonoslos	reelegir	VGMPE
reeligiéndooslos	reelegir	VGMPE
reeligiéndomela	reelegir	VGFSE
reeligiéndotela	reelegir	VGFSE
reeligiéndosela	reelegir	VGFSE
reeligiéndonosla	reelegir	VGFSE
reeligiéndoosla	reelegir	VGFSE
reeligiéndomelas	reelegir	VGFPE
reeligiéndotelas	reelegir	VGFPE
reeligiéndoselas	reelegir	VGFPE
reeligiéndonoslas	reelegir	VGFPE
reeligiéndooslas	reelegir	VGFPE
reescribir	reescribir	O
reescribo	reescribir	VIP1
reescribes	reescribir	VIP2
reescribe	reescribir	VIP3
reescribimos	reescribir	VIP4
reescribís	reescribir	VIP5
reescriben	reescribir	VIP6
reescribía	reescribir	VII1
reescribías	reescribir	VII2
reescribíamos	reescribir	VII4
reescribíais	reescribir	VII5
reescribían	reescribir	VII6
reescribiré	reescribir	VIF1
reescribirás	reescribir	VIF2
reescribirá	reescribir	VIF3
reescribiremos	reescribir	VIF4
reescribiréis	reescribir	VIF5
reescribirán	reescribir	VIF6
reescribiría	reescribir	VIC1
reescribirías	reescribir	VIC2
reescribiría	reescribir	VIC3
reescribiríamos	reescribir	VIC4
reescribiríais	reescribir	VIC5
reescribirían	reescribir	VIC6
reescribí	reescribir	VIX1
reescribiste	reescribir	VIX2
reescribió	reescribir	VIX3
reescribisteis	reescribir	VIX5
reescribieron	reescribir	VIX6
reescriba	reescribir	VSP1
reescribas	reescribir	VSP2
reescribamos	reescribir	VSP4
reescribáis	reescribir	VSP5
reescriban	reescribir	VSP6
reescribiera	reescribir	VSX1
reescribieras	reescribir	VSX2
reescribiéramos	reescribir	VSX4
reescribierais	reescribir	VSX5
reescribieran	reescribir	VSX6
reescribiere	reescribir	VSF1
reescribieres	reescribir	VSF2
reescribiéremos	reescribir	VSF4
reescribiereis	reescribir	VSF5
reescribieren	reescribir	VSF6
reescribiese	reescribir	VSI1
reescribieses	reescribir	VSI2
reescribiésemos	reescribir	VSI4
reescribieseis	reescribir	VSI5
reescribiesen	reescribir	VSI6
reescribid	reescribir	VMP
reescribidme	reescribir	VMSE
reescribidle	reescribir	VMSE
reescribidnos	reescribir	VMPE
reescribios	reescribir	VMPE
reescribidles	reescribir	VMPE
reescribidlo	reescribir	VMMSE
reescribidla	reescribir	VMFSE
reescribidlos	reescribir	VMMPE
reescribidlas	reescribir	VMFPE
reescribídmelo	reescribir	VMMSE
reescribídselo	reescribir	VMMSE
reescribídnoslo	reescribir	VMMSE
reescribíoslo	reescribir	VMMSE
reescribídmelos	reescribir	VMMPE
reescribídselos	reescribir	VMMPE
reescribídnoslos	reescribir	VMMPE
reescribíoslos	reescribir	VMMPE
reescribídmela	reescribir	VMFSE
reescribídsela	reescribir	VMFSE
reescribídnosla	reescribir	VMFSE
reescribíosla	reescribir	VMFSE
reescribídmelas	reescribir	VMFPE
reescribídselas	reescribir	VMFPE
reescribídnoslas	reescribir	VMFPE
reescribíoslas	reescribir	VMFPE
reescrito	reescribir	VPMS
reescritos	reescribir	VPMP
reescrita	reescribir	VPFS
reescritas	reescribir	VFP
reescribiendo	reescribir	VG
reescribiéndome	reescribir	VGSE
reescribiéndote	reescribir	VGSE
reescribiéndole	reescribir	VGSE
reescribiéndonos	reescribir	VGPE
reescribiéndoos	reescribir	VGPE
reescribiéndolo	reescribir	VGMSE
reescribiéndola	reescribir	VGFSE
reescribiéndolos	reescribir	VGMPE
reescribiéndolas	reescribir	VGFPE
reescribiéndomelo	reescribir	VGMSE
reescribiéndotelo	reescribir	VGMSE
reescribiéndoselo	reescribir	VGMSE
reescribiéndonoslo	reescribir	VGMSE
reescribiéndooslo	reescribir	VGMSE
reescribiéndomelos	reescribir	VGMPE
reescribiéndotelos	reescribir	VGMPE
reescribiéndoselos	reescribir	VGMPE
reescribiéndonoslos	reescribir	VGMPE
reescribiéndooslos	reescribir	VGMPE
reescribiéndomela	reescribir	VGFSE
reescribiéndotela	reescribir	VGFSE
reescribiéndosela	reescribir	VGFSE
reescribiéndonosla	reescribir	VGFSE
reescribiéndoosla	reescribir	VGFSE
reescribiéndomelas	reescribir	VGFPE
reescribiéndotelas	reescribir	VGFPE
reescribiéndoselas	reescribir	VGFPE
reescribiéndonoslas	reescribir	VGFPE
reescribiéndooslas	reescribir	VGFPE
reexpedir	reexpedir	O
reexpido	reexpedir	VIP1
reexpides	reexpedir	VIP2
reexpide	reexpedir	VIP3
reexpedimos	reexpedir	VIP4
reexpedís	reexpedir	VIP5
reexpiden	reexpedir	VIP6
reexpedía	reexpedir	VII1
reexpedías	reexpedir	VII2
reexpedíamos	reexpedir	VII4
reexpedíais	reexpedir	VII5
reexpedían	reexpedir	VII6
reexpediré	reexpedir	VIF1
reexpedirás	reexpedir	VIF2
reexpedirá	reexpedir	VIF3
reexpediremos	reexpedir	VIF4
reexpediréis	reexpedir	VIF5
reexpedirán	reexpedir	VIF6
reexpediría	reexpedir	VIC1
reexpedirías	reexpedir	VIC2
reexpediría	reexpedir	VIC3
reexpediríamos	reexpedir	VIC4
reexpediríais	reexpedir	VIC5
reexpedirían	reexpedir	VIC6
reexpedí	reexpedir	VIX1
reexpediste	reexpedir	VIX2
reexpidió	reexpedir	VIX3
reexpedisteis	reexpedir	VIX5
reexpidieron	reexpedir	VIX6
reexpida	reexpedir	VSP1
reexpidas	reexpedir	VSP2
reexpidamos	reexpedir	VSP4
reexpidáis	reexpedir	VSP5
reexpidan	reexpedir	VSP6
reexpidiera	reexpedir	VSX1
reexpidieras	reexpedir	VSX2
reexpidiéramos	reexpedir	VSX4
reexpidierais	reexpedir	VSX5
reexpidieran	reexpedir	VSX6
reexpidiere	reexpedir	VSF1
reexpidieres	reexpedir	VSF2
reexpidiéremos	reexpedir	VSF4
reexpidiereis	reexpedir	VSF5
reexpidieren	reexpedir	VSF6
reexpidiese	reexpedir	VSI1
reexpidieses	reexpedir	VSI2
reexpidiésemos	reexpedir	VSI4
reexpidieseis	reexpedir	VSI5
reexpidiesen	reexpedir	VSI6
reexpedid	reexpedir	VMP
reexpedidme	reexpedir	VMSE
reexpedidle	reexpedir	VMSE
reexpedidnos	reexpedir	VMPE
reexpedios	reexpedir	VMPE
reexpedidles	reexpedir	VMPE
reexpedidlo	reexpedir	VMMSE
reexpedidla	reexpedir	VMFSE
reexpedidlos	reexpedir	VMMPE
reexpedidlas	reexpedir	VMFPE
reexpedídmelo	reexpedir	VMMSE
reexpedídselo	reexpedir	VMMSE
reexpedídnoslo	reexpedir	VMMSE
reexpedíoslo	reexpedir	VMMSE
reexpedídmelos	reexpedir	VMMPE
reexpedídselos	reexpedir	VMMPE
reexpedídnoslos	reexpedir	VMMPE
reexpedíoslos	reexpedir	VMMPE
reexpedídmela	reexpedir	VMFSE
reexpedídsela	reexpedir	VMFSE
reexpedídnosla	reexpedir	VMFSE
reexpedíosla	reexpedir	VMFSE
reexpedídmelas	reexpedir	VMFPE
reexpedídselas	reexpedir	VMFPE
reexpedídnoslas	reexpedir	VMFPE
reexpedíoslas	reexpedir	VMFPE
reexpedido	reexpedir	VPM
reexpedidos	reexpedir	VPMP
reexpedida	reexpedir	VPF
reexpedidas	reexpedir	VPFP
reexpidiendo	reexpedir	VG
reexpidiéndome	reexpedir	VGSE
reexpidiéndote	reexpedir	VGSE
reexpidiéndole	reexpedir	VGSE
reexpidiéndonos	reexpedir	VGPE
reexpidiéndoos	reexpedir	VGPE
reexpidiéndolo	reexpedir	VGMSE
reexpidiéndola	reexpedir	VGFSE
reexpidiéndolos	reexpedir	VGMPE
reexpidiéndolas	reexpedir	VGFPE
reexpidiéndomelo	reexpedir	VGMSE
reexpidiéndotelo	reexpedir	VGMSE
reexpidiéndoselo	reexpedir	VGMSE
reexpidiéndonoslo	reexpedir	VGMSE
reexpidiéndooslo	reexpedir	VGMSE
reexpidiéndomelos	reexpedir	VGMPE
reexpidiéndotelos	reexpedir	VGMPE
reexpidiéndoselos	reexpedir	VGMPE
reexpidiéndonoslos	reexpedir	VGMPE
reexpidiéndooslos	reexpedir	VGMPE
reexpidiéndomela	reexpedir	VGFSE
reexpidiéndotela	reexpedir	VGFSE
reexpidiéndosela	reexpedir	VGFSE
reexpidiéndonosla	reexpedir	VGFSE
reexpidiéndoosla	reexpedir	VGFSE
reexpidiéndomelas	reexpedir	VGFPE
reexpidiéndotelas	reexpedir	VGFPE
reexpidiéndoselas	reexpedir	VGFPE
reexpidiéndonoslas	reexpedir	VGFPE
reexpidiéndooslas	reexpedir	VGFPE
reemprender	reemprender	O
reemprendo	reemprender	VIP1
reemprendes	reemprender	VIP2
reemprende	reemprender	VIP3
reemprendemos	reemprender	VIP4
reemprendéis	reemprender	VIP5
reemprenden	reemprender	VIP6
reemprendía	reemprender	VII1
reemprendías	reemprender	VII2
reemprendíamos	reemprender	VII4
reemprendíais	reemprender	VII5
reemprendían	reemprender	VII6
reemprenderé	reemprender	VIF1
reemprenderás	reemprender	VIF2
reemprenderá	reemprender	VIF3
reemprenderemos	reemprender	VIF4
reemprenderéis	reemprender	VIF5
reemprenderán	reemprender	VIF6
reemprendería	reemprender	VIC1
reemprenderías	reemprender	VIC2
reemprendería	reemprender	VIC3
reemprenderíamos	reemprender	VIC4
reemprenderíais	reemprender	VIC5
reemprenderían	reemprender	VIC6
reemprendí	reemprender	VIX1
reemprendiste	reemprender	VIX2
reemprendió	reemprender	VIX3
reemprendisteis	reemprender	VIX5
reemprendieron	reemprender	VIX6
reemprenda	reemprender	VSP1
reemprendas	reemprender	VSP2
reemprendamos	reemprender	VSP4
reemprendáis	reemprender	VSP5
reemprendan	reemprender	VSP6
reemprendiera	reemprender	VSX1
reemprendieras	reemprender	VSX2
reemprendiéramos	reemprender	VSX4
reemprendierais	reemprender	VSX5
reemprendieran	reemprender	VSX6
reemprendiere	reemprender	VSF1
reemprendieres	reemprender	VSF2
reemprendiéremos	reemprender	VSF4
reemprendiereis	reemprender	VSF5
reemprendieren	reemprender	VSF6
reemprendiese	reemprender	VSI1
reemprendieses	reemprender	VSI2
reemprendiésemos	reemprender	VSI4
reemprendieseis	reemprender	VSI5
reemprendiesen	reemprender	VSI6
reemprended	reemprender	VMP
reemprendedme	reemprender	VMSE
reemprendedle	reemprender	VMSE
reemprendednos	reemprender	VMPE
reemprendeos	reemprender	VMPE
reemprendedles	reemprender	VMPE
reemprendedlo	reemprender	VMMSE
reemprendedla	reemprender	VMFSE
reemprendedlos	reemprender	VMMPE
reemprendedlas	reemprender	VMFPE
reemprendédmelo	reemprender	VMMSE
reemprendédselo	reemprender	VMMSE
reemprendédnoslo	reemprender	VMMSE
reemprendéoslo	reemprender	VMMSE
reemprendédmelos	reemprender	VMMPE
reemprendédselos	reemprender	VMMPE
reemprendédnoslos	reemprender	VMMPE
reemprendéoslos	reemprender	VMMPE
reemprendédmela	reemprender	VMFSE
reemprendédsela	reemprender	VMFSE
reemprendédnosla	reemprender	VMFSE
reemprendéosla	reemprender	VMFSE
reemprendédmelas	reemprender	VMFPE
reemprendédselas	reemprender	VMFPE
reemprendédnoslas	reemprender	VMFPE
reemprendéoslas	reemprender	VMFPE
reemprendido	reemprender	VPM
reemprendidos	reemprender	VPMP
reemprendida	reemprender	VPF
reemprendidas	reemprender	VPFP
reemprendiendo	reemprender	VG
reemprendiéndome	reemprender	VGSE
reemprendiéndote	reemprender	VGSE
reemprendiéndole	reemprender	VGSE
reemprendiéndonos	reemprender	VGPE
reemprendiéndoos	reemprender	VGPE
reemprendiéndolo	reemprender	VGMSE
reemprendiéndola	reemprender	VGFSE
reemprendiéndolos	reemprender	VGMPE
reemprendiéndolas	reemprender	VGFPE
reemprendiéndomelo	reemprender	VGMSE
reemprendiéndotelo	reemprender	VGMSE
reemprendiéndoselo	reemprender	VGMSE
reemprendiéndonoslo	reemprender	VGMSE
reemprendiéndooslo	reemprender	VGMSE
reemprendiéndomelos	reemprender	VGMPE
reemprendiéndotelos	reemprender	VGMPE
reemprendiéndoselos	reemprender	VGMPE
reemprendiéndonoslos	reemprender	VGMPE
reemprendiéndooslos	reemprender	VGMPE
reemprendiéndomela	reemprender	VGFSE
reemprendiéndotela	reemprender	VGFSE
reemprendiéndosela	reemprender	VGFSE
reemprendiéndonosla	reemprender	VGFSE
reemprendiéndoosla	reemprender	VGFSE
reemprendiéndomelas	reemprender	VGFPE
reemprendiéndotelas	reemprender	VGFPE
reemprendiéndoselas	reemprender	VGFPE
reemprendiéndonoslas	reemprender	VGFPE
reemprendiéndooslas	reemprender	VGFPE
reedificar	reedificar	O
reedifico	reedificar	VIP1
reedificas	reedificar	VIP2
reedifica	reedificar	VIP3
reedificamos	reedificar	VIP4
reedificáis	reedificar	VIP5
reedifican	reedificar	VIP6
reedificaba	reedificar	VII1
reedificabas	reedificar	VII2
reedificábamos	reedificar	VII4
reedificabais	reedificar	VII5
reedificaban	reedificar	VII6
reedificaré	reedificar	VIF1
reedificarás	reedificar	VIF2
reedificará	reedificar	VIF3
reedificaremos	reedificar	VIF4
reedificaréis	reedificar	VIF5
reedificarán	reedificar	VIF6
reedificaría	reedificar	VIC1
reedificarías	reedificar	VIC2
reedificaría	reedificar	VIC3
reedificaríamos	reedificar	VIC4
reedificaríais	reedificar	VIC5
reedificarían	reedificar	VIC6
reedifiqué	reedificar	VIX1
reedificaste	reedificar	VIX2
reedificó	reedificar	VIX3
reedificasteis	reedificar	VIX5
reedificaron	reedificar	VIX6
reedifique	reedificar	VSP1
reedifiques	reedificar	VSP2
reedifiquemos	reedificar	VSP4
reedifiquéis	reedificar	VSP5
reedifiquen	reedificar	VSP6
reedificara	reedificar	VSX1
reedificaras	reedificar	VSX2
reedificáramos	reedificar	VSX4
reedificarais	reedificar	VSX5
reedificaran	reedificar	VSX6
reedificare	reedificar	VSF1
reedificares	reedificar	VSF2
reedificáremos	reedificar	VSF4
reedificareis	reedificar	VSF5
reedificaren	reedificar	VSF6
reedificase	reedificar	VSI1
reedificases	reedificar	VSI2
reedificásemos	reedificar	VSI4
reedificaseis	reedificar	VSI5
reedificasen	reedificar	VSI6
reedificad	reedificar	VMP
reedificadme	reedificar	VMSE
reedificadle	reedificar	VMSE
reedificadnos	reedificar	VMPE
reedificaos	reedificar	VMPE
reedificadles	reedificar	VMPE
reedificadlo	reedificar	VMMSE
reedificadla	reedificar	VMFSE
reedificadlos	reedificar	VMMPE
reedificadlas	reedificar	VMFPE
reedificádmelo	reedificar	VMMSE
reedificádselo	reedificar	VMMSE
reedificádnoslo	reedificar	VMMSE
reedificáoslo	reedificar	VMMSE
reedificádmelos	reedificar	VMMPE
reedificádselos	reedificar	VMMPE
reedificádnoslos	reedificar	VMMPE
reedificáoslos	reedificar	VMMPE
reedificádmela	reedificar	VMFSE
reedificádsela	reedificar	VMFSE
reedificádnosla	reedificar	VMFSE
reedificáosla	reedificar	VMFSE
reedificádmelas	reedificar	VMFPE
reedificádselas	reedificar	VMFPE
reedificádnoslas	reedificar	VMFPE
reedificáoslas	reedificar	VMFPE
reedificado	reedificar	VPM
reedificados	reedificar	VPMP
reedificada	reedificar	VPF
reedificadas	reedificar	VPFP
reedificando	reedificar	VG
reedificándome	reedificar	VGSE
reedificándote	reedificar	VGSE
reedificándole	reedificar	VGSE
reedificándonos	reedificar	VGPE
reedificándoos	reedificar	VGPE
reedificándolo	reedificar	VGMSE
reedificándola	reedificar	VGFSE
reedificándolos	reedificar	VGMPE
reedificándolas	reedificar	VGFPE
reedificándomelo	reedificar	VGMSE
reedificándotelo	reedificar	VGMSE
reedificándoselo	reedificar	VGMSE
reedificándonoslo	reedificar	VGMSE
reedificándooslo	reedificar	VGMSE
reedificándomelos	reedificar	VGMPE
reedificándotelos	reedificar	VGMPE
reedificándoselos	reedificar	VGMPE
reedificándonoslos	reedificar	VGMPE
reedificándooslos	reedificar	VGMPE
reedificándomela	reedificar	VGFSE
reedificándotela	reedificar	VGFSE
reedificándosela	reedificar	VGFSE
reedificándonosla	reedificar	VGFSE
reedificándoosla	reedificar	VGFSE
reedificándomelas	reedificar	VGFPE
reedificándotelas	reedificar	VGFPE
reedificándoselas	reedificar	VGFPE
reedificándonoslas	reedificar	VGFPE
reedificándooslas	reedificar	VGFPE
reeditar	reeditar	O
reedito	reeditar	VIP1
reeditas	reeditar	VIP2
reedita	reeditar	VIP3
reeditamos	reeditar	VIP4
reeditáis	reeditar	VIP5
reeditan	reeditar	VIP6
reeditaba	reeditar	VII1
reeditabas	reeditar	VII2
reeditábamos	reeditar	VII4
reeditabais	reeditar	VII5
reeditaban	reeditar	VII6
reeditaré	reeditar	VIF1
reeditarás	reeditar	VIF2
reeditará	reeditar	VIF3
reeditaremos	reeditar	VIF4
reeditaréis	reeditar	VIF5
reeditarán	reeditar	VIF6
reeditaría	reeditar	VIC1
reeditarías	reeditar	VIC2
reeditaría	reeditar	VIC3
reeditaríamos	reeditar	VIC4
reeditaríais	reeditar	VIC5
reeditarían	reeditar	VIC6
reedité	reeditar	VIX1
reeditaste	reeditar	VIX2
reeditó	reeditar	VIX3
reeditasteis	reeditar	VIX5
reeditaron	reeditar	VIX6
reedite	reeditar	VSP1
reedites	reeditar	VSP2
reeditemos	reeditar	VSP4
reeditéis	reeditar	VSP5
reediten	reeditar	VSP6
reeditara	reeditar	VSX1
reeditaras	reeditar	VSX2
reeditáramos	reeditar	VSX4
reeditarais	reeditar	VSX5
reeditaran	reeditar	VSX6
reeditare	reeditar	VSF1
reeditares	reeditar	VSF2
reeditáremos	reeditar	VSF4
reeditareis	reeditar	VSF5
reeditaren	reeditar	VSF6
reeditase	reeditar	VSI1
reeditases	reeditar	VSI2
reeditásemos	reeditar	VSI4
reeditaseis	reeditar	VSI5
reeditasen	reeditar	VSI6
reeditad	reeditar	VMP
reeditadme	reeditar	VMSE
reeditadle	reeditar	VMSE
reeditadnos	reeditar	VMPE
reeditaos	reeditar	VMPE
reeditadles	reeditar	VMPE
reeditadlo	reeditar	VMMSE
reeditadla	reeditar	VMFSE
reeditadlos	reeditar	VMMPE
reeditadlas	reeditar	VMFPE
reeditádmelo	reeditar	VMMSE
reeditádselo	reeditar	VMMSE
reeditádnoslo	reeditar	VMMSE
reeditáoslo	reeditar	VMMSE
reeditádmelos	reeditar	VMMPE
reeditádselos	reeditar	VMMPE
reeditádnoslos	reeditar	VMMPE
reeditáoslos	reeditar	VMMPE
reeditádmela	reeditar	VMFSE
reeditádsela	reeditar	VMFSE
reeditádnosla	reeditar	VMFSE
reeditáosla	reeditar	VMFSE
reeditádmelas	reeditar	VMFPE
reeditádselas	reeditar	VMFPE
reeditádnoslas	reeditar	VMFPE
reeditáoslas	reeditar	VMFPE
reeditado	reeditar	VPM
reeditados	reeditar	VPMP
reeditada	reeditar	VPF
reeditadas	reeditar	VPFP
reeditando	reeditar	VG
reeditándome	reeditar	VGSE
reeditándote	reeditar	VGSE
reeditándole	reeditar	VGSE
reeditándonos	reeditar	VGPE
reeditándoos	reeditar	VGPE
reeditándolo	reeditar	VGMSE
reeditándola	reeditar	VGFSE
reeditándolos	reeditar	VGMPE
reeditándolas	reeditar	VGFPE
reeditándomelo	reeditar	VGMSE
reeditándotelo	reeditar	VGMSE
reeditándoselo	reeditar	VGMSE
reeditándonoslo	reeditar	VGMSE
reeditándooslo	reeditar	VGMSE
reeditándomelos	reeditar	VGMPE
reeditándotelos	reeditar	VGMPE
reeditándoselos	reeditar	VGMPE
reeditándonoslos	reeditar	VGMPE
reeditándooslos	reeditar	VGMPE
reeditándomela	reeditar	VGFSE
reeditándotela	reeditar	VGFSE
reeditándosela	reeditar	VGFSE
reeditándonosla	reeditar	VGFSE
reeditándoosla	reeditar	VGFSE
reeditándomelas	reeditar	VGFPE
reeditándotelas	reeditar	VGFPE
reeditándoselas	reeditar	VGFPE
reeditándonoslas	reeditar	VGFPE
reeditándooslas	reeditar	VGFPE
reeducar	reeducar	O
reeduco	reeducar	VIP1
reeducas	reeducar	VIP2
reeduca	reeducar	VIP3
reeducamos	reeducar	VIP4
reeducáis	reeducar	VIP5
reeducan	reeducar	VIP6
reeducaba	reeducar	VII1
reeducabas	reeducar	VII2
reeducábamos	reeducar	VII4
reeducabais	reeducar	VII5
reeducaban	reeducar	VII6
reeducaré	reeducar	VIF1
reeducarás	reeducar	VIF2
reeducará	reeducar	VIF3
reeducaremos	reeducar	VIF4
reeducaréis	reeducar	VIF5
reeducarán	reeducar	VIF6
reeducaría	reeducar	VIC1
reeducarías	reeducar	VIC2
reeducaría	reeducar	VIC3
reeducaríamos	reeducar	VIC4
reeducaríais	reeducar	VIC5
reeducarían	reeducar	VIC6
reeduqué	reeducar	VIX1
reeducaste	reeducar	VIX2
reeducó	reeducar	VIX3
reeducasteis	reeducar	VIX5
reeducaron	reeducar	VIX6
reeduque	reeducar	VSP1
reeduques	reeducar	VSP2
reeduquemos	reeducar	VSP4
reeduquéis	reeducar	VSP5
reeduquen	reeducar	VSP6
reeducara	reeducar	VSX1
reeducaras	reeducar	VSX2
reeducáramos	reeducar	VSX4
reeducarais	reeducar	VSX5
reeducaran	reeducar	VSX6
reeducare	reeducar	VSF1
reeducares	reeducar	VSF2
reeducáremos	reeducar	VSF4
reeducareis	reeducar	VSF5
reeducaren	reeducar	VSF6
reeducase	reeducar	VSI1
reeducases	reeducar	VSI2
reeducásemos	reeducar	VSI4
reeducaseis	reeducar	VSI5
reeducasen	reeducar	VSI6
reeducad	reeducar	VMP
reeducadme	reeducar	VMSE
reeducadle	reeducar	VMSE
reeducadnos	reeducar	VMPE
reeducaos	reeducar	VMPE
reeducadles	reeducar	VMPE
reeducadlo	reeducar	VMMSE
reeducadla	reeducar	VMFSE
reeducadlos	reeducar	VMMPE
reeducadlas	reeducar	VMFPE
reeducádmelo	reeducar	VMMSE
reeducádselo	reeducar	VMMSE
reeducádnoslo	reeducar	VMMSE
reeducáoslo	reeducar	VMMSE
reeducádmelos	reeducar	VMMPE
reeducádselos	reeducar	VMMPE
reeducádnoslos	reeducar	VMMPE
reeducáoslos	reeducar	VMMPE
reeducádmela	reeducar	VMFSE
reeducádsela	reeducar	VMFSE
reeducádnosla	reeducar	VMFSE
reeducáosla	reeducar	VMFSE
reeducádmelas	reeducar	VMFPE
reeducádselas	reeducar	VMFPE
reeducádnoslas	reeducar	VMFPE
reeducáoslas	reeducar	VMFPE
reeducado	reeducar	VPM
reeducados	reeducar	VPMP
reeducada	reeducar	VPF
reeducadas	reeducar	VPFP
reeducando	reeducar	VG
reeducándome	reeducar	VGSE
reeducándote	reeducar	VGSE
reeducándole	reeducar	VGSE
reeducándonos	reeducar	VGPE
reeducándoos	reeducar	VGPE
reeducándolo	reeducar	VGMSE
reeducándola	reeducar	VGFSE
reeducándolos	reeducar	VGMPE
reeducándolas	reeducar	VGFPE
reeducándomelo	reeducar	VGMSE
reeducándotelo	reeducar	VGMSE
reeducándoselo	reeducar	VGMSE
reeducándonoslo	reeducar	VGMSE
reeducándooslo	reeducar	VGMSE
reeducándomelos	reeducar	VGMPE
reeducándotelos	reeducar	VGMPE
reeducándoselos	reeducar	VGMPE
reeducándonoslos	reeducar	VGMPE
reeducándooslos	reeducar	VGMPE
reeducándomela	reeducar	VGFSE
reeducándotela	reeducar	VGFSE
reeducándosela	reeducar	VGFSE
reeducándonosla	reeducar	VGFSE
reeducándoosla	reeducar	VGFSE
reeducándomelas	reeducar	VGFPE
reeducándotelas	reeducar	VGFPE
reeducándoselas	reeducar	VGFPE
reeducándonoslas	reeducar	VGFPE
reeducándooslas	reeducar	VGFPE
reembarcar	reembarcar	O
reembarco	reembarcar	VIP1
reembarcas	reembarcar	VIP2
reembarca	reembarcar	VIP3
reembarcamos	reembarcar	VIP4
reembarcáis	reembarcar	VIP5
reembarcan	reembarcar	VIP6
reembarcaba	reembarcar	VII1
reembarcabas	reembarcar	VII2
reembarcábamos	reembarcar	VII4
reembarcabais	reembarcar	VII5
reembarcaban	reembarcar	VII6
reembarcaré	reembarcar	VIF1
reembarcarás	reembarcar	VIF2
reembarcará	reembarcar	VIF3
reembarcaremos	reembarcar	VIF4
reembarcaréis	reembarcar	VIF5
reembarcarán	reembarcar	VIF6
reembarcaría	reembarcar	VIC1
reembarcarías	reembarcar	VIC2
reembarcaría	reembarcar	VIC3
reembarcaríamos	reembarcar	VIC4
reembarcaríais	reembarcar	VIC5
reembarcarían	reembarcar	VIC6
reembarqué	reembarcar	VIX1
reembarcaste	reembarcar	VIX2
reembarcó	reembarcar	VIX3
reembarcasteis	reembarcar	VIX5
reembarcaron	reembarcar	VIX6
reembarque	reembarcar	VSP1
reembarques	reembarcar	VSP2
reembarquemos	reembarcar	VSP4
reembarquéis	reembarcar	VSP5
reembarquen	reembarcar	VSP6
reembarcara	reembarcar	VSX1
reembarcaras	reembarcar	VSX2
reembarcáramos	reembarcar	VSX4
reembarcarais	reembarcar	VSX5
reembarcaran	reembarcar	VSX6
reembarcare	reembarcar	VSF1
reembarcares	reembarcar	VSF2
reembarcáremos	reembarcar	VSF4
reembarcareis	reembarcar	VSF5
reembarcaren	reembarcar	VSF6
reembarcase	reembarcar	VSI1
reembarcases	reembarcar	VSI2
reembarcásemos	reembarcar	VSI4
reembarcaseis	reembarcar	VSI5
reembarcasen	reembarcar	VSI6
reembarcad	reembarcar	VMP
reembarcadme	reembarcar	VMSE
reembarcadle	reembarcar	VMSE
reembarcadnos	reembarcar	VMPE
reembarcaos	reembarcar	VMPE
reembarcadles	reembarcar	VMPE
reembarcadlo	reembarcar	VMMSE
reembarcadla	reembarcar	VMFSE
reembarcadlos	reembarcar	VMMPE
reembarcadlas	reembarcar	VMFPE
reembarcádmelo	reembarcar	VMMSE
reembarcádselo	reembarcar	VMMSE
reembarcádnoslo	reembarcar	VMMSE
reembarcáoslo	reembarcar	VMMSE
reembarcádmelos	reembarcar	VMMPE
reembarcádselos	reembarcar	VMMPE
reembarcádnoslos	reembarcar	VMMPE
reembarcáoslos	reembarcar	VMMPE
reembarcádmela	reembarcar	VMFSE
reembarcádsela	reembarcar	VMFSE
reembarcádnosla	reembarcar	VMFSE
reembarcáosla	reembarcar	VMFSE
reembarcádmelas	reembarcar	VMFPE
reembarcádselas	reembarcar	VMFPE
reembarcádnoslas	reembarcar	VMFPE
reembarcáoslas	reembarcar	VMFPE
reembarcado	reembarcar	VPM
reembarcados	reembarcar	VPMP
reembarcada	reembarcar	VPF
reembarcadas	reembarcar	VPFP
reembarcando	reembarcar	VG
reembarcándome	reembarcar	VGSE
reembarcándote	reembarcar	VGSE
reembarcándole	reembarcar	VGSE
reembarcándonos	reembarcar	VGPE
reembarcándoos	reembarcar	VGPE
reembarcándolo	reembarcar	VGMSE
reembarcándola	reembarcar	VGFSE
reembarcándolos	reembarcar	VGMPE
reembarcándolas	reembarcar	VGFPE
reembarcándomelo	reembarcar	VGMSE
reembarcándotelo	reembarcar	VGMSE
reembarcándoselo	reembarcar	VGMSE
reembarcándonoslo	reembarcar	VGMSE
reembarcándooslo	reembarcar	VGMSE
reembarcándomelos	reembarcar	VGMPE
reembarcándotelos	reembarcar	VGMPE
reembarcándoselos	reembarcar	VGMPE
reembarcándonoslos	reembarcar	VGMPE
reembarcándooslos	reembarcar	VGMPE
reembarcándomela	reembarcar	VGFSE
reembarcándotela	reembarcar	VGFSE
reembarcándosela	reembarcar	VGFSE
reembarcándonosla	reembarcar	VGFSE
reembarcándoosla	reembarcar	VGFSE
reembarcándomelas	reembarcar	VGFPE
reembarcándotelas	reembarcar	VGFPE
reembarcándoselas	reembarcar	VGFPE
reembarcándonoslas	reembarcar	VGFPE
reembarcándooslas	reembarcar	VGFPE
reembolsar	reembolsar	O
reembolso	reembolsar	VIP1
reembolsas	reembolsar	VIP2
reembolsa	reembolsar	VIP3
reembolsamos	reembolsar	VIP4
reembolsáis	reembolsar	VIP5
reembolsan	reembolsar	VIP6
reembolsaba	reembolsar	VII1
reembolsabas	reembolsar	VII2
reembolsábamos	reembolsar	VII4
reembolsabais	reembolsar	VII5
reembolsaban	reembolsar	VII6
reembolsaré	reembolsar	VIF1
reembolsarás	reembolsar	VIF2
reembolsará	reembolsar	VIF3
reembolsaremos	reembolsar	VIF4
reembolsaréis	reembolsar	VIF5
reembolsarán	reembolsar	VIF6
reembolsaría	reembolsar	VIC1
reembolsarías	reembolsar	VIC2
reembolsaría	reembolsar	VIC3
reembolsaríamos	reembolsar	VIC4
reembolsaríais	reembolsar	VIC5
reembolsarían	reembolsar	VIC6
reembolsé	reembolsar	VIX1
reembolsaste	reembolsar	VIX2
reembolsó	reembolsar	VIX3
reembolsasteis	reembolsar	VIX5
reembolsaron	reembolsar	VIX6
reembolse	reembolsar	VSP1
reembolses	reembolsar	VSP2
reembolsemos	reembolsar	VSP4
reembolséis	reembolsar	VSP5
reembolsen	reembolsar	VSP6
reembolsara	reembolsar	VSX1
reembolsaras	reembolsar	VSX2
reembolsáramos	reembolsar	VSX4
reembolsarais	reembolsar	VSX5
reembolsaran	reembolsar	VSX6
reembolsare	reembolsar	VSF1
reembolsares	reembolsar	VSF2
reembolsáremos	reembolsar	VSF4
reembolsareis	reembolsar	VSF5
reembolsaren	reembolsar	VSF6
reembolsase	reembolsar	VSI1
reembolsases	reembolsar	VSI2
reembolsásemos	reembolsar	VSI4
reembolsaseis	reembolsar	VSI5
reembolsasen	reembolsar	VSI6
reembolsad	reembolsar	VMP
reembolsadme	reembolsar	VMSE
reembolsadle	reembolsar	VMSE
reembolsadnos	reembolsar	VMPE
reembolsaos	reembolsar	VMPE
reembolsadles	reembolsar	VMPE
reembolsadlo	reembolsar	VMMSE
reembolsadla	reembolsar	VMFSE
reembolsadlos	reembolsar	VMMPE
reembolsadlas	reembolsar	VMFPE
reembolsádmelo	reembolsar	VMMSE
reembolsádselo	reembolsar	VMMSE
reembolsádnoslo	reembolsar	VMMSE
reembolsáoslo	reembolsar	VMMSE
reembolsádmelos	reembolsar	VMMPE
reembolsádselos	reembolsar	VMMPE
reembolsádnoslos	reembolsar	VMMPE
reembolsáoslos	reembolsar	VMMPE
reembolsádmela	reembolsar	VMFSE
reembolsádsela	reembolsar	VMFSE
reembolsádnosla	reembolsar	VMFSE
reembolsáosla	reembolsar	VMFSE
reembolsádmelas	reembolsar	VMFPE
reembolsádselas	reembolsar	VMFPE
reembolsádnoslas	reembolsar	VMFPE
reembolsáoslas	reembolsar	VMFPE
reembolsado	reembolsar	VPM
reembolsados	reembolsar	VPMP
reembolsada	reembolsar	VPF
reembolsadas	reembolsar	VPFP
reembolsando	reembolsar	VG
reembolsándome	reembolsar	VGSE
reembolsándote	reembolsar	VGSE
reembolsándole	reembolsar	VGSE
reembolsándonos	reembolsar	VGPE
reembolsándoos	reembolsar	VGPE
reembolsándolo	reembolsar	VGMSE
reembolsándola	reembolsar	VGFSE
reembolsándolos	reembolsar	VGMPE
reembolsándolas	reembolsar	VGFPE
reembolsándomelo	reembolsar	VGMSE
reembolsándotelo	reembolsar	VGMSE
reembolsándoselo	reembolsar	VGMSE
reembolsándonoslo	reembolsar	VGMSE
reembolsándooslo	reembolsar	VGMSE
reembolsándomelos	reembolsar	VGMPE
reembolsándotelos	reembolsar	VGMPE
reembolsándoselos	reembolsar	VGMPE
reembolsándonoslos	reembolsar	VGMPE
reembolsándooslos	reembolsar	VGMPE
reembolsándomela	reembolsar	VGFSE
reembolsándotela	reembolsar	VGFSE
reembolsándosela	reembolsar	VGFSE
reembolsándonosla	reembolsar	VGFSE
reembolsándoosla	reembolsar	VGFSE
reembolsándomelas	reembolsar	VGFPE
reembolsándotelas	reembolsar	VGFPE
reembolsándoselas	reembolsar	VGFPE
reembolsándonoslas	reembolsar	VGFPE
reembolsándooslas	reembolsar	VGFPE
reemplazar	reemplazar	O
reemplazo	reemplazar	VIP1
reemplazas	reemplazar	VIP2
reemplaza	reemplazar	VIP3
reemplazamos	reemplazar	VIP4
reemplazáis	reemplazar	VIP5
reemplazan	reemplazar	VIP6
reemplazaba	reemplazar	VII1
reemplazabas	reemplazar	VII2
reemplazábamos	reemplazar	VII4
reemplazabais	reemplazar	VII5
reemplazaban	reemplazar	VII6
reemplazaré	reemplazar	VIF1
reemplazarás	reemplazar	VIF2
reemplazará	reemplazar	VIF3
reemplazaremos	reemplazar	VIF4
reemplazaréis	reemplazar	VIF5
reemplazarán	reemplazar	VIF6
reemplazaría	reemplazar	VIC1
reemplazarías	reemplazar	VIC2
reemplazaría	reemplazar	VIC3
reemplazaríamos	reemplazar	VIC4
reemplazaríais	reemplazar	VIC5
reemplazarían	reemplazar	VIC6
reemplacé	reemplazar	VIX1
reemplazaste	reemplazar	VIX2
reemplazó	reemplazar	VIX3
reemplazasteis	reemplazar	VIX5
reemplazaron	reemplazar	VIX6
reemplace	reemplazar	VSP1
reemplaces	reemplazar	VSP2
reemplacemos	reemplazar	VSP4
reemplacéis	reemplazar	VSP5
reemplacen	reemplazar	VSP6
reemplazara	reemplazar	VSX1
reemplazaras	reemplazar	VSX2
reemplazáramos	reemplazar	VSX4
reemplazarais	reemplazar	VSX5
reemplazaran	reemplazar	VSX6
reemplazare	reemplazar	VSF1
reemplazares	reemplazar	VSF2
reemplazáremos	reemplazar	VSF4
reemplazareis	reemplazar	VSF5
reemplazaren	reemplazar	VSF6
reemplazase	reemplazar	VSI1
reemplazases	reemplazar	VSI2
reemplazásemos	reemplazar	VSI4
reemplazaseis	reemplazar	VSI5
reemplazasen	reemplazar	VSI6
reemplazad	reemplazar	VMP
reemplazadme	reemplazar	VMSE
reemplazadle	reemplazar	VMSE
reemplazadnos	reemplazar	VMPE
reemplazaos	reemplazar	VMPE
reemplazadles	reemplazar	VMPE
reemplazadlo	reemplazar	VMMSE
reemplazadla	reemplazar	VMFSE
reemplazadlos	reemplazar	VMMPE
reemplazadlas	reemplazar	VMFPE
reemplazádmelo	reemplazar	VMMSE
reemplazádselo	reemplazar	VMMSE
reemplazádnoslo	reemplazar	VMMSE
reemplazáoslo	reemplazar	VMMSE
reemplazádmelos	reemplazar	VMMPE
reemplazádselos	reemplazar	VMMPE
reemplazádnoslos	reemplazar	VMMPE
reemplazáoslos	reemplazar	VMMPE
reemplazádmela	reemplazar	VMFSE
reemplazádsela	reemplazar	VMFSE
reemplazádnosla	reemplazar	VMFSE
reemplazáosla	reemplazar	VMFSE
reemplazádmelas	reemplazar	VMFPE
reemplazádselas	reemplazar	VMFPE
reemplazádnoslas	reemplazar	VMFPE
reemplazáoslas	reemplazar	VMFPE
reemplazado	reemplazar	VPM
reemplazados	reemplazar	VPMP
reemplazada	reemplazar	VPF
reemplazadas	reemplazar	VPFP
reemplazando	reemplazar	VG
reemplazándome	reemplazar	VGSE
reemplazándote	reemplazar	VGSE
reemplazándole	reemplazar	VGSE
reemplazándonos	reemplazar	VGPE
reemplazándoos	reemplazar	VGPE
reemplazándolo	reemplazar	VGMSE
reemplazándola	reemplazar	VGFSE
reemplazándolos	reemplazar	VGMPE
reemplazándolas	reemplazar	VGFPE
reemplazándomelo	reemplazar	VGMSE
reemplazándotelo	reemplazar	VGMSE
reemplazándoselo	reemplazar	VGMSE
reemplazándonoslo	reemplazar	VGMSE
reemplazándooslo	reemplazar	VGMSE
reemplazándomelos	reemplazar	VGMPE
reemplazándotelos	reemplazar	VGMPE
reemplazándoselos	reemplazar	VGMPE
reemplazándonoslos	reemplazar	VGMPE
reemplazándooslos	reemplazar	VGMPE
reemplazándomela	reemplazar	VGFSE
reemplazándotela	reemplazar	VGFSE
reemplazándosela	reemplazar	VGFSE
reemplazándonosla	reemplazar	VGFSE
reemplazándoosla	reemplazar	VGFSE
reemplazándomelas	reemplazar	VGFPE
reemplazándotelas	reemplazar	VGFPE
reemplazándoselas	reemplazar	VGFPE
reemplazándonoslas	reemplazar	VGFPE
reemplazándooslas	reemplazar	VGFPE
reencarnar	reencarnar	O
reencarno	reencarnar	VIP1
reencarnas	reencarnar	VIP2
reencarna	reencarnar	VIP3
reencarnamos	reencarnar	VIP4
reencarnáis	reencarnar	VIP5
reencarnan	reencarnar	VIP6
reencarnaba	reencarnar	VII1
reencarnabas	reencarnar	VII2
reencarnábamos	reencarnar	VII4
reencarnabais	reencarnar	VII5
reencarnaban	reencarnar	VII6
reencarnaré	reencarnar	VIF1
reencarnarás	reencarnar	VIF2
reencarnará	reencarnar	VIF3
reencarnaremos	reencarnar	VIF4
reencarnaréis	reencarnar	VIF5
reencarnarán	reencarnar	VIF6
reencarnaría	reencarnar	VIC1
reencarnarías	reencarnar	VIC2
reencarnaría	reencarnar	VIC3
reencarnaríamos	reencarnar	VIC4
reencarnaríais	reencarnar	VIC5
reencarnarían	reencarnar	VIC6
reencarné	reencarnar	VIX1
reencarnaste	reencarnar	VIX2
reencarnó	reencarnar	VIX3
reencarnasteis	reencarnar	VIX5
reencarnaron	reencarnar	VIX6
reencarne	reencarnar	VSP1
reencarnes	reencarnar	VSP2
reencarnemos	reencarnar	VSP4
reencarnéis	reencarnar	VSP5
reencarnen	reencarnar	VSP6
reencarnara	reencarnar	VSX1
reencarnaras	reencarnar	VSX2
reencarnáramos	reencarnar	VSX4
reencarnarais	reencarnar	VSX5
reencarnaran	reencarnar	VSX6
reencarnare	reencarnar	VSF1
reencarnares	reencarnar	VSF2
reencarnáremos	reencarnar	VSF4
reencarnareis	reencarnar	VSF5
reencarnaren	reencarnar	VSF6
reencarnase	reencarnar	VSI1
reencarnases	reencarnar	VSI2
reencarnásemos	reencarnar	VSI4
reencarnaseis	reencarnar	VSI5
reencarnasen	reencarnar	VSI6
reencarnad	reencarnar	VMP
reencarnadme	reencarnar	VMSE
reencarnadle	reencarnar	VMSE
reencarnadnos	reencarnar	VMPE
reencarnaos	reencarnar	VMPE
reencarnadles	reencarnar	VMPE
reencarnado	reencarnar	VPM
reencarnados	reencarnar	VPMP
reencarnada	reencarnar	VPF
reencarnadas	reencarnar	VPFP
reencarnando	reencarnar	VG
reencarnándome	reencarnar	VGSE
reencarnándote	reencarnar	VGSE
reencarnándole	reencarnar	VGSE
reencarnándonos	reencarnar	VGPE
reencarnándoos	reencarnar	VGPE
reencauchar	reencauchar	O
reencaucho	reencauchar	VIP1
reencauchas	reencauchar	VIP2
reencaucha	reencauchar	VIP3
reencauchamos	reencauchar	VIP4
reencaucháis	reencauchar	VIP5
reencauchan	reencauchar	VIP6
reencauchaba	reencauchar	VII1
reencauchabas	reencauchar	VII2
reencauchábamos	reencauchar	VII4
reencauchabais	reencauchar	VII5
reencauchaban	reencauchar	VII6
reencaucharé	reencauchar	VIF1
reencaucharás	reencauchar	VIF2
reencauchará	reencauchar	VIF3
reencaucharemos	reencauchar	VIF4
reencaucharéis	reencauchar	VIF5
reencaucharán	reencauchar	VIF6
reencaucharía	reencauchar	VIC1
reencaucharías	reencauchar	VIC2
reencaucharía	reencauchar	VIC3
reencaucharíamos	reencauchar	VIC4
reencaucharíais	reencauchar	VIC5
reencaucharían	reencauchar	VIC6
reencauché	reencauchar	VIX1
reencauchaste	reencauchar	VIX2
reencauchó	reencauchar	VIX3
reencauchasteis	reencauchar	VIX5
reencaucharon	reencauchar	VIX6
reencauche	reencauchar	VSP1
reencauches	reencauchar	VSP2
reencauchemos	reencauchar	VSP4
reencauchéis	reencauchar	VSP5
reencauchen	reencauchar	VSP6
reencauchara	reencauchar	VSX1
reencaucharas	reencauchar	VSX2
reencaucháramos	reencauchar	VSX4
reencaucharais	reencauchar	VSX5
reencaucharan	reencauchar	VSX6
reencauchare	reencauchar	VSF1
reencauchares	reencauchar	VSF2
reencaucháremos	reencauchar	VSF4
reencauchareis	reencauchar	VSF5
reencaucharen	reencauchar	VSF6
reencauchase	reencauchar	VSI1
reencauchases	reencauchar	VSI2
reencauchásemos	reencauchar	VSI4
reencauchaseis	reencauchar	VSI5
reencauchasen	reencauchar	VSI6
reencauchad	reencauchar	VMP
reencauchadme	reencauchar	VMSE
reencauchadle	reencauchar	VMSE
reencauchadnos	reencauchar	VMPE
reencauchaos	reencauchar	VMPE
reencauchadles	reencauchar	VMPE
reencauchadlo	reencauchar	VMMSE
reencauchadla	reencauchar	VMFSE
reencauchadlos	reencauchar	VMMPE
reencauchadlas	reencauchar	VMFPE
reencauchádmelo	reencauchar	VMMSE
reencauchádselo	reencauchar	VMMSE
reencauchádnoslo	reencauchar	VMMSE
reencaucháoslo	reencauchar	VMMSE
reencauchádmelos	reencauchar	VMMPE
reencauchádselos	reencauchar	VMMPE
reencauchádnoslos	reencauchar	VMMPE
reencaucháoslos	reencauchar	VMMPE
reencauchádmela	reencauchar	VMFSE
reencauchádsela	reencauchar	VMFSE
reencauchádnosla	reencauchar	VMFSE
reencaucháosla	reencauchar	VMFSE
reencauchádmelas	reencauchar	VMFPE
reencauchádselas	reencauchar	VMFPE
reencauchádnoslas	reencauchar	VMFPE
reencaucháoslas	reencauchar	VMFPE
reencauchado	reencauchar	VPM
reencauchados	reencauchar	VPMP
reencauchada	reencauchar	VPF
reencauchadas	reencauchar	VPFP
reencauchando	reencauchar	VG
reencauchándome	reencauchar	VGSE
reencauchándote	reencauchar	VGSE
reencauchándole	reencauchar	VGSE
reencauchándonos	reencauchar	VGPE
reencauchándoos	reencauchar	VGPE
reencauchándolo	reencauchar	VGMSE
reencauchándola	reencauchar	VGFSE
reencauchándolos	reencauchar	VGMPE
reencauchándolas	reencauchar	VGFPE
reencauchándomelo	reencauchar	VGMSE
reencauchándotelo	reencauchar	VGMSE
reencauchándoselo	reencauchar	VGMSE
reencauchándonoslo	reencauchar	VGMSE
reencauchándooslo	reencauchar	VGMSE
reencauchándomelos	reencauchar	VGMPE
reencauchándotelos	reencauchar	VGMPE
reencauchándoselos	reencauchar	VGMPE
reencauchándonoslos	reencauchar	VGMPE
reencauchándooslos	reencauchar	VGMPE
reencauchándomela	reencauchar	VGFSE
reencauchándotela	reencauchar	VGFSE
reencauchándosela	reencauchar	VGFSE
reencauchándonosla	reencauchar	VGFSE
reencauchándoosla	reencauchar	VGFSE
reencauchándomelas	reencauchar	VGFPE
reencauchándotelas	reencauchar	VGFPE
reencauchándoselas	reencauchar	VGFPE
reencauchándonoslas	reencauchar	VGFPE
reencauchándooslas	reencauchar	VGFPE
reencontrar	reencontrar	O
reencuentro	reencontrar	VIP1
reencuentras	reencontrar	VIP2
reencuentra	reencontrar	VIP3
reencontramos	reencontrar	VIP4
reencontráis	reencontrar	VIP5
reencuentran	reencontrar	VIP6
reencontraba	reencontrar	VII1
reencontrabas	reencontrar	VII2
reencontrábamos	reencontrar	VII4
reencontrabais	reencontrar	VII5
reencontraban	reencontrar	VII6
reencontraré	reencontrar	VIF1
reencontrarás	reencontrar	VIF2
reencontrará	reencontrar	VIF3
reencontraremos	reencontrar	VIF4
reencontraréis	reencontrar	VIF5
reencontrarán	reencontrar	VIF6
reencontraría	reencontrar	VIC1
reencontrarías	reencontrar	VIC2
reencontraría	reencontrar	VIC3
reencontraríamos	reencontrar	VIC4
reencontraríais	reencontrar	VIC5
reencontrarían	reencontrar	VIC6
reencontré	reencontrar	VIX1
reencontraste	reencontrar	VIX2
reencontró	reencontrar	VIX3
reencontrasteis	reencontrar	VIX5
reencontraron	reencontrar	VIX6
reencuentre	reencontrar	VSP1
reencuentres	reencontrar	VSP2
reencontremos	reencontrar	VSP4
reencontréis	reencontrar	VSP5
reencuentren	reencontrar	VSP6
reencontrara	reencontrar	VSX1
reencontraras	reencontrar	VSX2
reencontráramos	reencontrar	VSX4
reencontrarais	reencontrar	VSX5
reencontraran	reencontrar	VSX6
reencontrare	reencontrar	VSF1
reencontrares	reencontrar	VSF2
reencontráremos	reencontrar	VSF4
reencontrareis	reencontrar	VSF5
reencontraren	reencontrar	VSF6
reencontrase	reencontrar	VSI1
reencontrases	reencontrar	VSI2
reencontrásemos	reencontrar	VSI4
reencontraseis	reencontrar	VSI5
reencontrasen	reencontrar	VSI6
reencontrad	reencontrar	VMP
reencontradme	reencontrar	VMSE
reencontradle	reencontrar	VMSE
reencontradnos	reencontrar	VMPE
reencontraos	reencontrar	VMPE
reencontradles	reencontrar	VMPE
reencontradlo	reencontrar	VMMSE
reencontradla	reencontrar	VMFSE
reencontradlos	reencontrar	VMMPE
reencontradlas	reencontrar	VMFPE
reencontrádmelo	reencontrar	VMMSE
reencontrádselo	reencontrar	VMMSE
reencontrádnoslo	reencontrar	VMMSE
reencontráoslo	reencontrar	VMMSE
reencontrádmelos	reencontrar	VMMPE
reencontrádselos	reencontrar	VMMPE
reencontrádnoslos	reencontrar	VMMPE
reencontráoslos	reencontrar	VMMPE
reencontrádmela	reencontrar	VMFSE
reencontrádsela	reencontrar	VMFSE
reencontrádnosla	reencontrar	VMFSE
reencontráosla	reencontrar	VMFSE
reencontrádmelas	reencontrar	VMFPE
reencontrádselas	reencontrar	VMFPE
reencontrádnoslas	reencontrar	VMFPE
reencontráoslas	reencontrar	VMFPE
reencontrado	reencontrar	VPM
reencontrados	reencontrar	VPMP
reencontrada	reencontrar	VPF
reencontradas	reencontrar	VPFP
reencontrando	reencontrar	VG
reencontrándome	reencontrar	VGSE
reencontrándote	reencontrar	VGSE
reencontrándole	reencontrar	VGSE
reencontrándonos	reencontrar	VGPE
reencontrándoos	reencontrar	VGPE
reencontrándolo	reencontrar	VGMSE
reencontrándola	reencontrar	VGFSE
reencontrándolos	reencontrar	VGMPE
reencontrándolas	reencontrar	VGFPE
reencontrándomelo	reencontrar	VGMSE
reencontrándotelo	reencontrar	VGMSE
reencontrándoselo	reencontrar	VGMSE
reencontrándonoslo	reencontrar	VGMSE
reencontrándooslo	reencontrar	VGMSE
reencontrándomelos	reencontrar	VGMPE
reencontrándotelos	reencontrar	VGMPE
reencontrándoselos	reencontrar	VGMPE
reencontrándonoslos	reencontrar	VGMPE
reencontrándooslos	reencontrar	VGMPE
reencontrándomela	reencontrar	VGFSE
reencontrándotela	reencontrar	VGFSE
reencontrándosela	reencontrar	VGFSE
reencontrándonosla	reencontrar	VGFSE
reencontrándoosla	reencontrar	VGFSE
reencontrándomelas	reencontrar	VGFPE
reencontrándotelas	reencontrar	VGFPE
reencontrándoselas	reencontrar	VGFPE
reencontrándonoslas	reencontrar	VGFPE
reencontrándooslas	reencontrar	VGFPE
reencuadernar	reencuadernar	O
reencuaderno	reencuadernar	VIP1
reencuadernas	reencuadernar	VIP2
reencuaderna	reencuadernar	VIP3
reencuadernamos	reencuadernar	VIP4
reencuadernáis	reencuadernar	VIP5
reencuadernan	reencuadernar	VIP6
reencuadernaba	reencuadernar	VII1
reencuadernabas	reencuadernar	VII2
reencuadernábamos	reencuadernar	VII4
reencuadernabais	reencuadernar	VII5
reencuadernaban	reencuadernar	VII6
reencuadernaré	reencuadernar	VIF1
reencuadernarás	reencuadernar	VIF2
reencuadernará	reencuadernar	VIF3
reencuadernaremos	reencuadernar	VIF4
reencuadernaréis	reencuadernar	VIF5
reencuadernarán	reencuadernar	VIF6
reencuadernaría	reencuadernar	VIC1
reencuadernarías	reencuadernar	VIC2
reencuadernaría	reencuadernar	VIC3
reencuadernaríamos	reencuadernar	VIC4
reencuadernaríais	reencuadernar	VIC5
reencuadernarían	reencuadernar	VIC6
reencuaderné	reencuadernar	VIX1
reencuadernaste	reencuadernar	VIX2
reencuadernó	reencuadernar	VIX3
reencuadernasteis	reencuadernar	VIX5
reencuadernaron	reencuadernar	VIX6
reencuaderne	reencuadernar	VSP1
reencuadernes	reencuadernar	VSP2
reencuadernemos	reencuadernar	VSP4
reencuadernéis	reencuadernar	VSP5
reencuadernen	reencuadernar	VSP6
reencuadernara	reencuadernar	VSX1
reencuadernaras	reencuadernar	VSX2
reencuadernáramos	reencuadernar	VSX4
reencuadernarais	reencuadernar	VSX5
reencuadernaran	reencuadernar	VSX6
reencuadernare	reencuadernar	VSF1
reencuadernares	reencuadernar	VSF2
reencuadernáremos	reencuadernar	VSF4
reencuadernareis	reencuadernar	VSF5
reencuadernaren	reencuadernar	VSF6
reencuadernase	reencuadernar	VSI1
reencuadernases	reencuadernar	VSI2
reencuadernásemos	reencuadernar	VSI4
reencuadernaseis	reencuadernar	VSI5
reencuadernasen	reencuadernar	VSI6
reencuadernad	reencuadernar	VMP
reencuadernadme	reencuadernar	VMSE
reencuadernadle	reencuadernar	VMSE
reencuadernadnos	reencuadernar	VMPE
reencuadernaos	reencuadernar	VMPE
reencuadernadles	reencuadernar	VMPE
reencuadernadlo	reencuadernar	VMMSE
reencuadernadla	reencuadernar	VMFSE
reencuadernadlos	reencuadernar	VMMPE
reencuadernadlas	reencuadernar	VMFPE
reencuadernádmelo	reencuadernar	VMMSE
reencuadernádselo	reencuadernar	VMMSE
reencuadernádnoslo	reencuadernar	VMMSE
reencuadernáoslo	reencuadernar	VMMSE
reencuadernádmelos	reencuadernar	VMMPE
reencuadernádselos	reencuadernar	VMMPE
reencuadernádnoslos	reencuadernar	VMMPE
reencuadernáoslos	reencuadernar	VMMPE
reencuadernádmela	reencuadernar	VMFSE
reencuadernádsela	reencuadernar	VMFSE
reencuadernádnosla	reencuadernar	VMFSE
reencuadernáosla	reencuadernar	VMFSE
reencuadernádmelas	reencuadernar	VMFPE
reencuadernádselas	reencuadernar	VMFPE
reencuadernádnoslas	reencuadernar	VMFPE
reencuadernáoslas	reencuadernar	VMFPE
reencuadernado	reencuadernar	VPM
reencuadernados	reencuadernar	VPMP
reencuadernada	reencuadernar	VPF
reencuadernadas	reencuadernar	VPFP
reencuadernando	reencuadernar	VG
reencuadernándome	reencuadernar	VGSE
reencuadernándote	reencuadernar	VGSE
reencuadernándole	reencuadernar	VGSE
reencuadernándonos	reencuadernar	VGPE
reencuadernándoos	reencuadernar	VGPE
reencuadernándolo	reencuadernar	VGMSE
reencuadernándola	reencuadernar	VGFSE
reencuadernándolos	reencuadernar	VGMPE
reencuadernándolas	reencuadernar	VGFPE
reencuadernándomelo	reencuadernar	VGMSE
reencuadernándotelo	reencuadernar	VGMSE
reencuadernándoselo	reencuadernar	VGMSE
reencuadernándonoslo	reencuadernar	VGMSE
reencuadernándooslo	reencuadernar	VGMSE
reencuadernándomelos	reencuadernar	VGMPE
reencuadernándotelos	reencuadernar	VGMPE
reencuadernándoselos	reencuadernar	VGMPE
reencuadernándonoslos	reencuadernar	VGMPE
reencuadernándooslos	reencuadernar	VGMPE
reencuadernándomela	reencuadernar	VGFSE
reencuadernándotela	reencuadernar	VGFSE
reencuadernándosela	reencuadernar	VGFSE
reencuadernándonosla	reencuadernar	VGFSE
reencuadernándoosla	reencuadernar	VGFSE
reencuadernándomelas	reencuadernar	VGFPE
reencuadernándotelas	reencuadernar	VGFPE
reencuadernándoselas	reencuadernar	VGFPE
reencuadernándonoslas	reencuadernar	VGFPE
reencuadernándooslas	reencuadernar	VGFPE
reenganchar	reenganchar	O
reengancho	reenganchar	VIP1
reenganchas	reenganchar	VIP2
reengancha	reenganchar	VIP3
reenganchamos	reenganchar	VIP4
reengancháis	reenganchar	VIP5
reenganchan	reenganchar	VIP6
reenganchaba	reenganchar	VII1
reenganchabas	reenganchar	VII2
reenganchábamos	reenganchar	VII4
reenganchabais	reenganchar	VII5
reenganchaban	reenganchar	VII6
reengancharé	reenganchar	VIF1
reengancharás	reenganchar	VIF2
reenganchará	reenganchar	VIF3
reengancharemos	reenganchar	VIF4
reengancharéis	reenganchar	VIF5
reengancharán	reenganchar	VIF6
reengancharía	reenganchar	VIC1
reengancharías	reenganchar	VIC2
reengancharía	reenganchar	VIC3
reengancharíamos	reenganchar	VIC4
reengancharíais	reenganchar	VIC5
reengancharían	reenganchar	VIC6
reenganché	reenganchar	VIX1
reenganchaste	reenganchar	VIX2
reenganchó	reenganchar	VIX3
reenganchasteis	reenganchar	VIX5
reengancharon	reenganchar	VIX6
reenganche	reenganchar	VSP1
reenganches	reenganchar	VSP2
reenganchemos	reenganchar	VSP4
reenganchéis	reenganchar	VSP5
reenganchen	reenganchar	VSP6
reenganchara	reenganchar	VSX1
reengancharas	reenganchar	VSX2
reengancháramos	reenganchar	VSX4
reengancharais	reenganchar	VSX5
reengancharan	reenganchar	VSX6
reenganchare	reenganchar	VSF1
reenganchares	reenganchar	VSF2
reengancháremos	reenganchar	VSF4
reenganchareis	reenganchar	VSF5
reengancharen	reenganchar	VSF6
reenganchase	reenganchar	VSI1
reenganchases	reenganchar	VSI2
reenganchásemos	reenganchar	VSI4
reenganchaseis	reenganchar	VSI5
reenganchasen	reenganchar	VSI6
reenganchad	reenganchar	VMP
reenganchadme	reenganchar	VMSE
reenganchadle	reenganchar	VMSE
reenganchadnos	reenganchar	VMPE
reenganchaos	reenganchar	VMPE
reenganchadles	reenganchar	VMPE
reenganchadlo	reenganchar	VMMSE
reenganchadla	reenganchar	VMFSE
reenganchadlos	reenganchar	VMMPE
reenganchadlas	reenganchar	VMFPE
reenganchádmelo	reenganchar	VMMSE
reenganchádselo	reenganchar	VMMSE
reenganchádnoslo	reenganchar	VMMSE
reengancháoslo	reenganchar	VMMSE
reenganchádmelos	reenganchar	VMMPE
reenganchádselos	reenganchar	VMMPE
reenganchádnoslos	reenganchar	VMMPE
reengancháoslos	reenganchar	VMMPE
reenganchádmela	reenganchar	VMFSE
reenganchádsela	reenganchar	VMFSE
reenganchádnosla	reenganchar	VMFSE
reengancháosla	reenganchar	VMFSE
reenganchádmelas	reenganchar	VMFPE
reenganchádselas	reenganchar	VMFPE
reenganchádnoslas	reenganchar	VMFPE
reengancháoslas	reenganchar	VMFPE
reenganchado	reenganchar	VPM
reenganchados	reenganchar	VPMP
reenganchada	reenganchar	VPF
reenganchadas	reenganchar	VPFP
reenganchando	reenganchar	VG
reenganchándome	reenganchar	VGSE
reenganchándote	reenganchar	VGSE
reenganchándole	reenganchar	VGSE
reenganchándonos	reenganchar	VGPE
reenganchándoos	reenganchar	VGPE
reenganchándolo	reenganchar	VGMSE
reenganchándola	reenganchar	VGFSE
reenganchándolos	reenganchar	VGMPE
reenganchándolas	reenganchar	VGFPE
reenganchándomelo	reenganchar	VGMSE
reenganchándotelo	reenganchar	VGMSE
reenganchándoselo	reenganchar	VGMSE
reenganchándonoslo	reenganchar	VGMSE
reenganchándooslo	reenganchar	VGMSE
reenganchándomelos	reenganchar	VGMPE
reenganchándotelos	reenganchar	VGMPE
reenganchándoselos	reenganchar	VGMPE
reenganchándonoslos	reenganchar	VGMPE
reenganchándooslos	reenganchar	VGMPE
reenganchándomela	reenganchar	VGFSE
reenganchándotela	reenganchar	VGFSE
reenganchándosela	reenganchar	VGFSE
reenganchándonosla	reenganchar	VGFSE
reenganchándoosla	reenganchar	VGFSE
reenganchándomelas	reenganchar	VGFPE
reenganchándotelas	reenganchar	VGFPE
reenganchándoselas	reenganchar	VGFPE
reenganchándonoslas	reenganchar	VGFPE
reenganchándooslas	reenganchar	VGFPE
reengendrar	reengendrar	O
reengendro	reengendrar	VIP1
reengendras	reengendrar	VIP2
reengendra	reengendrar	VIP3
reengendramos	reengendrar	VIP4
reengendráis	reengendrar	VIP5
reengendran	reengendrar	VIP6
reengendraba	reengendrar	VII1
reengendrabas	reengendrar	VII2
reengendrábamos	reengendrar	VII4
reengendrabais	reengendrar	VII5
reengendraban	reengendrar	VII6
reengendraré	reengendrar	VIF1
reengendrarás	reengendrar	VIF2
reengendrará	reengendrar	VIF3
reengendraremos	reengendrar	VIF4
reengendraréis	reengendrar	VIF5
reengendrarán	reengendrar	VIF6
reengendraría	reengendrar	VIC1
reengendrarías	reengendrar	VIC2
reengendraría	reengendrar	VIC3
reengendraríamos	reengendrar	VIC4
reengendraríais	reengendrar	VIC5
reengendrarían	reengendrar	VIC6
reengendré	reengendrar	VIX1
reengendraste	reengendrar	VIX2
reengendró	reengendrar	VIX3
reengendrasteis	reengendrar	VIX5
reengendraron	reengendrar	VIX6
reengendre	reengendrar	VSP1
reengendres	reengendrar	VSP2
reengendremos	reengendrar	VSP4
reengendréis	reengendrar	VSP5
reengendren	reengendrar	VSP6
reengendrara	reengendrar	VSX1
reengendraras	reengendrar	VSX2
reengendráramos	reengendrar	VSX4
reengendrarais	reengendrar	VSX5
reengendraran	reengendrar	VSX6
reengendrare	reengendrar	VSF1
reengendrares	reengendrar	VSF2
reengendráremos	reengendrar	VSF4
reengendrareis	reengendrar	VSF5
reengendraren	reengendrar	VSF6
reengendrase	reengendrar	VSI1
reengendrases	reengendrar	VSI2
reengendrásemos	reengendrar	VSI4
reengendraseis	reengendrar	VSI5
reengendrasen	reengendrar	VSI6
reengendrad	reengendrar	VMP
reengendradme	reengendrar	VMSE
reengendradle	reengendrar	VMSE
reengendradnos	reengendrar	VMPE
reengendraos	reengendrar	VMPE
reengendradles	reengendrar	VMPE
reengendradlo	reengendrar	VMMSE
reengendradla	reengendrar	VMFSE
reengendradlos	reengendrar	VMMPE
reengendradlas	reengendrar	VMFPE
reengendrádmelo	reengendrar	VMMSE
reengendrádselo	reengendrar	VMMSE
reengendrádnoslo	reengendrar	VMMSE
reengendráoslo	reengendrar	VMMSE
reengendrádmelos	reengendrar	VMMPE
reengendrádselos	reengendrar	VMMPE
reengendrádnoslos	reengendrar	VMMPE
reengendráoslos	reengendrar	VMMPE
reengendrádmela	reengendrar	VMFSE
reengendrádsela	reengendrar	VMFSE
reengendrádnosla	reengendrar	VMFSE
reengendráosla	reengendrar	VMFSE
reengendrádmelas	reengendrar	VMFPE
reengendrádselas	reengendrar	VMFPE
reengendrádnoslas	reengendrar	VMFPE
reengendráoslas	reengendrar	VMFPE
reengendrado	reengendrar	VPM
reengendrados	reengendrar	VPMP
reengendrada	reengendrar	VPF
reengendradas	reengendrar	VPFP
reengendrando	reengendrar	VG
reengendrándome	reengendrar	VGSE
reengendrándote	reengendrar	VGSE
reengendrándole	reengendrar	VGSE
reengendrándonos	reengendrar	VGPE
reengendrándoos	reengendrar	VGPE
reengendrándolo	reengendrar	VGMSE
reengendrándola	reengendrar	VGFSE
reengendrándolos	reengendrar	VGMPE
reengendrándolas	reengendrar	VGFPE
reengendrándomelo	reengendrar	VGMSE
reengendrándotelo	reengendrar	VGMSE
reengendrándoselo	reengendrar	VGMSE
reengendrándonoslo	reengendrar	VGMSE
reengendrándooslo	reengendrar	VGMSE
reengendrándomelos	reengendrar	VGMPE
reengendrándotelos	reengendrar	VGMPE
reengendrándoselos	reengendrar	VGMPE
reengendrándonoslos	reengendrar	VGMPE
reengendrándooslos	reengendrar	VGMPE
reengendrándomela	reengendrar	VGFSE
reengendrándotela	reengendrar	VGFSE
reengendrándosela	reengendrar	VGFSE
reengendrándonosla	reengendrar	VGFSE
reengendrándoosla	reengendrar	VGFSE
reengendrándomelas	reengendrar	VGFPE
reengendrándotelas	reengendrar	VGFPE
reengendrándoselas	reengendrar	VGFPE
reengendrándonoslas	reengendrar	VGFPE
reengendrándooslas	reengendrar	VGFPE
reensayar	reensayar	O
reensayo	reensayar	VIP1
reensayas	reensayar	VIP2
reensaya	reensayar	VIP3
reensayamos	reensayar	VIP4
reensayáis	reensayar	VIP5
reensayan	reensayar	VIP6
reensayaba	reensayar	VII1
reensayabas	reensayar	VII2
reensayábamos	reensayar	VII4
reensayabais	reensayar	VII5
reensayaban	reensayar	VII6
reensayaré	reensayar	VIF1
reensayarás	reensayar	VIF2
reensayará	reensayar	VIF3
reensayaremos	reensayar	VIF4
reensayaréis	reensayar	VIF5
reensayarán	reensayar	VIF6
reensayaría	reensayar	VIC1
reensayarías	reensayar	VIC2
reensayaría	reensayar	VIC3
reensayaríamos	reensayar	VIC4
reensayaríais	reensayar	VIC5
reensayarían	reensayar	VIC6
reensayé	reensayar	VIX1
reensayaste	reensayar	VIX2
reensayó	reensayar	VIX3
reensayasteis	reensayar	VIX5
reensayaron	reensayar	VIX6
reensaye	reensayar	VSP1
reensayes	reensayar	VSP2
reensayemos	reensayar	VSP4
reensayéis	reensayar	VSP5
reensayen	reensayar	VSP6
reensayara	reensayar	VSX1
reensayaras	reensayar	VSX2
reensayáramos	reensayar	VSX4
reensayarais	reensayar	VSX5
reensayaran	reensayar	VSX6
reensayare	reensayar	VSF1
reensayares	reensayar	VSF2
reensayáremos	reensayar	VSF4
reensayareis	reensayar	VSF5
reensayaren	reensayar	VSF6
reensayase	reensayar	VSI1
reensayases	reensayar	VSI2
reensayásemos	reensayar	VSI4
reensayaseis	reensayar	VSI5
reensayasen	reensayar	VSI6
reensayad	reensayar	VMP
reensayadme	reensayar	VMSE
reensayadle	reensayar	VMSE
reensayadnos	reensayar	VMPE
reensayaos	reensayar	VMPE
reensayadles	reensayar	VMPE
reensayadlo	reensayar	VMMSE
reensayadla	reensayar	VMFSE
reensayadlos	reensayar	VMMPE
reensayadlas	reensayar	VMFPE
reensayádmelo	reensayar	VMMSE
reensayádselo	reensayar	VMMSE
reensayádnoslo	reensayar	VMMSE
reensayáoslo	reensayar	VMMSE
reensayádmelos	reensayar	VMMPE
reensayádselos	reensayar	VMMPE
reensayádnoslos	reensayar	VMMPE
reensayáoslos	reensayar	VMMPE
reensayádmela	reensayar	VMFSE
reensayádsela	reensayar	VMFSE
reensayádnosla	reensayar	VMFSE
reensayáosla	reensayar	VMFSE
reensayádmelas	reensayar	VMFPE
reensayádselas	reensayar	VMFPE
reensayádnoslas	reensayar	VMFPE
reensayáoslas	reensayar	VMFPE
reensayado	reensayar	VPM
reensayados	reensayar	VPMP
reensayada	reensayar	VPF
reensayadas	reensayar	VPFP
reensayando	reensayar	VG
reensayándome	reensayar	VGSE
reensayándote	reensayar	VGSE
reensayándole	reensayar	VGSE
reensayándonos	reensayar	VGPE
reensayándoos	reensayar	VGPE
reensayándolo	reensayar	VGMSE
reensayándola	reensayar	VGFSE
reensayándolos	reensayar	VGMPE
reensayándolas	reensayar	VGFPE
reensayándomelo	reensayar	VGMSE
reensayándotelo	reensayar	VGMSE
reensayándoselo	reensayar	VGMSE
reensayándonoslo	reensayar	VGMSE
reensayándooslo	reensayar	VGMSE
reensayándomelos	reensayar	VGMPE
reensayándotelos	reensayar	VGMPE
reensayándoselos	reensayar	VGMPE
reensayándonoslos	reensayar	VGMPE
reensayándooslos	reensayar	VGMPE
reensayándomela	reensayar	VGFSE
reensayándotela	reensayar	VGFSE
reensayándosela	reensayar	VGFSE
reensayándonosla	reensayar	VGFSE
reensayándoosla	reensayar	VGFSE
reensayándomelas	reensayar	VGFPE
reensayándotelas	reensayar	VGFPE
reensayándoselas	reensayar	VGFPE
reensayándonoslas	reensayar	VGFPE
reensayándooslas	reensayar	VGFPE
reenviar	reenviar	O
reenvío	reenviar	VIP1
reenvias	reenviar	VIP2
reenvia	reenviar	VIP3
reenviamos	reenviar	VIP4
reenviáis	reenviar	VIP5
reenvian	reenviar	VIP6
reenviaba	reenviar	VII1
reenviabas	reenviar	VII2
reenviábamos	reenviar	VII4
reenviabais	reenviar	VII5
reenviaban	reenviar	VII6
reenviaré	reenviar	VIF1
reenviarás	reenviar	VIF2
reenviará	reenviar	VIF3
reenviaremos	reenviar	VIF4
reenviaréis	reenviar	VIF5
reenviarán	reenviar	VIF6
reenviaría	reenviar	VIC1
reenviarías	reenviar	VIC2
reenviaría	reenviar	VIC3
reenviaríamos	reenviar	VIC4
reenviaríais	reenviar	VIC5
reenviarían	reenviar	VIC6
reenvié	reenviar	VIX1
reenviaste	reenviar	VIX2
reenvió	reenviar	VIX3
reenviasteis	reenviar	VIX5
reenviaron	reenviar	VIX6
reenvíe	reenviar	VSP1
reenvíes	reenviar	VSP2
reenviemos	reenviar	VSP4
reenviéis	reenviar	VSP5
reenvíen	reenviar	VSP6
reenviara	reenviar	VSX1
reenviaras	reenviar	VSX2
reenviáramos	reenviar	VSX4
reenviarais	reenviar	VSX5
reenviaran	reenviar	VSX6
reenviare	reenviar	VSF1
reenviares	reenviar	VSF2
reenviáremos	reenviar	VSF4
reenviareis	reenviar	VSF5
reenviaren	reenviar	VSF6
reenviase	reenviar	VSI1
reenviases	reenviar	VSI2
reenviásemos	reenviar	VSI4
reenviaseis	reenviar	VSI5
reenviasen	reenviar	VSI6
reenviad	reenviar	VMP
reenviadme	reenviar	VMSE
reenviadle	reenviar	VMSE
reenviadnos	reenviar	VMPE
reenviaos	reenviar	VMPE
reenviadles	reenviar	VMPE
reenviadlo	reenviar	VMMSE
reenviadla	reenviar	VMFSE
reenviadlos	reenviar	VMMPE
reenviadlas	reenviar	VMFPE
reenviádmelo	reenviar	VMMSE
reenviádselo	reenviar	VMMSE
reenviádnoslo	reenviar	VMMSE
reenviáoslo	reenviar	VMMSE
reenviádmelos	reenviar	VMMPE
reenviádselos	reenviar	VMMPE
reenviádnoslos	reenviar	VMMPE
reenviáoslos	reenviar	VMMPE
reenviádmela	reenviar	VMFSE
reenviádsela	reenviar	VMFSE
reenviádnosla	reenviar	VMFSE
reenviáosla	reenviar	VMFSE
reenviádmelas	reenviar	VMFPE
reenviádselas	reenviar	VMFPE
reenviádnoslas	reenviar	VMFPE
reenviáoslas	reenviar	VMFPE
reenviado	reenviar	VPM
reenviados	reenviar	VPMP
reenviada	reenviar	VPF
reenviadas	reenviar	VPFP
reenviando	reenviar	VG
reenviándome	reenviar	VGSE
reenviándote	reenviar	VGSE
reenviándole	reenviar	VGSE
reenviándonos	reenviar	VGPE
reenviándoos	reenviar	VGPE
reenviándolo	reenviar	VGMSE
reenviándola	reenviar	VGFSE
reenviándolos	reenviar	VGMPE
reenviándolas	reenviar	VGFPE
reenviándomelo	reenviar	VGMSE
reenviándotelo	reenviar	VGMSE
reenviándoselo	reenviar	VGMSE
reenviándonoslo	reenviar	VGMSE
reenviándooslo	reenviar	VGMSE
reenviándomelos	reenviar	VGMPE
reenviándotelos	reenviar	VGMPE
reenviándoselos	reenviar	VGMPE
reenviándonoslos	reenviar	VGMPE
reenviándooslos	reenviar	VGMPE
reenviándomela	reenviar	VGFSE
reenviándotela	reenviar	VGFSE
reenviándosela	reenviar	VGFSE
reenviándonosla	reenviar	VGFSE
reenviándoosla	reenviar	VGFSE
reenviándomelas	reenviar	VGFPE
reenviándotelas	reenviar	VGFPE
reenviándoselas	reenviar	VGFPE
reenviándonoslas	reenviar	VGFPE
reenviándooslas	reenviar	VGFPE
reenvidar	reenvidar	O
reenvido	reenvidar	VIP1
reenvidas	reenvidar	VIP2
reenvida	reenvidar	VIP3
reenvidamos	reenvidar	VIP4
reenvidáis	reenvidar	VIP5
reenvidan	reenvidar	VIP6
reenvidaba	reenvidar	VII1
reenvidabas	reenvidar	VII2
reenvidábamos	reenvidar	VII4
reenvidabais	reenvidar	VII5
reenvidaban	reenvidar	VII6
reenvidaré	reenvidar	VIF1
reenvidarás	reenvidar	VIF2
reenvidará	reenvidar	VIF3
reenvidaremos	reenvidar	VIF4
reenvidaréis	reenvidar	VIF5
reenvidarán	reenvidar	VIF6
reenvidaría	reenvidar	VIC1
reenvidarías	reenvidar	VIC2
reenvidaría	reenvidar	VIC3
reenvidaríamos	reenvidar	VIC4
reenvidaríais	reenvidar	VIC5
reenvidarían	reenvidar	VIC6
reenvidé	reenvidar	VIX1
reenvidaste	reenvidar	VIX2
reenvidó	reenvidar	VIX3
reenvidasteis	reenvidar	VIX5
reenvidaron	reenvidar	VIX6
reenvide	reenvidar	VSP1
reenvides	reenvidar	VSP2
reenvidemos	reenvidar	VSP4
reenvidéis	reenvidar	VSP5
reenviden	reenvidar	VSP6
reenvidara	reenvidar	VSX1
reenvidaras	reenvidar	VSX2
reenvidáramos	reenvidar	VSX4
reenvidarais	reenvidar	VSX5
reenvidaran	reenvidar	VSX6
reenvidare	reenvidar	VSF1
reenvidares	reenvidar	VSF2
reenvidáremos	reenvidar	VSF4
reenvidareis	reenvidar	VSF5
reenvidaren	reenvidar	VSF6
reenvidase	reenvidar	VSI1
reenvidases	reenvidar	VSI2
reenvidásemos	reenvidar	VSI4
reenvidaseis	reenvidar	VSI5
reenvidasen	reenvidar	VSI6
reenvidad	reenvidar	VMP
reenvidadme	reenvidar	VMSE
reenvidadle	reenvidar	VMSE
reenvidadnos	reenvidar	VMPE
reenvidaos	reenvidar	VMPE
reenvidadles	reenvidar	VMPE
reenvidadlo	reenvidar	VMMSE
reenvidadla	reenvidar	VMFSE
reenvidadlos	reenvidar	VMMPE
reenvidadlas	reenvidar	VMFPE
reenvidádmelo	reenvidar	VMMSE
reenvidádselo	reenvidar	VMMSE
reenvidádnoslo	reenvidar	VMMSE
reenvidáoslo	reenvidar	VMMSE
reenvidádmelos	reenvidar	VMMPE
reenvidádselos	reenvidar	VMMPE
reenvidádnoslos	reenvidar	VMMPE
reenvidáoslos	reenvidar	VMMPE
reenvidádmela	reenvidar	VMFSE
reenvidádsela	reenvidar	VMFSE
reenvidádnosla	reenvidar	VMFSE
reenvidáosla	reenvidar	VMFSE
reenvidádmelas	reenvidar	VMFPE
reenvidádselas	reenvidar	VMFPE
reenvidádnoslas	reenvidar	VMFPE
reenvidáoslas	reenvidar	VMFPE
reenvidado	reenvidar	VPM
reenvidados	reenvidar	VPMP
reenvidada	reenvidar	VPF
reenvidadas	reenvidar	VPFP
reenvidando	reenvidar	VG
reenvidándome	reenvidar	VGSE
reenvidándote	reenvidar	VGSE
reenvidándole	reenvidar	VGSE
reenvidándonos	reenvidar	VGPE
reenvidándoos	reenvidar	VGPE
reenvidándolo	reenvidar	VGMSE
reenvidándola	reenvidar	VGFSE
reenvidándolos	reenvidar	VGMPE
reenvidándolas	reenvidar	VGFPE
reenvidándomelo	reenvidar	VGMSE
reenvidándotelo	reenvidar	VGMSE
reenvidándoselo	reenvidar	VGMSE
reenvidándonoslo	reenvidar	VGMSE
reenvidándooslo	reenvidar	VGMSE
reenvidándomelos	reenvidar	VGMPE
reenvidándotelos	reenvidar	VGMPE
reenvidándoselos	reenvidar	VGMPE
reenvidándonoslos	reenvidar	VGMPE
reenvidándooslos	reenvidar	VGMPE
reenvidándomela	reenvidar	VGFSE
reenvidándotela	reenvidar	VGFSE
reenvidándosela	reenvidar	VGFSE
reenvidándonosla	reenvidar	VGFSE
reenvidándoosla	reenvidar	VGFSE
reenvidándomelas	reenvidar	VGFPE
reenvidándotelas	reenvidar	VGFPE
reenvidándoselas	reenvidar	VGFPE
reenvidándonoslas	reenvidar	VGFPE
reenvidándooslas	reenvidar	VGFPE
reestrenar	reestrenar	O
reestreno	reestrenar	VIP1
reestrenas	reestrenar	VIP2
reestrena	reestrenar	VIP3
reestrenamos	reestrenar	VIP4
reestrenáis	reestrenar	VIP5
reestrenan	reestrenar	VIP6
reestrenaba	reestrenar	VII1
reestrenabas	reestrenar	VII2
reestrenábamos	reestrenar	VII4
reestrenabais	reestrenar	VII5
reestrenaban	reestrenar	VII6
reestrenaré	reestrenar	VIF1
reestrenarás	reestrenar	VIF2
reestrenará	reestrenar	VIF3
reestrenaremos	reestrenar	VIF4
reestrenaréis	reestrenar	VIF5
reestrenarán	reestrenar	VIF6
reestrenaría	reestrenar	VIC1
reestrenarías	reestrenar	VIC2
reestrenaría	reestrenar	VIC3
reestrenaríamos	reestrenar	VIC4
reestrenaríais	reestrenar	VIC5
reestrenarían	reestrenar	VIC6
reestrené	reestrenar	VIX1
reestrenaste	reestrenar	VIX2
reestrenó	reestrenar	VIX3
reestrenasteis	reestrenar	VIX5
reestrenaron	reestrenar	VIX6
reestrene	reestrenar	VSP1
reestrenes	reestrenar	VSP2
reestrenemos	reestrenar	VSP4
reestrenéis	reestrenar	VSP5
reestrenen	reestrenar	VSP6
reestrenara	reestrenar	VSX1
reestrenaras	reestrenar	VSX2
reestrenáramos	reestrenar	VSX4
reestrenarais	reestrenar	VSX5
reestrenaran	reestrenar	VSX6
reestrenare	reestrenar	VSF1
reestrenares	reestrenar	VSF2
reestrenáremos	reestrenar	VSF4
reestrenareis	reestrenar	VSF5
reestrenaren	reestrenar	VSF6
reestrenase	reestrenar	VSI1
reestrenases	reestrenar	VSI2
reestrenásemos	reestrenar	VSI4
reestrenaseis	reestrenar	VSI5
reestrenasen	reestrenar	VSI6
reestrenad	reestrenar	VMP
reestrenadme	reestrenar	VMSE
reestrenadle	reestrenar	VMSE
reestrenadnos	reestrenar	VMPE
reestrenaos	reestrenar	VMPE
reestrenadles	reestrenar	VMPE
reestrenadlo	reestrenar	VMMSE
reestrenadla	reestrenar	VMFSE
reestrenadlos	reestrenar	VMMPE
reestrenadlas	reestrenar	VMFPE
reestrenádmelo	reestrenar	VMMSE
reestrenádselo	reestrenar	VMMSE
reestrenádnoslo	reestrenar	VMMSE
reestrenáoslo	reestrenar	VMMSE
reestrenádmelos	reestrenar	VMMPE
reestrenádselos	reestrenar	VMMPE
reestrenádnoslos	reestrenar	VMMPE
reestrenáoslos	reestrenar	VMMPE
reestrenádmela	reestrenar	VMFSE
reestrenádsela	reestrenar	VMFSE
reestrenádnosla	reestrenar	VMFSE
reestrenáosla	reestrenar	VMFSE
reestrenádmelas	reestrenar	VMFPE
reestrenádselas	reestrenar	VMFPE
reestrenádnoslas	reestrenar	VMFPE
reestrenáoslas	reestrenar	VMFPE
reestrenado	reestrenar	VPM
reestrenados	reestrenar	VPMP
reestrenada	reestrenar	VPF
reestrenadas	reestrenar	VPFP
reestrenando	reestrenar	VG
reestrenándome	reestrenar	VGSE
reestrenándote	reestrenar	VGSE
reestrenándole	reestrenar	VGSE
reestrenándonos	reestrenar	VGPE
reestrenándoos	reestrenar	VGPE
reestrenándolo	reestrenar	VGMSE
reestrenándola	reestrenar	VGFSE
reestrenándolos	reestrenar	VGMPE
reestrenándolas	reestrenar	VGFPE
reestrenándomelo	reestrenar	VGMSE
reestrenándotelo	reestrenar	VGMSE
reestrenándoselo	reestrenar	VGMSE
reestrenándonoslo	reestrenar	VGMSE
reestrenándooslo	reestrenar	VGMSE
reestrenándomelos	reestrenar	VGMPE
reestrenándotelos	reestrenar	VGMPE
reestrenándoselos	reestrenar	VGMPE
reestrenándonoslos	reestrenar	VGMPE
reestrenándooslos	reestrenar	VGMPE
reestrenándomela	reestrenar	VGFSE
reestrenándotela	reestrenar	VGFSE
reestrenándosela	reestrenar	VGFSE
reestrenándonosla	reestrenar	VGFSE
reestrenándoosla	reestrenar	VGFSE
reestrenándomelas	reestrenar	VGFPE
reestrenándotelas	reestrenar	VGFPE
reestrenándoselas	reestrenar	VGFPE
reestrenándonoslas	reestrenar	VGFPE
reestrenándooslas	reestrenar	VGFPE
reestructurar	reestructurar	O
reestructuro	reestructurar	VIP1
reestructuras	reestructurar	VIP2
reestructura	reestructurar	VIP3
reestructuramos	reestructurar	VIP4
reestructuráis	reestructurar	VIP5
reestructuran	reestructurar	VIP6
reestructuraba	reestructurar	VII1
reestructurabas	reestructurar	VII2
reestructurábamos	reestructurar	VII4
reestructurabais	reestructurar	VII5
reestructuraban	reestructurar	VII6
reestructuraré	reestructurar	VIF1
reestructurarás	reestructurar	VIF2
reestructurará	reestructurar	VIF3
reestructuraremos	reestructurar	VIF4
reestructuraréis	reestructurar	VIF5
reestructurarán	reestructurar	VIF6
reestructuraría	reestructurar	VIC1
reestructurarías	reestructurar	VIC2
reestructuraría	reestructurar	VIC3
reestructuraríamos	reestructurar	VIC4
reestructuraríais	reestructurar	VIC5
reestructurarían	reestructurar	VIC6
reestructuré	reestructurar	VIX1
reestructuraste	reestructurar	VIX2
reestructuró	reestructurar	VIX3
reestructurasteis	reestructurar	VIX5
reestructuraron	reestructurar	VIX6
reestructure	reestructurar	VSP1
reestructures	reestructurar	VSP2
reestructuremos	reestructurar	VSP4
reestructuréis	reestructurar	VSP5
reestructuren	reestructurar	VSP6
reestructurara	reestructurar	VSX1
reestructuraras	reestructurar	VSX2
reestructuráramos	reestructurar	VSX4
reestructurarais	reestructurar	VSX5
reestructuraran	reestructurar	VSX6
reestructurare	reestructurar	VSF1
reestructurares	reestructurar	VSF2
reestructuráremos	reestructurar	VSF4
reestructurareis	reestructurar	VSF5
reestructuraren	reestructurar	VSF6
reestructurase	reestructurar	VSI1
reestructurases	reestructurar	VSI2
reestructurásemos	reestructurar	VSI4
reestructuraseis	reestructurar	VSI5
reestructurasen	reestructurar	VSI6
reestructurad	reestructurar	VMP
reestructuradme	reestructurar	VMSE
reestructuradle	reestructurar	VMSE
reestructuradnos	reestructurar	VMPE
reestructuraos	reestructurar	VMPE
reestructuradles	reestructurar	VMPE
reestructuradlo	reestructurar	VMMSE
reestructuradla	reestructurar	VMFSE
reestructuradlos	reestructurar	VMMPE
reestructuradlas	reestructurar	VMFPE
reestructurádmelo	reestructurar	VMMSE
reestructurádselo	reestructurar	VMMSE
reestructurádnoslo	reestructurar	VMMSE
reestructuráoslo	reestructurar	VMMSE
reestructurádmelos	reestructurar	VMMPE
reestructurádselos	reestructurar	VMMPE
reestructurádnoslos	reestructurar	VMMPE
reestructuráoslos	reestructurar	VMMPE
reestructurádmela	reestructurar	VMFSE
reestructurádsela	reestructurar	VMFSE
reestructurádnosla	reestructurar	VMFSE
reestructuráosla	reestructurar	VMFSE
reestructurádmelas	reestructurar	VMFPE
reestructurádselas	reestructurar	VMFPE
reestructurádnoslas	reestructurar	VMFPE
reestructuráoslas	reestructurar	VMFPE
reestructurado	reestructurar	VPM
reestructurados	reestructurar	VPMP
reestructurada	reestructurar	VPF
reestructuradas	reestructurar	VPFP
reestructurando	reestructurar	VG
reestructurándome	reestructurar	VGSE
reestructurándote	reestructurar	VGSE
reestructurándole	reestructurar	VGSE
reestructurándonos	reestructurar	VGPE
reestructurándoos	reestructurar	VGPE
reestructurándolo	reestructurar	VGMSE
reestructurándola	reestructurar	VGFSE
reestructurándolos	reestructurar	VGMPE
reestructurándolas	reestructurar	VGFPE
reestructurándomelo	reestructurar	VGMSE
reestructurándotelo	reestructurar	VGMSE
reestructurándoselo	reestructurar	VGMSE
reestructurándonoslo	reestructurar	VGMSE
reestructurándooslo	reestructurar	VGMSE
reestructurándomelos	reestructurar	VGMPE
reestructurándotelos	reestructurar	VGMPE
reestructurándoselos	reestructurar	VGMPE
reestructurándonoslos	reestructurar	VGMPE
reestructurándooslos	reestructurar	VGMPE
reestructurándomela	reestructurar	VGFSE
reestructurándotela	reestructurar	VGFSE
reestructurándosela	reestructurar	VGFSE
reestructurándonosla	reestructurar	VGFSE
reestructurándoosla	reestructurar	VGFSE
reestructurándomelas	reestructurar	VGFPE
reestructurándotelas	reestructurar	VGFPE
reestructurándoselas	reestructurar	VGFPE
reestructurándonoslas	reestructurar	VGFPE
reestructurándooslas	reestructurar	VGFPE
reexaminar	reexaminar	O
reexamino	reexaminar	VIP1
reexaminas	reexaminar	VIP2
reexamina	reexaminar	VIP3
reexaminamos	reexaminar	VIP4
reexamináis	reexaminar	VIP5
reexaminan	reexaminar	VIP6
reexaminaba	reexaminar	VII1
reexaminabas	reexaminar	VII2
reexaminábamos	reexaminar	VII4
reexaminabais	reexaminar	VII5
reexaminaban	reexaminar	VII6
reexaminaré	reexaminar	VIF1
reexaminarás	reexaminar	VIF2
reexaminará	reexaminar	VIF3
reexaminaremos	reexaminar	VIF4
reexaminaréis	reexaminar	VIF5
reexaminarán	reexaminar	VIF6
reexaminaría	reexaminar	VIC1
reexaminarías	reexaminar	VIC2
reexaminaría	reexaminar	VIC3
reexaminaríamos	reexaminar	VIC4
reexaminaríais	reexaminar	VIC5
reexaminarían	reexaminar	VIC6
reexaminé	reexaminar	VIX1
reexaminaste	reexaminar	VIX2
reexaminó	reexaminar	VIX3
reexaminasteis	reexaminar	VIX5
reexaminaron	reexaminar	VIX6
reexamine	reexaminar	VSP1
reexamines	reexaminar	VSP2
reexaminemos	reexaminar	VSP4
reexaminéis	reexaminar	VSP5
reexaminen	reexaminar	VSP6
reexaminara	reexaminar	VSX1
reexaminaras	reexaminar	VSX2
reexamináramos	reexaminar	VSX4
reexaminarais	reexaminar	VSX5
reexaminaran	reexaminar	VSX6
reexaminare	reexaminar	VSF1
reexaminares	reexaminar	VSF2
reexamináremos	reexaminar	VSF4
reexaminareis	reexaminar	VSF5
reexaminaren	reexaminar	VSF6
reexaminase	reexaminar	VSI1
reexaminases	reexaminar	VSI2
reexaminásemos	reexaminar	VSI4
reexaminaseis	reexaminar	VSI5
reexaminasen	reexaminar	VSI6
reexaminad	reexaminar	VMP
reexaminadme	reexaminar	VMSE
reexaminadle	reexaminar	VMSE
reexaminadnos	reexaminar	VMPE
reexaminaos	reexaminar	VMPE
reexaminadles	reexaminar	VMPE
reexaminadlo	reexaminar	VMMSE
reexaminadla	reexaminar	VMFSE
reexaminadlos	reexaminar	VMMPE
reexaminadlas	reexaminar	VMFPE
reexaminádmelo	reexaminar	VMMSE
reexaminádselo	reexaminar	VMMSE
reexaminádnoslo	reexaminar	VMMSE
reexamináoslo	reexaminar	VMMSE
reexaminádmelos	reexaminar	VMMPE
reexaminádselos	reexaminar	VMMPE
reexaminádnoslos	reexaminar	VMMPE
reexamináoslos	reexaminar	VMMPE
reexaminádmela	reexaminar	VMFSE
reexaminádsela	reexaminar	VMFSE
reexaminádnosla	reexaminar	VMFSE
reexamináosla	reexaminar	VMFSE
reexaminádmelas	reexaminar	VMFPE
reexaminádselas	reexaminar	VMFPE
reexaminádnoslas	reexaminar	VMFPE
reexamináoslas	reexaminar	VMFPE
reexaminado	reexaminar	VPM
reexaminados	reexaminar	VPMP
reexaminada	reexaminar	VPF
reexaminadas	reexaminar	VPFP
reexaminando	reexaminar	VG
reexaminándome	reexaminar	VGSE
reexaminándote	reexaminar	VGSE
reexaminándole	reexaminar	VGSE
reexaminándonos	reexaminar	VGPE
reexaminándoos	reexaminar	VGPE
reexaminándolo	reexaminar	VGMSE
reexaminándola	reexaminar	VGFSE
reexaminándolos	reexaminar	VGMPE
reexaminándolas	reexaminar	VGFPE
reexaminándomelo	reexaminar	VGMSE
reexaminándotelo	reexaminar	VGMSE
reexaminándoselo	reexaminar	VGMSE
reexaminándonoslo	reexaminar	VGMSE
reexaminándooslo	reexaminar	VGMSE
reexaminándomelos	reexaminar	VGMPE
reexaminándotelos	reexaminar	VGMPE
reexaminándoselos	reexaminar	VGMPE
reexaminándonoslos	reexaminar	VGMPE
reexaminándooslos	reexaminar	VGMPE
reexaminándomela	reexaminar	VGFSE
reexaminándotela	reexaminar	VGFSE
reexaminándosela	reexaminar	VGFSE
reexaminándonosla	reexaminar	VGFSE
reexaminándoosla	reexaminar	VGFSE
reexaminándomelas	reexaminar	VGFPE
reexaminándotelas	reexaminar	VGFPE
reexaminándoselas	reexaminar	VGFPE
reexaminándonoslas	reexaminar	VGFPE
reexaminándooslas	reexaminar	VGFPE
reexportar	reexportar	O
reexporto	reexportar	VIP1
reexportas	reexportar	VIP2
reexporta	reexportar	VIP3
reexportamos	reexportar	VIP4
reexportáis	reexportar	VIP5
reexportan	reexportar	VIP6
reexportaba	reexportar	VII1
reexportabas	reexportar	VII2
reexportábamos	reexportar	VII4
reexportabais	reexportar	VII5
reexportaban	reexportar	VII6
reexportaré	reexportar	VIF1
reexportarás	reexportar	VIF2
reexportará	reexportar	VIF3
reexportaremos	reexportar	VIF4
reexportaréis	reexportar	VIF5
reexportarán	reexportar	VIF6
reexportaría	reexportar	VIC1
reexportarías	reexportar	VIC2
reexportaría	reexportar	VIC3
reexportaríamos	reexportar	VIC4
reexportaríais	reexportar	VIC5
reexportarían	reexportar	VIC6
reexporté	reexportar	VIX1
reexportaste	reexportar	VIX2
reexportó	reexportar	VIX3
reexportasteis	reexportar	VIX5
reexportaron	reexportar	VIX6
reexporte	reexportar	VSP1
reexportes	reexportar	VSP2
reexportemos	reexportar	VSP4
reexportéis	reexportar	VSP5
reexporten	reexportar	VSP6
reexportara	reexportar	VSX1
reexportaras	reexportar	VSX2
reexportáramos	reexportar	VSX4
reexportarais	reexportar	VSX5
reexportaran	reexportar	VSX6
reexportare	reexportar	VSF1
reexportares	reexportar	VSF2
reexportáremos	reexportar	VSF4
reexportareis	reexportar	VSF5
reexportaren	reexportar	VSF6
reexportase	reexportar	VSI1
reexportases	reexportar	VSI2
reexportásemos	reexportar	VSI4
reexportaseis	reexportar	VSI5
reexportasen	reexportar	VSI6
reexportad	reexportar	VMP
reexportadme	reexportar	VMSE
reexportadle	reexportar	VMSE
reexportadnos	reexportar	VMPE
reexportaos	reexportar	VMPE
reexportadles	reexportar	VMPE
reexportadlo	reexportar	VMMSE
reexportadla	reexportar	VMFSE
reexportadlos	reexportar	VMMPE
reexportadlas	reexportar	VMFPE
reexportádmelo	reexportar	VMMSE
reexportádselo	reexportar	VMMSE
reexportádnoslo	reexportar	VMMSE
reexportáoslo	reexportar	VMMSE
reexportádmelos	reexportar	VMMPE
reexportádselos	reexportar	VMMPE
reexportádnoslos	reexportar	VMMPE
reexportáoslos	reexportar	VMMPE
reexportádmela	reexportar	VMFSE
reexportádsela	reexportar	VMFSE
reexportádnosla	reexportar	VMFSE
reexportáosla	reexportar	VMFSE
reexportádmelas	reexportar	VMFPE
reexportádselas	reexportar	VMFPE
reexportádnoslas	reexportar	VMFPE
reexportáoslas	reexportar	VMFPE
reexportado	reexportar	VPM
reexportados	reexportar	VPMP
reexportada	reexportar	VPF
reexportadas	reexportar	VPFP
reexportando	reexportar	VG
reexportándome	reexportar	VGSE
reexportándote	reexportar	VGSE
reexportándole	reexportar	VGSE
reexportándonos	reexportar	VGPE
reexportándoos	reexportar	VGPE
reexportándolo	reexportar	VGMSE
reexportándola	reexportar	VGFSE
reexportándolos	reexportar	VGMPE
reexportándolas	reexportar	VGFPE
reexportándomelo	reexportar	VGMSE
reexportándotelo	reexportar	VGMSE
reexportándoselo	reexportar	VGMSE
reexportándonoslo	reexportar	VGMSE
reexportándooslo	reexportar	VGMSE
reexportándomelos	reexportar	VGMPE
reexportándotelos	reexportar	VGMPE
reexportándoselos	reexportar	VGMPE
reexportándonoslos	reexportar	VGMPE
reexportándooslos	reexportar	VGMPE
reexportándomela	reexportar	VGFSE
reexportándotela	reexportar	VGFSE
reexportándosela	reexportar	VGFSE
reexportándonosla	reexportar	VGFSE
reexportándoosla	reexportar	VGFSE
reexportándomelas	reexportar	VGFPE
reexportándotelas	reexportar	VGFPE
reexportándoselas	reexportar	VGFPE
reexportándonoslas	reexportar	VGFPE
reexportándooslas	reexportar	VGFPE
