riego	riego	O
riegos	riego	P
riel	riel	O
rieles	riel	P
rienda	rienda	O
riendas	rienda	P
riepto	riepto	O
rieptos	riepto	P
riera	riera	O
rieras	riera	P
riesgo	riesgo	O
riesgos	riesgo	P
riesgoso	riesgoso	O
riesgosas	riesgoso	FP
riesgosa	riesgoso	F
riesgosos	riesgoso	P
riestra	riestra	O
riestras	riestra	P
riego	regar	VIP1
riegas	regar	VIP2
riega	regar	VIP3
riegan	regar	VIP6
riegue	regar	VSP1
riegues	regar	VSP2
rieguen	regar	VSP6
rielar	rielar	O
rielo	rielar	VIP1
rielas	rielar	VIP2
riela	rielar	VIP3
rielamos	rielar	VIP4
rieláis	rielar	VIP5
rielan	rielar	VIP6
rielaba	rielar	VII1
rielabas	rielar	VII2
rielábamos	rielar	VII4
rielabais	rielar	VII5
rielaban	rielar	VII6
rielaré	rielar	VIF1
rielarás	rielar	VIF2
rielará	rielar	VIF3
rielaremos	rielar	VIF4
rielaréis	rielar	VIF5
rielarán	rielar	VIF6
rielaría	rielar	VIC1
rielarías	rielar	VIC2
rielaría	rielar	VIC3
rielaríamos	rielar	VIC4
rielaríais	rielar	VIC5
rielarían	rielar	VIC6
rielé	rielar	VIX1
rielaste	rielar	VIX2
rieló	rielar	VIX3
rielasteis	rielar	VIX5
rielaron	rielar	VIX6
riele	rielar	VSP1
rieles	rielar	VSP2
rielemos	rielar	VSP4
rieléis	rielar	VSP5
rielen	rielar	VSP6
rielara	rielar	VSX1
rielaras	rielar	VSX2
rieláramos	rielar	VSX4
rielarais	rielar	VSX5
rielaran	rielar	VSX6
rielare	rielar	VSF1
rielares	rielar	VSF2
rieláremos	rielar	VSF4
rielareis	rielar	VSF5
rielaren	rielar	VSF6
rielase	rielar	VSI1
rielases	rielar	VSI2
rielásemos	rielar	VSI4
rielaseis	rielar	VSI5
rielasen	rielar	VSI6
rielad	rielar	VMP
rieladme	rielar	VMSE
rieladle	rielar	VMSE
rieladnos	rielar	VMPE
rielaos	rielar	VMPE
rieladles	rielar	VMPE
rielado	rielar	VPM
rielados	rielar	VPMP
rielada	rielar	VPF
rieladas	rielar	VPFP
rielando	rielar	VG
rielándome	rielar	VGSE
rielándote	rielar	VGSE
rielándole	rielar	VGSE
rielándonos	rielar	VGPE
rielándoos	rielar	VGPE
