ruc	ruc	O
ruces	ruc	P
ruca	ruca	O
rucas	ruca	P
ruche	ruche	O
ruches	ruche	P
ruchique	ruchique	O
ruchiques	ruchique	P
rucho	rucho	O
ruchos	rucho	P
ruciadera	ruciadera	O
ruciaderas	ruciadera	P
rucio	rucio	O
rucios	rucio	P
ruco	ruco	O
rucas	ruco	FP
ruca	ruco	F
rucos	ruco	P
rucar	rucar	O
ruco	rucar	VIP1
rucas	rucar	VIP2
ruca	rucar	VIP3
rucamos	rucar	VIP4
rucáis	rucar	VIP5
rucan	rucar	VIP6
rucaba	rucar	VII1
rucabas	rucar	VII2
rucábamos	rucar	VII4
rucabais	rucar	VII5
rucaban	rucar	VII6
rucaré	rucar	VIF1
rucarás	rucar	VIF2
rucará	rucar	VIF3
rucaremos	rucar	VIF4
rucaréis	rucar	VIF5
rucarán	rucar	VIF6
rucaría	rucar	VIC1
rucarías	rucar	VIC2
rucaría	rucar	VIC3
rucaríamos	rucar	VIC4
rucaríais	rucar	VIC5
rucarían	rucar	VIC6
rucaste	rucar	VIX2
rucó	rucar	VIX3
rucasteis	rucar	VIX5
rucaron	rucar	VIX6
rucara	rucar	VSX1
rucaras	rucar	VSX2
rucáramos	rucar	VSX4
rucarais	rucar	VSX5
rucaran	rucar	VSX6
rucare	rucar	VSF1
rucares	rucar	VSF2
rucáremos	rucar	VSF4
rucareis	rucar	VSF5
rucaren	rucar	VSF6
rucase	rucar	VSI1
rucases	rucar	VSI2
rucásemos	rucar	VSI4
rucaseis	rucar	VSI5
rucasen	rucar	VSI6
rucad	rucar	VMP
rucadme	rucar	VMSE
rucadle	rucar	VMSE
rucadnos	rucar	VMPE
rucaos	rucar	VMPE
rucadles	rucar	VMPE
rucadlo	rucar	VMMSE
rucadla	rucar	VMFSE
rucadlos	rucar	VMMPE
rucadlas	rucar	VMFPE
rucádmelo	rucar	VMMSE
rucádselo	rucar	VMMSE
rucádnoslo	rucar	VMMSE
rucáoslo	rucar	VMMSE
rucádmelos	rucar	VMMPE
rucádselos	rucar	VMMPE
rucádnoslos	rucar	VMMPE
rucáoslos	rucar	VMMPE
rucádmela	rucar	VMFSE
rucádsela	rucar	VMFSE
rucádnosla	rucar	VMFSE
rucáosla	rucar	VMFSE
rucádmelas	rucar	VMFPE
rucádselas	rucar	VMFPE
rucádnoslas	rucar	VMFPE
rucáoslas	rucar	VMFPE
rucado	rucar	VPM
rucados	rucar	VPMP
rucada	rucar	VPF
rucadas	rucar	VPFP
rucando	rucar	VG
rucándome	rucar	VGSE
rucándote	rucar	VGSE
rucándole	rucar	VGSE
rucándonos	rucar	VGPE
rucándoos	rucar	VGPE
rucándolo	rucar	VGMSE
rucándola	rucar	VGFSE
rucándolos	rucar	VGMPE
rucándolas	rucar	VGFPE
rucándomelo	rucar	VGMSE
rucándotelo	rucar	VGMSE
rucándoselo	rucar	VGMSE
rucándonoslo	rucar	VGMSE
rucándooslo	rucar	VGMSE
rucándomelos	rucar	VGMPE
rucándotelos	rucar	VGMPE
rucándoselos	rucar	VGMPE
rucándonoslos	rucar	VGMPE
rucándooslos	rucar	VGMPE
rucándomela	rucar	VGFSE
rucándotela	rucar	VGFSE
rucándosela	rucar	VGFSE
rucándonosla	rucar	VGFSE
rucándoosla	rucar	VGFSE
rucándomelas	rucar	VGFPE
rucándotelas	rucar	VGFPE
rucándoselas	rucar	VGFPE
rucándonoslas	rucar	VGFPE
rucándooslas	rucar	VGFPE
ruchar	ruchar	O
rucho	ruchar	VIP1
ruchas	ruchar	VIP2
rucha	ruchar	VIP3
ruchamos	ruchar	VIP4
rucháis	ruchar	VIP5
ruchan	ruchar	VIP6
ruchaba	ruchar	VII1
ruchabas	ruchar	VII2
ruchábamos	ruchar	VII4
ruchabais	ruchar	VII5
ruchaban	ruchar	VII6
rucharé	ruchar	VIF1
rucharás	ruchar	VIF2
ruchará	ruchar	VIF3
rucharemos	ruchar	VIF4
rucharéis	ruchar	VIF5
rucharán	ruchar	VIF6
rucharía	ruchar	VIC1
rucharías	ruchar	VIC2
rucharía	ruchar	VIC3
rucharíamos	ruchar	VIC4
rucharíais	ruchar	VIC5
rucharían	ruchar	VIC6
ruché	ruchar	VIX1
ruchaste	ruchar	VIX2
ruchó	ruchar	VIX3
ruchasteis	ruchar	VIX5
rucharon	ruchar	VIX6
ruche	ruchar	VSP1
ruches	ruchar	VSP2
ruchemos	ruchar	VSP4
ruchéis	ruchar	VSP5
ruchen	ruchar	VSP6
ruchara	ruchar	VSX1
rucharas	ruchar	VSX2
rucháramos	ruchar	VSX4
rucharais	ruchar	VSX5
rucharan	ruchar	VSX6
ruchare	ruchar	VSF1
ruchares	ruchar	VSF2
rucháremos	ruchar	VSF4
ruchareis	ruchar	VSF5
rucharen	ruchar	VSF6
ruchase	ruchar	VSI1
ruchases	ruchar	VSI2
ruchásemos	ruchar	VSI4
ruchaseis	ruchar	VSI5
ruchasen	ruchar	VSI6
ruchad	ruchar	VMP
ruchadme	ruchar	VMSE
ruchadle	ruchar	VMSE
ruchadnos	ruchar	VMPE
ruchaos	ruchar	VMPE
ruchadles	ruchar	VMPE
ruchado	ruchar	VPM
ruchados	ruchar	VPMP
ruchada	ruchar	VPF
ruchadas	ruchar	VPFP
ruchando	ruchar	VG
ruchándome	ruchar	VGSE
ruchándote	ruchar	VGSE
ruchándole	ruchar	VGSE
ruchándonos	ruchar	VGPE
ruchándoos	ruchar	VGPE
