saya	saya	O
sayas	saya	P
sayagués	sayagués	O
sayaguesas	sayagués	FP
sayaguesa	sayagués	F
sayagueses	sayagués	P
sayal	sayal	O
sayales	sayal	P
sayalero	sayalero	O
sayaleras	sayalero	FP
sayalera	sayalero	F
sayaleros	sayalero	P
sayalería	sayalería	O
sayalerías	sayalería	P
sayalesco	sayalesco	O
sayalescas	sayalesco	FP
sayalesca	sayalesco	F
sayalescos	sayalesco	P
sayalete	sayalete	O
sayaletes	sayalete	P
sayama	sayama	O
sayamas	sayama	P
sayo	sayo	O
sayos	sayo	P
sayuela	sayuela	O
sayuelas	sayuela	P
sayuelo	sayuelo	O
sayuelos	sayuelo	P
sayugo	sayugo	O
sayugos	sayugo	P
sayuguina	sayuguina	O
sayuguinas	sayuguina	P
sayón	sayón	O
sayones	sayón	P
