satandera	satandera	O
satanderas	satandera	P
satanismo	satanismo	O
satanismos	satanismo	P
satinado	satinado	O
satinados	satinado	P
satinador	satinador	O
satinadoras	satinador	FP
satinadora	satinador	F
satinadores	satinador	P
satiriasis	satiriasis	O
satirio	satirio	O
satirios	satirio	P
satirizante	satirizante	O
satirizantes	satirizante	P
satirión	satirión	O
satiriones	satirión	P
satis	satis	O
satisdación	satisdación	O
satisdaciones	satisdación	P
satisfacción	satisfacción	O
satisfacciones	satisfacción	P
satisfactoriamente	satisfactoriamente	O
satisfactorio	satisfactorio	O
satisfactorias	satisfactorio	FP
satisfactoria	satisfactorio	F
satisfactorios	satisfactorio	P
satisfecho	satisfecho	O
satisfechas	satisfecho	FP
satisfecha	satisfecho	F
satisfechos	satisfecho	P
sativo	sativo	O
sativas	sativo	FP
sativa	sativo	F
sativos	sativo	P
sato	sato	O
satas	sato	FP
sata	sato	F
satos	sato	P
satrapía	satrapía	O
satrapías	satrapía	P
saturable	saturable	O
saturables	saturable	P
saturación	saturación	O
saturaciones	saturación	P
saturado	saturado	O
saturadas	saturado	FP
saturada	saturado	F
saturados	saturado	P
saturnal	saturnal	O
saturnales	saturnal	P
saturnino	saturnino	O
saturninas	saturnino	FP
saturnina	saturnino	F
saturninos	saturnino	P
saturnio	saturnio	O
saturnias	saturnio	FP
saturnia	saturnio	F
saturnios	saturnio	P
saturnismo	saturnismo	O
saturnismos	saturnismo	P
saturno	saturno	O
saturnos	saturno	P
satánico	satánico	O
satánicas	satánico	FP
satánica	satánico	F
satánicos	satánico	P
satélite	satélite	O
satélites	satélite	P
satén	satén	O
satenes	satén	P
satín	satín	O
satines	satín	P
satíricamente	satíricamente	O
satírico	satírico	O
satíricas	satírico	FP
satírica	satírico	F
satíricos	satírico	P
sátira	sátira	O
sátiras	sátira	P
sátiro	sátiro	O
sátiras	sátiro	FP
sátira	sátiro	F
sátiros	sátiro	P
sátrapa	sátrapa	O
sátrapas	sátrapa	P
satisfacer	satisfacer	O
satisfaces	satisfacer	VIP2
satisface	satisfacer	VIP3
satisfacemos	satisfacer	VIP4
satisfacéis	satisfacer	VIP5
satisfacen	satisfacer	VIP6
satisfacía	satisfacer	VII1
satisfacías	satisfacer	VII2
satisfacíamos	satisfacer	VII4
satisfacíais	satisfacer	VII5
satisfacían	satisfacer	VII6
satisfaceré	satisfacer	VIF1
satisfacerás	satisfacer	VIF2
satisfacerá	satisfacer	VIF3
satisfaceremos	satisfacer	VIF4
satisfaceréis	satisfacer	VIF5
satisfacerán	satisfacer	VIF6
satisfacería	satisfacer	VIC1
satisfacerías	satisfacer	VIC2
satisfacería	satisfacer	VIC3
satisfaceríamos	satisfacer	VIC4
satisfaceríais	satisfacer	VIC5
satisfacerían	satisfacer	VIC6
satisfací	satisfacer	VIX1
satisfaciste	satisfacer	VIX2
satisfació	satisfacer	VIX3
satisfacisteis	satisfacer	VIX5
satisfacieron	satisfacer	VIX6
satisfaciera	satisfacer	VSX1
satisfacieras	satisfacer	VSX2
satisfaciéramos	satisfacer	VSX4
satisfacierais	satisfacer	VSX5
satisfacieran	satisfacer	VSX6
satisfaciere	satisfacer	VSF1
satisfacieres	satisfacer	VSF2
satisfaciéremos	satisfacer	VSF4
satisfaciereis	satisfacer	VSF5
satisfacieren	satisfacer	VSF6
satisfaciese	satisfacer	VSI1
satisfacieses	satisfacer	VSI2
satisfaciésemos	satisfacer	VSI4
satisfacieseis	satisfacer	VSI5
satisfaciesen	satisfacer	VSI6
satisfaced	satisfacer	VMP
satisfacedme	satisfacer	VMSE
satisfacedle	satisfacer	VMSE
satisfacednos	satisfacer	VMPE
satisfaceos	satisfacer	VMPE
satisfacedles	satisfacer	VMPE
satisfacedlo	satisfacer	VMMSE
satisfacedla	satisfacer	VMFSE
satisfacedlos	satisfacer	VMMPE
satisfacedlas	satisfacer	VMFPE
satisfacédmelo	satisfacer	VMMSE
satisfacédselo	satisfacer	VMMSE
satisfacédnoslo	satisfacer	VMMSE
satisfacéoslo	satisfacer	VMMSE
satisfacédmelos	satisfacer	VMMPE
satisfacédselos	satisfacer	VMMPE
satisfacédnoslos	satisfacer	VMMPE
satisfacéoslos	satisfacer	VMMPE
satisfacédmela	satisfacer	VMFSE
satisfacédsela	satisfacer	VMFSE
satisfacédnosla	satisfacer	VMFSE
satisfacéosla	satisfacer	VMFSE
satisfacédmelas	satisfacer	VMFPE
satisfacédselas	satisfacer	VMFPE
satisfacédnoslas	satisfacer	VMFPE
satisfacéoslas	satisfacer	VMFPE
satisfecho	satisfacer	VPMS
satisfechos	satisfacer	VPMP
satisfecha	satisfacer	VPFS
satisfechas	satisfacer	VFP
satisfaciendo	satisfacer	VG
satisfaciéndome	satisfacer	VGSE
satisfaciéndote	satisfacer	VGSE
satisfaciéndole	satisfacer	VGSE
satisfaciéndonos	satisfacer	VGPE
satisfaciéndoos	satisfacer	VGPE
satisfaciéndolo	satisfacer	VGMSE
satisfaciéndola	satisfacer	VGFSE
satisfaciéndolos	satisfacer	VGMPE
satisfaciéndolas	satisfacer	VGFPE
satisfaciéndomelo	satisfacer	VGMSE
satisfaciéndotelo	satisfacer	VGMSE
satisfaciéndoselo	satisfacer	VGMSE
satisfaciéndonoslo	satisfacer	VGMSE
satisfaciéndooslo	satisfacer	VGMSE
satisfaciéndomelos	satisfacer	VGMPE
satisfaciéndotelos	satisfacer	VGMPE
satisfaciéndoselos	satisfacer	VGMPE
satisfaciéndonoslos	satisfacer	VGMPE
satisfaciéndooslos	satisfacer	VGMPE
satisfaciéndomela	satisfacer	VGFSE
satisfaciéndotela	satisfacer	VGFSE
satisfaciéndosela	satisfacer	VGFSE
satisfaciéndonosla	satisfacer	VGFSE
satisfaciéndoosla	satisfacer	VGFSE
satisfaciéndomelas	satisfacer	VGFPE
satisfaciéndotelas	satisfacer	VGFPE
satisfaciéndoselas	satisfacer	VGFPE
satisfaciéndonoslas	satisfacer	VGFPE
satisfaciéndooslas	satisfacer	VGFPE
satinar	satinar	O
satino	satinar	VIP1
satinas	satinar	VIP2
satina	satinar	VIP3
satinamos	satinar	VIP4
satináis	satinar	VIP5
satinan	satinar	VIP6
satinaba	satinar	VII1
satinabas	satinar	VII2
satinábamos	satinar	VII4
satinabais	satinar	VII5
satinaban	satinar	VII6
satinaré	satinar	VIF1
satinarás	satinar	VIF2
satinará	satinar	VIF3
satinaremos	satinar	VIF4
satinaréis	satinar	VIF5
satinarán	satinar	VIF6
satinaría	satinar	VIC1
satinarías	satinar	VIC2
satinaría	satinar	VIC3
satinaríamos	satinar	VIC4
satinaríais	satinar	VIC5
satinarían	satinar	VIC6
satiné	satinar	VIX1
satinaste	satinar	VIX2
satinó	satinar	VIX3
satinasteis	satinar	VIX5
satinaron	satinar	VIX6
satine	satinar	VSP1
satines	satinar	VSP2
satinemos	satinar	VSP4
satinéis	satinar	VSP5
satinen	satinar	VSP6
satinara	satinar	VSX1
satinaras	satinar	VSX2
satináramos	satinar	VSX4
satinarais	satinar	VSX5
satinaran	satinar	VSX6
satinare	satinar	VSF1
satinares	satinar	VSF2
satináremos	satinar	VSF4
satinareis	satinar	VSF5
satinaren	satinar	VSF6
satinase	satinar	VSI1
satinases	satinar	VSI2
satinásemos	satinar	VSI4
satinaseis	satinar	VSI5
satinasen	satinar	VSI6
satinad	satinar	VMP
satinadme	satinar	VMSE
satinadle	satinar	VMSE
satinadnos	satinar	VMPE
satinaos	satinar	VMPE
satinadles	satinar	VMPE
satinadlo	satinar	VMMSE
satinadla	satinar	VMFSE
satinadlos	satinar	VMMPE
satinadlas	satinar	VMFPE
satinádmelo	satinar	VMMSE
satinádselo	satinar	VMMSE
satinádnoslo	satinar	VMMSE
satináoslo	satinar	VMMSE
satinádmelos	satinar	VMMPE
satinádselos	satinar	VMMPE
satinádnoslos	satinar	VMMPE
satináoslos	satinar	VMMPE
satinádmela	satinar	VMFSE
satinádsela	satinar	VMFSE
satinádnosla	satinar	VMFSE
satináosla	satinar	VMFSE
satinádmelas	satinar	VMFPE
satinádselas	satinar	VMFPE
satinádnoslas	satinar	VMFPE
satináoslas	satinar	VMFPE
satinado	satinar	VPM
satinados	satinar	VPMP
satinada	satinar	VPF
satinadas	satinar	VPFP
satinando	satinar	VG
satinándome	satinar	VGSE
satinándote	satinar	VGSE
satinándole	satinar	VGSE
satinándonos	satinar	VGPE
satinándoos	satinar	VGPE
satinándolo	satinar	VGMSE
satinándola	satinar	VGFSE
satinándolos	satinar	VGMPE
satinándolas	satinar	VGFPE
satinándomelo	satinar	VGMSE
satinándotelo	satinar	VGMSE
satinándoselo	satinar	VGMSE
satinándonoslo	satinar	VGMSE
satinándooslo	satinar	VGMSE
satinándomelos	satinar	VGMPE
satinándotelos	satinar	VGMPE
satinándoselos	satinar	VGMPE
satinándonoslos	satinar	VGMPE
satinándooslos	satinar	VGMPE
satinándomela	satinar	VGFSE
satinándotela	satinar	VGFSE
satinándosela	satinar	VGFSE
satinándonosla	satinar	VGFSE
satinándoosla	satinar	VGFSE
satinándomelas	satinar	VGFPE
satinándotelas	satinar	VGFPE
satinándoselas	satinar	VGFPE
satinándonoslas	satinar	VGFPE
satinándooslas	satinar	VGFPE
satirizar	satirizar	O
satirizo	satirizar	VIP1
satirizas	satirizar	VIP2
satiriza	satirizar	VIP3
satirizamos	satirizar	VIP4
satirizáis	satirizar	VIP5
satirizan	satirizar	VIP6
satirizaba	satirizar	VII1
satirizabas	satirizar	VII2
satirizábamos	satirizar	VII4
satirizabais	satirizar	VII5
satirizaban	satirizar	VII6
satirizaré	satirizar	VIF1
satirizarás	satirizar	VIF2
satirizará	satirizar	VIF3
satirizaremos	satirizar	VIF4
satirizaréis	satirizar	VIF5
satirizarán	satirizar	VIF6
satirizaría	satirizar	VIC1
satirizarías	satirizar	VIC2
satirizaría	satirizar	VIC3
satirizaríamos	satirizar	VIC4
satirizaríais	satirizar	VIC5
satirizarían	satirizar	VIC6
satiricé	satirizar	VIX1
satirizaste	satirizar	VIX2
satirizó	satirizar	VIX3
satirizasteis	satirizar	VIX5
satirizaron	satirizar	VIX6
satirice	satirizar	VSP1
satirices	satirizar	VSP2
satiricemos	satirizar	VSP4
satiricéis	satirizar	VSP5
satiricen	satirizar	VSP6
satirizara	satirizar	VSX1
satirizaras	satirizar	VSX2
satirizáramos	satirizar	VSX4
satirizarais	satirizar	VSX5
satirizaran	satirizar	VSX6
satirizare	satirizar	VSF1
satirizares	satirizar	VSF2
satirizáremos	satirizar	VSF4
satirizareis	satirizar	VSF5
satirizaren	satirizar	VSF6
satirizase	satirizar	VSI1
satirizases	satirizar	VSI2
satirizásemos	satirizar	VSI4
satirizaseis	satirizar	VSI5
satirizasen	satirizar	VSI6
satirizad	satirizar	VMP
satirizadme	satirizar	VMSE
satirizadle	satirizar	VMSE
satirizadnos	satirizar	VMPE
satirizaos	satirizar	VMPE
satirizadles	satirizar	VMPE
satirizadlo	satirizar	VMMSE
satirizadla	satirizar	VMFSE
satirizadlos	satirizar	VMMPE
satirizadlas	satirizar	VMFPE
satirizádmelo	satirizar	VMMSE
satirizádselo	satirizar	VMMSE
satirizádnoslo	satirizar	VMMSE
satirizáoslo	satirizar	VMMSE
satirizádmelos	satirizar	VMMPE
satirizádselos	satirizar	VMMPE
satirizádnoslos	satirizar	VMMPE
satirizáoslos	satirizar	VMMPE
satirizádmela	satirizar	VMFSE
satirizádsela	satirizar	VMFSE
satirizádnosla	satirizar	VMFSE
satirizáosla	satirizar	VMFSE
satirizádmelas	satirizar	VMFPE
satirizádselas	satirizar	VMFPE
satirizádnoslas	satirizar	VMFPE
satirizáoslas	satirizar	VMFPE
satirizado	satirizar	VPM
satirizados	satirizar	VPMP
satirizada	satirizar	VPF
satirizadas	satirizar	VPFP
satirizando	satirizar	VG
satirizándome	satirizar	VGSE
satirizándote	satirizar	VGSE
satirizándole	satirizar	VGSE
satirizándonos	satirizar	VGPE
satirizándoos	satirizar	VGPE
satirizándolo	satirizar	VGMSE
satirizándola	satirizar	VGFSE
satirizándolos	satirizar	VGMPE
satirizándolas	satirizar	VGFPE
satirizándomelo	satirizar	VGMSE
satirizándotelo	satirizar	VGMSE
satirizándoselo	satirizar	VGMSE
satirizándonoslo	satirizar	VGMSE
satirizándooslo	satirizar	VGMSE
satirizándomelos	satirizar	VGMPE
satirizándotelos	satirizar	VGMPE
satirizándoselos	satirizar	VGMPE
satirizándonoslos	satirizar	VGMPE
satirizándooslos	satirizar	VGMPE
satirizándomela	satirizar	VGFSE
satirizándotela	satirizar	VGFSE
satirizándosela	satirizar	VGFSE
satirizándonosla	satirizar	VGFSE
satirizándoosla	satirizar	VGFSE
satirizándomelas	satirizar	VGFPE
satirizándotelas	satirizar	VGFPE
satirizándoselas	satirizar	VGFPE
satirizándonoslas	satirizar	VGFPE
satirizándooslas	satirizar	VGFPE
saturar	saturar	O
saturo	saturar	VIP1
saturas	saturar	VIP2
satura	saturar	VIP3
saturamos	saturar	VIP4
saturáis	saturar	VIP5
saturan	saturar	VIP6
saturaba	saturar	VII1
saturabas	saturar	VII2
saturábamos	saturar	VII4
saturabais	saturar	VII5
saturaban	saturar	VII6
saturaré	saturar	VIF1
saturarás	saturar	VIF2
saturará	saturar	VIF3
saturaremos	saturar	VIF4
saturaréis	saturar	VIF5
saturarán	saturar	VIF6
saturaría	saturar	VIC1
saturarías	saturar	VIC2
saturaría	saturar	VIC3
saturaríamos	saturar	VIC4
saturaríais	saturar	VIC5
saturarían	saturar	VIC6
saturé	saturar	VIX1
saturaste	saturar	VIX2
saturó	saturar	VIX3
saturasteis	saturar	VIX5
saturaron	saturar	VIX6
sature	saturar	VSP1
satures	saturar	VSP2
saturemos	saturar	VSP4
saturéis	saturar	VSP5
saturen	saturar	VSP6
saturara	saturar	VSX1
saturaras	saturar	VSX2
saturáramos	saturar	VSX4
saturarais	saturar	VSX5
saturaran	saturar	VSX6
saturare	saturar	VSF1
saturares	saturar	VSF2
saturáremos	saturar	VSF4
saturareis	saturar	VSF5
saturaren	saturar	VSF6
saturase	saturar	VSI1
saturases	saturar	VSI2
saturásemos	saturar	VSI4
saturaseis	saturar	VSI5
saturasen	saturar	VSI6
saturad	saturar	VMP
saturadme	saturar	VMSE
saturadle	saturar	VMSE
saturadnos	saturar	VMPE
saturaos	saturar	VMPE
saturadles	saturar	VMPE
saturadlo	saturar	VMMSE
saturadla	saturar	VMFSE
saturadlos	saturar	VMMPE
saturadlas	saturar	VMFPE
saturádmelo	saturar	VMMSE
saturádselo	saturar	VMMSE
saturádnoslo	saturar	VMMSE
saturáoslo	saturar	VMMSE
saturádmelos	saturar	VMMPE
saturádselos	saturar	VMMPE
saturádnoslos	saturar	VMMPE
saturáoslos	saturar	VMMPE
saturádmela	saturar	VMFSE
saturádsela	saturar	VMFSE
saturádnosla	saturar	VMFSE
saturáosla	saturar	VMFSE
saturádmelas	saturar	VMFPE
saturádselas	saturar	VMFPE
saturádnoslas	saturar	VMFPE
saturáoslas	saturar	VMFPE
saturado	saturar	VPM
saturados	saturar	VPMP
saturada	saturar	VPF
saturadas	saturar	VPFP
saturando	saturar	VG
saturándome	saturar	VGSE
saturándote	saturar	VGSE
saturándole	saturar	VGSE
saturándonos	saturar	VGPE
saturándoos	saturar	VGPE
saturándolo	saturar	VGMSE
saturándola	saturar	VGFSE
saturándolos	saturar	VGMPE
saturándolas	saturar	VGFPE
saturándomelo	saturar	VGMSE
saturándotelo	saturar	VGMSE
saturándoselo	saturar	VGMSE
saturándonoslo	saturar	VGMSE
saturándooslo	saturar	VGMSE
saturándomelos	saturar	VGMPE
saturándotelos	saturar	VGMPE
saturándoselos	saturar	VGMPE
saturándonoslos	saturar	VGMPE
saturándooslos	saturar	VGMPE
saturándomela	saturar	VGFSE
saturándotela	saturar	VGFSE
saturándosela	saturar	VGFSE
saturándonosla	saturar	VGFSE
saturándoosla	saturar	VGFSE
saturándomelas	saturar	VGFPE
saturándotelas	saturar	VGFPE
saturándoselas	saturar	VGFPE
saturándonoslas	saturar	VGFPE
saturándooslas	saturar	VGFPE
