saque	saque	O
saques	saque	P
saqueador	saqueador	O
saqueadoras	saqueador	FP
saqueadora	saqueador	F
saqueadores	saqueador	P
saqueamiento	saqueamiento	O
saqueamientos	saqueamiento	P
saqueo	saqueo	O
saqueos	saqueo	P
saquero	saquero	O
saqueras	saquero	FP
saquera	saquero	F
saqueros	saquero	P
saquería	saquería	O
saquerías	saquería	P
saquerío	saquerío	O
saqueríos	saquerío	P
saquete	saquete	O
saquetes	saquete	P
saquilada	saquilada	O
saquiladas	saquilada	P
saqué	sacar	VIX1
saque	sacar	VSP1
saques	sacar	VSP2
saquemos	sacar	VSP4
saquéis	sacar	VSP5
saquen	sacar	VSP6
saquear	saquear	O
saqueo	saquear	VIP1
saqueas	saquear	VIP2
saquea	saquear	VIP3
saqueamos	saquear	VIP4
saqueáis	saquear	VIP5
saquean	saquear	VIP6
saqueaba	saquear	VII1
saqueabas	saquear	VII2
saqueábamos	saquear	VII4
saqueabais	saquear	VII5
saqueaban	saquear	VII6
saquearé	saquear	VIF1
saquearás	saquear	VIF2
saqueará	saquear	VIF3
saquearemos	saquear	VIF4
saquearéis	saquear	VIF5
saquearán	saquear	VIF6
saquearía	saquear	VIC1
saquearías	saquear	VIC2
saquearía	saquear	VIC3
saquearíamos	saquear	VIC4
saquearíais	saquear	VIC5
saquearían	saquear	VIC6
saqueé	saquear	VIX1
saqueaste	saquear	VIX2
saqueó	saquear	VIX3
saqueasteis	saquear	VIX5
saquearon	saquear	VIX6
saquee	saquear	VSP1
saquees	saquear	VSP2
saqueemos	saquear	VSP4
saqueéis	saquear	VSP5
saqueen	saquear	VSP6
saqueara	saquear	VSX1
saquearas	saquear	VSX2
saqueáramos	saquear	VSX4
saquearais	saquear	VSX5
saquearan	saquear	VSX6
saqueare	saquear	VSF1
saqueares	saquear	VSF2
saqueáremos	saquear	VSF4
saqueareis	saquear	VSF5
saquearen	saquear	VSF6
saquease	saquear	VSI1
saqueases	saquear	VSI2
saqueásemos	saquear	VSI4
saqueaseis	saquear	VSI5
saqueasen	saquear	VSI6
saquead	saquear	VMP
saqueadme	saquear	VMSE
saqueadle	saquear	VMSE
saqueadnos	saquear	VMPE
saqueaos	saquear	VMPE
saqueadles	saquear	VMPE
saqueadlo	saquear	VMMSE
saqueadla	saquear	VMFSE
saqueadlos	saquear	VMMPE
saqueadlas	saquear	VMFPE
saqueádmelo	saquear	VMMSE
saqueádselo	saquear	VMMSE
saqueádnoslo	saquear	VMMSE
saqueáoslo	saquear	VMMSE
saqueádmelos	saquear	VMMPE
saqueádselos	saquear	VMMPE
saqueádnoslos	saquear	VMMPE
saqueáoslos	saquear	VMMPE
saqueádmela	saquear	VMFSE
saqueádsela	saquear	VMFSE
saqueádnosla	saquear	VMFSE
saqueáosla	saquear	VMFSE
saqueádmelas	saquear	VMFPE
saqueádselas	saquear	VMFPE
saqueádnoslas	saquear	VMFPE
saqueáoslas	saquear	VMFPE
saqueado	saquear	VPM
saqueados	saquear	VPMP
saqueada	saquear	VPF
saqueadas	saquear	VPFP
saqueando	saquear	VG
saqueándome	saquear	VGSE
saqueándote	saquear	VGSE
saqueándole	saquear	VGSE
saqueándonos	saquear	VGPE
saqueándoos	saquear	VGPE
saqueándolo	saquear	VGMSE
saqueándola	saquear	VGFSE
saqueándolos	saquear	VGMPE
saqueándolas	saquear	VGFPE
saqueándomelo	saquear	VGMSE
saqueándotelo	saquear	VGMSE
saqueándoselo	saquear	VGMSE
saqueándonoslo	saquear	VGMSE
saqueándooslo	saquear	VGMSE
saqueándomelos	saquear	VGMPE
saqueándotelos	saquear	VGMPE
saqueándoselos	saquear	VGMPE
saqueándonoslos	saquear	VGMPE
saqueándooslos	saquear	VGMPE
saqueándomela	saquear	VGFSE
saqueándotela	saquear	VGFSE
saqueándosela	saquear	VGFSE
saqueándonosla	saquear	VGFSE
saqueándoosla	saquear	VGFSE
saqueándomelas	saquear	VGFPE
saqueándotelas	saquear	VGFPE
saqueándoselas	saquear	VGFPE
saqueándonoslas	saquear	VGFPE
saqueándooslas	saquear	VGFPE
