sel	sel	O
seles	sel	P
selacio	selacio	O
selacias	selacio	FP
selacia	selacio	F
selacios	selacio	P
seleccionado	seleccionado	O
seleccionados	seleccionado	P
seleccionador	seleccionador	O
seleccionadoras	seleccionador	FP
seleccionadora	seleccionador	F
seleccionadores	seleccionador	P
seleccionismo	seleccionismo	O
seleccionismos	seleccionismo	P
selección	selección	O
selecciones	selección	P
selectas	selectas	O
selectividad	selectividad	O
selectividades	selectividad	P
selectivo	selectivo	O
selectivas	selectivo	FP
selectiva	selectivo	F
selectivos	selectivo	P
selecto	selecto	O
selectas	selecto	FP
selecta	selecto	F
selectos	selecto	P
selector	selector	O
selectoras	selector	FP
selectora	selector	F
selectores	selector	P
selenio	selenio	O
selenios	selenio	P
selenita	selenita	O
selenitas	selenita	P
selenitoso	selenitoso	O
selenitosas	selenitoso	FP
selenitosa	selenitoso	F
selenitosos	selenitoso	P
seleniuro	seleniuro	O
seleniuros	seleniuro	P
selenografía	selenografía	O
selenografías	selenografía	P
selenosis	selenosis	O
selenógrafo	selenógrafo	O
selenógrafas	selenógrafo	FP
selenógrafa	selenógrafo	F
selenógrafos	selenógrafo	P
selfservice	selfservice	O
selfservices	selfservice	P
sellado	sellado	O
sellados	sellado	P
sellador	sellador	O
selladoras	sellador	FP
selladora	sellador	F
selladores	sellador	P
selladura	selladura	O
selladuras	selladura	P
sello	sello	O
sellos	sello	P
selva	selva	O
selvas	selva	P
selvaje	selvaje	O
selvajes	selvaje	P
selvajino	selvajino	O
selvajinas	selvajino	FP
selvajina	selvajino	F
selvajinos	selvajino	P
selvatiquez	selvatiquez	O
selvatiqueces	selvatiquez	P
selvicultura	selvicultura	O
selviculturas	selvicultura	P
selvoso	selvoso	O
selvosas	selvoso	FP
selvosa	selvoso	F
selvosos	selvoso	P
selvático	selvático	O
selváticas	selvático	FP
selvática	selvático	F
selváticos	selvático	P
selénico	selénico	O
selénicas	selénico	FP
selénica	selénico	F
selénicos	selénico	P
seleccionar	seleccionar	O
selecciono	seleccionar	VIP1
seleccionas	seleccionar	VIP2
selecciona	seleccionar	VIP3
seleccionamos	seleccionar	VIP4
seleccionáis	seleccionar	VIP5
seleccionan	seleccionar	VIP6
seleccionaba	seleccionar	VII1
seleccionabas	seleccionar	VII2
seleccionábamos	seleccionar	VII4
seleccionabais	seleccionar	VII5
seleccionaban	seleccionar	VII6
seleccionaré	seleccionar	VIF1
seleccionarás	seleccionar	VIF2
seleccionará	seleccionar	VIF3
seleccionaremos	seleccionar	VIF4
seleccionaréis	seleccionar	VIF5
seleccionarán	seleccionar	VIF6
seleccionaría	seleccionar	VIC1
seleccionarías	seleccionar	VIC2
seleccionaría	seleccionar	VIC3
seleccionaríamos	seleccionar	VIC4
seleccionaríais	seleccionar	VIC5
seleccionarían	seleccionar	VIC6
seleccioné	seleccionar	VIX1
seleccionaste	seleccionar	VIX2
seleccionó	seleccionar	VIX3
seleccionasteis	seleccionar	VIX5
seleccionaron	seleccionar	VIX6
seleccione	seleccionar	VSP1
selecciones	seleccionar	VSP2
seleccionemos	seleccionar	VSP4
seleccionéis	seleccionar	VSP5
seleccionen	seleccionar	VSP6
seleccionara	seleccionar	VSX1
seleccionaras	seleccionar	VSX2
seleccionáramos	seleccionar	VSX4
seleccionarais	seleccionar	VSX5
seleccionaran	seleccionar	VSX6
seleccionare	seleccionar	VSF1
seleccionares	seleccionar	VSF2
seleccionáremos	seleccionar	VSF4
seleccionareis	seleccionar	VSF5
seleccionaren	seleccionar	VSF6
seleccionase	seleccionar	VSI1
seleccionases	seleccionar	VSI2
seleccionásemos	seleccionar	VSI4
seleccionaseis	seleccionar	VSI5
seleccionasen	seleccionar	VSI6
seleccionad	seleccionar	VMP
seleccionadme	seleccionar	VMSE
seleccionadle	seleccionar	VMSE
seleccionadnos	seleccionar	VMPE
seleccionaos	seleccionar	VMPE
seleccionadles	seleccionar	VMPE
seleccionadlo	seleccionar	VMMSE
seleccionadla	seleccionar	VMFSE
seleccionadlos	seleccionar	VMMPE
seleccionadlas	seleccionar	VMFPE
seleccionádmelo	seleccionar	VMMSE
seleccionádselo	seleccionar	VMMSE
seleccionádnoslo	seleccionar	VMMSE
seleccionáoslo	seleccionar	VMMSE
seleccionádmelos	seleccionar	VMMPE
seleccionádselos	seleccionar	VMMPE
seleccionádnoslos	seleccionar	VMMPE
seleccionáoslos	seleccionar	VMMPE
seleccionádmela	seleccionar	VMFSE
seleccionádsela	seleccionar	VMFSE
seleccionádnosla	seleccionar	VMFSE
seleccionáosla	seleccionar	VMFSE
seleccionádmelas	seleccionar	VMFPE
seleccionádselas	seleccionar	VMFPE
seleccionádnoslas	seleccionar	VMFPE
seleccionáoslas	seleccionar	VMFPE
seleccionado	seleccionar	VPM
seleccionados	seleccionar	VPMP
seleccionada	seleccionar	VPF
seleccionadas	seleccionar	VPFP
seleccionando	seleccionar	VG
seleccionándome	seleccionar	VGSE
seleccionándote	seleccionar	VGSE
seleccionándole	seleccionar	VGSE
seleccionándonos	seleccionar	VGPE
seleccionándoos	seleccionar	VGPE
seleccionándolo	seleccionar	VGMSE
seleccionándola	seleccionar	VGFSE
seleccionándolos	seleccionar	VGMPE
seleccionándolas	seleccionar	VGFPE
seleccionándomelo	seleccionar	VGMSE
seleccionándotelo	seleccionar	VGMSE
seleccionándoselo	seleccionar	VGMSE
seleccionándonoslo	seleccionar	VGMSE
seleccionándooslo	seleccionar	VGMSE
seleccionándomelos	seleccionar	VGMPE
seleccionándotelos	seleccionar	VGMPE
seleccionándoselos	seleccionar	VGMPE
seleccionándonoslos	seleccionar	VGMPE
seleccionándooslos	seleccionar	VGMPE
seleccionándomela	seleccionar	VGFSE
seleccionándotela	seleccionar	VGFSE
seleccionándosela	seleccionar	VGFSE
seleccionándonosla	seleccionar	VGFSE
seleccionándoosla	seleccionar	VGFSE
seleccionándomelas	seleccionar	VGFPE
seleccionándotelas	seleccionar	VGFPE
seleccionándoselas	seleccionar	VGFPE
seleccionándonoslas	seleccionar	VGFPE
seleccionándooslas	seleccionar	VGFPE
sellar	sellar	O
sello	sellar	VIP1
sellas	sellar	VIP2
sella	sellar	VIP3
sellamos	sellar	VIP4
selláis	sellar	VIP5
sellan	sellar	VIP6
sellaba	sellar	VII1
sellabas	sellar	VII2
sellábamos	sellar	VII4
sellabais	sellar	VII5
sellaban	sellar	VII6
sellaré	sellar	VIF1
sellarás	sellar	VIF2
sellará	sellar	VIF3
sellaremos	sellar	VIF4
sellaréis	sellar	VIF5
sellarán	sellar	VIF6
sellaría	sellar	VIC1
sellarías	sellar	VIC2
sellaría	sellar	VIC3
sellaríamos	sellar	VIC4
sellaríais	sellar	VIC5
sellarían	sellar	VIC6
sellé	sellar	VIX1
sellaste	sellar	VIX2
selló	sellar	VIX3
sellasteis	sellar	VIX5
sellaron	sellar	VIX6
selle	sellar	VSP1
selles	sellar	VSP2
sellemos	sellar	VSP4
selléis	sellar	VSP5
sellen	sellar	VSP6
sellara	sellar	VSX1
sellaras	sellar	VSX2
selláramos	sellar	VSX4
sellarais	sellar	VSX5
sellaran	sellar	VSX6
sellare	sellar	VSF1
sellares	sellar	VSF2
selláremos	sellar	VSF4
sellareis	sellar	VSF5
sellaren	sellar	VSF6
sellase	sellar	VSI1
sellases	sellar	VSI2
sellásemos	sellar	VSI4
sellaseis	sellar	VSI5
sellasen	sellar	VSI6
sellad	sellar	VMP
selladme	sellar	VMSE
selladle	sellar	VMSE
selladnos	sellar	VMPE
sellaos	sellar	VMPE
selladles	sellar	VMPE
selladlo	sellar	VMMSE
selladla	sellar	VMFSE
selladlos	sellar	VMMPE
selladlas	sellar	VMFPE
selládmelo	sellar	VMMSE
selládselo	sellar	VMMSE
selládnoslo	sellar	VMMSE
selláoslo	sellar	VMMSE
selládmelos	sellar	VMMPE
selládselos	sellar	VMMPE
selládnoslos	sellar	VMMPE
selláoslos	sellar	VMMPE
selládmela	sellar	VMFSE
selládsela	sellar	VMFSE
selládnosla	sellar	VMFSE
selláosla	sellar	VMFSE
selládmelas	sellar	VMFPE
selládselas	sellar	VMFPE
selládnoslas	sellar	VMFPE
selláoslas	sellar	VMFPE
sellado	sellar	VPM
sellados	sellar	VPMP
sellada	sellar	VPF
selladas	sellar	VPFP
sellando	sellar	VG
sellándome	sellar	VGSE
sellándote	sellar	VGSE
sellándole	sellar	VGSE
sellándonos	sellar	VGPE
sellándoos	sellar	VGPE
sellándolo	sellar	VGMSE
sellándola	sellar	VGFSE
sellándolos	sellar	VGMPE
sellándolas	sellar	VGFPE
sellándomelo	sellar	VGMSE
sellándotelo	sellar	VGMSE
sellándoselo	sellar	VGMSE
sellándonoslo	sellar	VGMSE
sellándooslo	sellar	VGMSE
sellándomelos	sellar	VGMPE
sellándotelos	sellar	VGMPE
sellándoselos	sellar	VGMPE
sellándonoslos	sellar	VGMPE
sellándooslos	sellar	VGMPE
sellándomela	sellar	VGFSE
sellándotela	sellar	VGFSE
sellándosela	sellar	VGFSE
sellándonosla	sellar	VGFSE
sellándoosla	sellar	VGFSE
sellándomelas	sellar	VGFPE
sellándotelas	sellar	VGFPE
sellándoselas	sellar	VGFPE
sellándonoslas	sellar	VGFPE
sellándooslas	sellar	VGFPE
