sega	sega	O
segas	sega	P
segable	segable	O
segables	segable	P
segada	segada	O
segadas	segada	P
segadero	segadero	O
segaderas	segadero	FP
segadera	segadero	F
segaderos	segadero	P
segador	segador	O
segadoras	segador	FP
segadora	segador	F
segadores	segador	P
segallo	segallo	O
segallos	segallo	P
segazón	segazón	O
segazones	segazón	P
seglar	seglar	O
seglares	seglar	P
seglarmente	seglarmente	O
segmentación	segmentación	O
segmentaciones	segmentación	P
segmentado	segmentado	O
segmentadas	segmentado	FP
segmentada	segmentado	F
segmentados	segmentado	P
segmento	segmento	O
segmentos	segmento	P
segobricense	segobricense	O
segobricenses	segobricense	P
segobrigense	segobrigense	O
segobrigenses	segobrigense	P
segorbino	segorbino	O
segorbinas	segorbino	FP
segorbina	segorbino	F
segorbinos	segorbino	P
segote	segote	O
segotes	segote	P
segoviano	segoviano	O
segovianas	segoviano	FP
segoviana	segoviano	F
segovianos	segoviano	P
segoviense	segoviense	O
segovienses	segoviense	P
segregacionismo	segregacionismo	O
segregacionismos	segregacionismo	P
segregacionista	segregacionista	O
segregacionistas	segregacionista	P
segregación	segregación	O
segregaciones	segregación	P
segregativo	segregativo	O
segregativas	segregativo	FP
segregativa	segregativo	F
segregativos	segregativo	P
segrí	segrí	O
segríes	segrí	P
segueta	segueta	O
seguetas	segueta	P
seguida	seguida	O
seguidas	seguida	P
seguidamente	seguidamente	O
seguidero	seguidero	O
seguideros	seguidero	P
seguidilla	seguidilla	O
seguidillas	seguidilla	P
seguido	seguido	O
seguidas	seguido	FP
seguida	seguido	F
seguidos	seguido	P
seguidor	seguidor	O
seguidoras	seguidor	FP
seguidora	seguidor	F
seguidores	seguidor	P
seguimiento	seguimiento	O
seguimientos	seguimiento	P
segunda	segunda	O
segundas	segunda	P
segundamente	segundamente	O
segundariamente	segundariamente	O
segundario	segundario	O
segundarias	segundario	FP
segundaria	segundario	F
segundarios	segundario	P
segundero	segundero	O
segunderas	segundero	FP
segundera	segundero	F
segunderos	segundero	P
segundilla	segundilla	O
segundillas	segundilla	P
segundillo	segundillo	O
segundillos	segundillo	P
segundo	segundo	O
segundas	segundo	FP
segunda	segundo	F
segundos	segundo	P
segundogenitura	segundogenitura	O
segundogenituras	segundogenitura	P
segundogénito	segundogénito	O
segundogénitas	segundogénito	FP
segundogénita	segundogénito	F
segundogénitos	segundogénito	P
segundón	segundón	O
segundonas	segundón	FP
segundona	segundón	F
segundones	segundón	P
seguntino	seguntino	O
seguntinas	seguntino	FP
seguntina	seguntino	F
seguntinos	seguntino	P
segur	segur	O
segures	segur	P
segurador	segurador	O
seguradores	segurador	P
seguramente	seguramente	O
seguramiento	seguramiento	O
seguramientos	seguramiento	P
seguranza	seguranza	O
seguranzas	seguranza	P
segureja	segureja	O
segurejas	segureja	P
seguridad	seguridad	O
seguridades	seguridad	P
seguro	seguro	O
seguras	seguro	FP
segura	seguro	F
seguros	seguro	P
según	según	O
segunes	según	P
seguir	seguir	O
seguimos	seguir	VIP4
seguís	seguir	VIP5
seguía	seguir	VII1
seguías	seguir	VII2
seguíamos	seguir	VII4
seguíais	seguir	VII5
seguían	seguir	VII6
seguiré	seguir	VIF1
seguirás	seguir	VIF2
seguirá	seguir	VIF3
seguiremos	seguir	VIF4
seguiréis	seguir	VIF5
seguirán	seguir	VIF6
seguiría	seguir	VIC1
seguirías	seguir	VIC2
seguiría	seguir	VIC3
seguiríamos	seguir	VIC4
seguiríais	seguir	VIC5
seguirían	seguir	VIC6
seguí	seguir	VIX1
seguiste	seguir	VIX2
seguisteis	seguir	VIX5
seguid	seguir	VMP
seguidme	seguir	VMSE
seguidle	seguir	VMSE
seguidnos	seguir	VMPE
seguios	seguir	VMPE
seguidles	seguir	VMPE
seguidlo	seguir	VMMSE
seguidla	seguir	VMFSE
seguidlos	seguir	VMMPE
seguidlas	seguir	VMFPE
seguídmelo	seguir	VMMSE
seguídselo	seguir	VMMSE
seguídnoslo	seguir	VMMSE
seguíoslo	seguir	VMMSE
seguídmelos	seguir	VMMPE
seguídselos	seguir	VMMPE
seguídnoslos	seguir	VMMPE
seguíoslos	seguir	VMMPE
seguídmela	seguir	VMFSE
seguídsela	seguir	VMFSE
seguídnosla	seguir	VMFSE
seguíosla	seguir	VMFSE
seguídmelas	seguir	VMFPE
seguídselas	seguir	VMFPE
seguídnoslas	seguir	VMFPE
seguíoslas	seguir	VMFPE
seguido	seguir	VPM
seguidos	seguir	VPMP
seguida	seguir	VPF
seguidas	seguir	VPFP
segar	segar	O
segamos	segar	VIP4
segáis	segar	VIP5
segaba	segar	VII1
segabas	segar	VII2
segábamos	segar	VII4
segabais	segar	VII5
segaban	segar	VII6
segaré	segar	VIF1
segarás	segar	VIF2
segará	segar	VIF3
segaremos	segar	VIF4
segaréis	segar	VIF5
segarán	segar	VIF6
segaría	segar	VIC1
segarías	segar	VIC2
segaría	segar	VIC3
segaríamos	segar	VIC4
segaríais	segar	VIC5
segarían	segar	VIC6
segé	segar	VIX1
segaste	segar	VIX2
segó	segar	VIX3
segasteis	segar	VIX5
segaron	segar	VIX6
seguemos	segar	VSP4
seguéis	segar	VSP5
segara	segar	VSX1
segaras	segar	VSX2
segáramos	segar	VSX4
segarais	segar	VSX5
segaran	segar	VSX6
segare	segar	VSF1
segares	segar	VSF2
segáremos	segar	VSF4
segareis	segar	VSF5
segaren	segar	VSF6
segase	segar	VSI1
segases	segar	VSI2
segásemos	segar	VSI4
segaseis	segar	VSI5
segasen	segar	VSI6
segad	segar	VMP
segadme	segar	VMSE
segadle	segar	VMSE
segadnos	segar	VMPE
segaos	segar	VMPE
segadles	segar	VMPE
segadlo	segar	VMMSE
segadla	segar	VMFSE
segadlos	segar	VMMPE
segadlas	segar	VMFPE
segádmelo	segar	VMMSE
segádselo	segar	VMMSE
segádnoslo	segar	VMMSE
segáoslo	segar	VMMSE
segádmelos	segar	VMMPE
segádselos	segar	VMMPE
segádnoslos	segar	VMMPE
segáoslos	segar	VMMPE
segádmela	segar	VMFSE
segádsela	segar	VMFSE
segádnosla	segar	VMFSE
segáosla	segar	VMFSE
segádmelas	segar	VMFPE
segádselas	segar	VMFPE
segádnoslas	segar	VMFPE
segáoslas	segar	VMFPE
segado	segar	VPM
segados	segar	VPMP
segada	segar	VPF
segadas	segar	VPFP
segando	segar	VG
segándome	segar	VGSE
segándote	segar	VGSE
segándole	segar	VGSE
segándonos	segar	VGPE
segándoos	segar	VGPE
segándolo	segar	VGMSE
segándola	segar	VGFSE
segándolos	segar	VGMPE
segándolas	segar	VGFPE
segándomelo	segar	VGMSE
segándotelo	segar	VGMSE
segándoselo	segar	VGMSE
segándonoslo	segar	VGMSE
segándooslo	segar	VGMSE
segándomelos	segar	VGMPE
segándotelos	segar	VGMPE
segándoselos	segar	VGMPE
segándonoslos	segar	VGMPE
segándooslos	segar	VGMPE
segándomela	segar	VGFSE
segándotela	segar	VGFSE
segándosela	segar	VGFSE
segándonosla	segar	VGFSE
segándoosla	segar	VGFSE
segándomelas	segar	VGFPE
segándotelas	segar	VGFPE
segándoselas	segar	VGFPE
segándonoslas	segar	VGFPE
segándooslas	segar	VGFPE
segmentar	segmentar	O
segmento	segmentar	VIP1
segmentas	segmentar	VIP2
segmenta	segmentar	VIP3
segmentamos	segmentar	VIP4
segmentáis	segmentar	VIP5
segmentan	segmentar	VIP6
segmentaba	segmentar	VII1
segmentabas	segmentar	VII2
segmentábamos	segmentar	VII4
segmentabais	segmentar	VII5
segmentaban	segmentar	VII6
segmentaré	segmentar	VIF1
segmentarás	segmentar	VIF2
segmentará	segmentar	VIF3
segmentaremos	segmentar	VIF4
segmentaréis	segmentar	VIF5
segmentarán	segmentar	VIF6
segmentaría	segmentar	VIC1
segmentarías	segmentar	VIC2
segmentaría	segmentar	VIC3
segmentaríamos	segmentar	VIC4
segmentaríais	segmentar	VIC5
segmentarían	segmentar	VIC6
segmenté	segmentar	VIX1
segmentaste	segmentar	VIX2
segmentó	segmentar	VIX3
segmentasteis	segmentar	VIX5
segmentaron	segmentar	VIX6
segmente	segmentar	VSP1
segmentes	segmentar	VSP2
segmentemos	segmentar	VSP4
segmentéis	segmentar	VSP5
segmenten	segmentar	VSP6
segmentara	segmentar	VSX1
segmentaras	segmentar	VSX2
segmentáramos	segmentar	VSX4
segmentarais	segmentar	VSX5
segmentaran	segmentar	VSX6
segmentare	segmentar	VSF1
segmentares	segmentar	VSF2
segmentáremos	segmentar	VSF4
segmentareis	segmentar	VSF5
segmentaren	segmentar	VSF6
segmentase	segmentar	VSI1
segmentases	segmentar	VSI2
segmentásemos	segmentar	VSI4
segmentaseis	segmentar	VSI5
segmentasen	segmentar	VSI6
segmentad	segmentar	VMP
segmentadme	segmentar	VMSE
segmentadle	segmentar	VMSE
segmentadnos	segmentar	VMPE
segmentaos	segmentar	VMPE
segmentadles	segmentar	VMPE
segmentadlo	segmentar	VMMSE
segmentadla	segmentar	VMFSE
segmentadlos	segmentar	VMMPE
segmentadlas	segmentar	VMFPE
segmentádmelo	segmentar	VMMSE
segmentádselo	segmentar	VMMSE
segmentádnoslo	segmentar	VMMSE
segmentáoslo	segmentar	VMMSE
segmentádmelos	segmentar	VMMPE
segmentádselos	segmentar	VMMPE
segmentádnoslos	segmentar	VMMPE
segmentáoslos	segmentar	VMMPE
segmentádmela	segmentar	VMFSE
segmentádsela	segmentar	VMFSE
segmentádnosla	segmentar	VMFSE
segmentáosla	segmentar	VMFSE
segmentádmelas	segmentar	VMFPE
segmentádselas	segmentar	VMFPE
segmentádnoslas	segmentar	VMFPE
segmentáoslas	segmentar	VMFPE
segmentado	segmentar	VPM
segmentados	segmentar	VPMP
segmentada	segmentar	VPF
segmentadas	segmentar	VPFP
segmentando	segmentar	VG
segmentándome	segmentar	VGSE
segmentándote	segmentar	VGSE
segmentándole	segmentar	VGSE
segmentándonos	segmentar	VGPE
segmentándoos	segmentar	VGPE
segmentándolo	segmentar	VGMSE
segmentándola	segmentar	VGFSE
segmentándolos	segmentar	VGMPE
segmentándolas	segmentar	VGFPE
segmentándomelo	segmentar	VGMSE
segmentándotelo	segmentar	VGMSE
segmentándoselo	segmentar	VGMSE
segmentándonoslo	segmentar	VGMSE
segmentándooslo	segmentar	VGMSE
segmentándomelos	segmentar	VGMPE
segmentándotelos	segmentar	VGMPE
segmentándoselos	segmentar	VGMPE
segmentándonoslos	segmentar	VGMPE
segmentándooslos	segmentar	VGMPE
segmentándomela	segmentar	VGFSE
segmentándotela	segmentar	VGFSE
segmentándosela	segmentar	VGFSE
segmentándonosla	segmentar	VGFSE
segmentándoosla	segmentar	VGFSE
segmentándomelas	segmentar	VGFPE
segmentándotelas	segmentar	VGFPE
segmentándoselas	segmentar	VGFPE
segmentándonoslas	segmentar	VGFPE
segmentándooslas	segmentar	VGFPE
segregar	segregar	O
segrego	segregar	VIP1
segregas	segregar	VIP2
segrega	segregar	VIP3
segregamos	segregar	VIP4
segregáis	segregar	VIP5
segregan	segregar	VIP6
segregaba	segregar	VII1
segregabas	segregar	VII2
segregábamos	segregar	VII4
segregabais	segregar	VII5
segregaban	segregar	VII6
segregaré	segregar	VIF1
segregarás	segregar	VIF2
segregará	segregar	VIF3
segregaremos	segregar	VIF4
segregaréis	segregar	VIF5
segregarán	segregar	VIF6
segregaría	segregar	VIC1
segregarías	segregar	VIC2
segregaría	segregar	VIC3
segregaríamos	segregar	VIC4
segregaríais	segregar	VIC5
segregarían	segregar	VIC6
segregé	segregar	VIX1
segregaste	segregar	VIX2
segregó	segregar	VIX3
segregasteis	segregar	VIX5
segregaron	segregar	VIX6
segregue	segregar	VSP1
segregues	segregar	VSP2
segreguemos	segregar	VSP4
segreguéis	segregar	VSP5
segreguen	segregar	VSP6
segregara	segregar	VSX1
segregaras	segregar	VSX2
segregáramos	segregar	VSX4
segregarais	segregar	VSX5
segregaran	segregar	VSX6
segregare	segregar	VSF1
segregares	segregar	VSF2
segregáremos	segregar	VSF4
segregareis	segregar	VSF5
segregaren	segregar	VSF6
segregase	segregar	VSI1
segregases	segregar	VSI2
segregásemos	segregar	VSI4
segregaseis	segregar	VSI5
segregasen	segregar	VSI6
segregad	segregar	VMP
segregadme	segregar	VMSE
segregadle	segregar	VMSE
segregadnos	segregar	VMPE
segregaos	segregar	VMPE
segregadles	segregar	VMPE
segregadlo	segregar	VMMSE
segregadla	segregar	VMFSE
segregadlos	segregar	VMMPE
segregadlas	segregar	VMFPE
segregádmelo	segregar	VMMSE
segregádselo	segregar	VMMSE
segregádnoslo	segregar	VMMSE
segregáoslo	segregar	VMMSE
segregádmelos	segregar	VMMPE
segregádselos	segregar	VMMPE
segregádnoslos	segregar	VMMPE
segregáoslos	segregar	VMMPE
segregádmela	segregar	VMFSE
segregádsela	segregar	VMFSE
segregádnosla	segregar	VMFSE
segregáosla	segregar	VMFSE
segregádmelas	segregar	VMFPE
segregádselas	segregar	VMFPE
segregádnoslas	segregar	VMFPE
segregáoslas	segregar	VMFPE
segregado	segregar	VPM
segregados	segregar	VPMP
segregada	segregar	VPF
segregadas	segregar	VPFP
segregando	segregar	VG
segregándome	segregar	VGSE
segregándote	segregar	VGSE
segregándole	segregar	VGSE
segregándonos	segregar	VGPE
segregándoos	segregar	VGPE
segregándolo	segregar	VGMSE
segregándola	segregar	VGFSE
segregándolos	segregar	VGMPE
segregándolas	segregar	VGFPE
segregándomelo	segregar	VGMSE
segregándotelo	segregar	VGMSE
segregándoselo	segregar	VGMSE
segregándonoslo	segregar	VGMSE
segregándooslo	segregar	VGMSE
segregándomelos	segregar	VGMPE
segregándotelos	segregar	VGMPE
segregándoselos	segregar	VGMPE
segregándonoslos	segregar	VGMPE
segregándooslos	segregar	VGMPE
segregándomela	segregar	VGFSE
segregándotela	segregar	VGFSE
segregándosela	segregar	VGFSE
segregándonosla	segregar	VGFSE
segregándoosla	segregar	VGFSE
segregándomelas	segregar	VGFPE
segregándotelas	segregar	VGFPE
segregándoselas	segregar	VGFPE
segregándonoslas	segregar	VGFPE
segregándooslas	segregar	VGFPE
segudar	segudar	O
segudo	segudar	VIP1
segudas	segudar	VIP2
seguda	segudar	VIP3
segudamos	segudar	VIP4
segudáis	segudar	VIP5
segudan	segudar	VIP6
segudaba	segudar	VII1
segudabas	segudar	VII2
segudábamos	segudar	VII4
segudabais	segudar	VII5
segudaban	segudar	VII6
segudaré	segudar	VIF1
segudarás	segudar	VIF2
segudará	segudar	VIF3
segudaremos	segudar	VIF4
segudaréis	segudar	VIF5
segudarán	segudar	VIF6
segudaría	segudar	VIC1
segudarías	segudar	VIC2
segudaría	segudar	VIC3
segudaríamos	segudar	VIC4
segudaríais	segudar	VIC5
segudarían	segudar	VIC6
segudé	segudar	VIX1
segudaste	segudar	VIX2
segudó	segudar	VIX3
segudasteis	segudar	VIX5
segudaron	segudar	VIX6
segude	segudar	VSP1
segudes	segudar	VSP2
segudemos	segudar	VSP4
segudéis	segudar	VSP5
seguden	segudar	VSP6
segudara	segudar	VSX1
segudaras	segudar	VSX2
segudáramos	segudar	VSX4
segudarais	segudar	VSX5
segudaran	segudar	VSX6
segudare	segudar	VSF1
segudares	segudar	VSF2
segudáremos	segudar	VSF4
segudareis	segudar	VSF5
segudaren	segudar	VSF6
segudase	segudar	VSI1
segudases	segudar	VSI2
segudásemos	segudar	VSI4
segudaseis	segudar	VSI5
segudasen	segudar	VSI6
segudad	segudar	VMP
segudadme	segudar	VMSE
segudadle	segudar	VMSE
segudadnos	segudar	VMPE
segudaos	segudar	VMPE
segudadles	segudar	VMPE
segudadlo	segudar	VMMSE
segudadla	segudar	VMFSE
segudadlos	segudar	VMMPE
segudadlas	segudar	VMFPE
segudádmelo	segudar	VMMSE
segudádselo	segudar	VMMSE
segudádnoslo	segudar	VMMSE
segudáoslo	segudar	VMMSE
segudádmelos	segudar	VMMPE
segudádselos	segudar	VMMPE
segudádnoslos	segudar	VMMPE
segudáoslos	segudar	VMMPE
segudádmela	segudar	VMFSE
segudádsela	segudar	VMFSE
segudádnosla	segudar	VMFSE
segudáosla	segudar	VMFSE
segudádmelas	segudar	VMFPE
segudádselas	segudar	VMFPE
segudádnoslas	segudar	VMFPE
segudáoslas	segudar	VMFPE
segudado	segudar	VPM
segudados	segudar	VPMP
segudada	segudar	VPF
segudadas	segudar	VPFP
segudando	segudar	VG
segudándome	segudar	VGSE
segudándote	segudar	VGSE
segudándole	segudar	VGSE
segudándonos	segudar	VGPE
segudándoos	segudar	VGPE
segudándolo	segudar	VGMSE
segudándola	segudar	VGFSE
segudándolos	segudar	VGMPE
segudándolas	segudar	VGFPE
segudándomelo	segudar	VGMSE
segudándotelo	segudar	VGMSE
segudándoselo	segudar	VGMSE
segudándonoslo	segudar	VGMSE
segudándooslo	segudar	VGMSE
segudándomelos	segudar	VGMPE
segudándotelos	segudar	VGMPE
segudándoselos	segudar	VGMPE
segudándonoslos	segudar	VGMPE
segudándooslos	segudar	VGMPE
segudándomela	segudar	VGFSE
segudándotela	segudar	VGFSE
segudándosela	segudar	VGFSE
segudándonosla	segudar	VGFSE
segudándoosla	segudar	VGFSE
segudándomelas	segudar	VGFPE
segudándotelas	segudar	VGFPE
segudándoselas	segudar	VGFPE
segudándonoslas	segudar	VGFPE
segudándooslas	segudar	VGFPE
seguetear	seguetear	O
segueteo	seguetear	VIP1
segueteas	seguetear	VIP2
seguetea	seguetear	VIP3
segueteamos	seguetear	VIP4
segueteáis	seguetear	VIP5
seguetean	seguetear	VIP6
segueteaba	seguetear	VII1
segueteabas	seguetear	VII2
segueteábamos	seguetear	VII4
segueteabais	seguetear	VII5
segueteaban	seguetear	VII6
seguetearé	seguetear	VIF1
seguetearás	seguetear	VIF2
segueteará	seguetear	VIF3
seguetearemos	seguetear	VIF4
seguetearéis	seguetear	VIF5
seguetearán	seguetear	VIF6
seguetearía	seguetear	VIC1
seguetearías	seguetear	VIC2
seguetearía	seguetear	VIC3
seguetearíamos	seguetear	VIC4
seguetearíais	seguetear	VIC5
seguetearían	seguetear	VIC6
segueteé	seguetear	VIX1
segueteaste	seguetear	VIX2
segueteó	seguetear	VIX3
segueteasteis	seguetear	VIX5
seguetearon	seguetear	VIX6
seguetee	seguetear	VSP1
seguetees	seguetear	VSP2
segueteemos	seguetear	VSP4
segueteéis	seguetear	VSP5
segueteen	seguetear	VSP6
segueteara	seguetear	VSX1
seguetearas	seguetear	VSX2
segueteáramos	seguetear	VSX4
seguetearais	seguetear	VSX5
seguetearan	seguetear	VSX6
segueteare	seguetear	VSF1
segueteares	seguetear	VSF2
segueteáremos	seguetear	VSF4
segueteareis	seguetear	VSF5
seguetearen	seguetear	VSF6
seguetease	seguetear	VSI1
segueteases	seguetear	VSI2
segueteásemos	seguetear	VSI4
segueteaseis	seguetear	VSI5
segueteasen	seguetear	VSI6
seguetead	seguetear	VMP
segueteadme	seguetear	VMSE
segueteadle	seguetear	VMSE
segueteadnos	seguetear	VMPE
segueteaos	seguetear	VMPE
segueteadles	seguetear	VMPE
segueteado	seguetear	VPM
segueteados	seguetear	VPMP
segueteada	seguetear	VPF
segueteadas	seguetear	VPFP
segueteando	seguetear	VG
segueteándome	seguetear	VGSE
segueteándote	seguetear	VGSE
segueteándole	seguetear	VGSE
segueteándonos	seguetear	VGPE
segueteándoos	seguetear	VGPE
segundar	segundar	O
segundo	segundar	VIP1
segundas	segundar	VIP2
segunda	segundar	VIP3
segundamos	segundar	VIP4
segundáis	segundar	VIP5
segundan	segundar	VIP6
segundaba	segundar	VII1
segundabas	segundar	VII2
segundábamos	segundar	VII4
segundabais	segundar	VII5
segundaban	segundar	VII6
segundaré	segundar	VIF1
segundarás	segundar	VIF2
segundará	segundar	VIF3
segundaremos	segundar	VIF4
segundaréis	segundar	VIF5
segundarán	segundar	VIF6
segundaría	segundar	VIC1
segundarías	segundar	VIC2
segundaría	segundar	VIC3
segundaríamos	segundar	VIC4
segundaríais	segundar	VIC5
segundarían	segundar	VIC6
segundé	segundar	VIX1
segundaste	segundar	VIX2
segundó	segundar	VIX3
segundasteis	segundar	VIX5
segundaron	segundar	VIX6
segunde	segundar	VSP1
segundes	segundar	VSP2
segundemos	segundar	VSP4
segundéis	segundar	VSP5
segunden	segundar	VSP6
segundara	segundar	VSX1
segundaras	segundar	VSX2
segundáramos	segundar	VSX4
segundarais	segundar	VSX5
segundaran	segundar	VSX6
segundare	segundar	VSF1
segundares	segundar	VSF2
segundáremos	segundar	VSF4
segundareis	segundar	VSF5
segundaren	segundar	VSF6
segundase	segundar	VSI1
segundases	segundar	VSI2
segundásemos	segundar	VSI4
segundaseis	segundar	VSI5
segundasen	segundar	VSI6
segundad	segundar	VMP
segundadme	segundar	VMSE
segundadle	segundar	VMSE
segundadnos	segundar	VMPE
segundaos	segundar	VMPE
segundadles	segundar	VMPE
segundadlo	segundar	VMMSE
segundadla	segundar	VMFSE
segundadlos	segundar	VMMPE
segundadlas	segundar	VMFPE
segundádmelo	segundar	VMMSE
segundádselo	segundar	VMMSE
segundádnoslo	segundar	VMMSE
segundáoslo	segundar	VMMSE
segundádmelos	segundar	VMMPE
segundádselos	segundar	VMMPE
segundádnoslos	segundar	VMMPE
segundáoslos	segundar	VMMPE
segundádmela	segundar	VMFSE
segundádsela	segundar	VMFSE
segundádnosla	segundar	VMFSE
segundáosla	segundar	VMFSE
segundádmelas	segundar	VMFPE
segundádselas	segundar	VMFPE
segundádnoslas	segundar	VMFPE
segundáoslas	segundar	VMFPE
segundado	segundar	VPM
segundados	segundar	VPMP
segundada	segundar	VPF
segundadas	segundar	VPFP
segundando	segundar	VG
segundándome	segundar	VGSE
segundándote	segundar	VGSE
segundándole	segundar	VGSE
segundándonos	segundar	VGPE
segundándoos	segundar	VGPE
segundándolo	segundar	VGMSE
segundándola	segundar	VGFSE
segundándolos	segundar	VGMPE
segundándolas	segundar	VGFPE
segundándomelo	segundar	VGMSE
segundándotelo	segundar	VGMSE
segundándoselo	segundar	VGMSE
segundándonoslo	segundar	VGMSE
segundándooslo	segundar	VGMSE
segundándomelos	segundar	VGMPE
segundándotelos	segundar	VGMPE
segundándoselos	segundar	VGMPE
segundándonoslos	segundar	VGMPE
segundándooslos	segundar	VGMPE
segundándomela	segundar	VGFSE
segundándotela	segundar	VGFSE
segundándosela	segundar	VGFSE
segundándonosla	segundar	VGFSE
segundándoosla	segundar	VGFSE
segundándomelas	segundar	VGFPE
segundándotelas	segundar	VGFPE
segundándoselas	segundar	VGFPE
segundándonoslas	segundar	VGFPE
segundándooslas	segundar	VGFPE
segurar	segurar	O
seguro	segurar	VIP1
seguras	segurar	VIP2
segura	segurar	VIP3
seguramos	segurar	VIP4
seguráis	segurar	VIP5
seguran	segurar	VIP6
seguraba	segurar	VII1
segurabas	segurar	VII2
segurábamos	segurar	VII4
segurabais	segurar	VII5
seguraban	segurar	VII6
seguraré	segurar	VIF1
segurarás	segurar	VIF2
segurará	segurar	VIF3
seguraremos	segurar	VIF4
seguraréis	segurar	VIF5
segurarán	segurar	VIF6
seguraría	segurar	VIC1
segurarías	segurar	VIC2
seguraría	segurar	VIC3
seguraríamos	segurar	VIC4
seguraríais	segurar	VIC5
segurarían	segurar	VIC6
seguré	segurar	VIX1
seguraste	segurar	VIX2
seguró	segurar	VIX3
segurasteis	segurar	VIX5
seguraron	segurar	VIX6
segure	segurar	VSP1
segures	segurar	VSP2
seguremos	segurar	VSP4
seguréis	segurar	VSP5
seguren	segurar	VSP6
segurara	segurar	VSX1
seguraras	segurar	VSX2
seguráramos	segurar	VSX4
segurarais	segurar	VSX5
seguraran	segurar	VSX6
segurare	segurar	VSF1
segurares	segurar	VSF2
seguráremos	segurar	VSF4
segurareis	segurar	VSF5
seguraren	segurar	VSF6
segurase	segurar	VSI1
segurases	segurar	VSI2
segurásemos	segurar	VSI4
seguraseis	segurar	VSI5
segurasen	segurar	VSI6
segurad	segurar	VMP
seguradme	segurar	VMSE
seguradle	segurar	VMSE
seguradnos	segurar	VMPE
seguraos	segurar	VMPE
seguradles	segurar	VMPE
seguradlo	segurar	VMMSE
seguradla	segurar	VMFSE
seguradlos	segurar	VMMPE
seguradlas	segurar	VMFPE
segurádmelo	segurar	VMMSE
segurádselo	segurar	VMMSE
segurádnoslo	segurar	VMMSE
seguráoslo	segurar	VMMSE
segurádmelos	segurar	VMMPE
segurádselos	segurar	VMMPE
segurádnoslos	segurar	VMMPE
seguráoslos	segurar	VMMPE
segurádmela	segurar	VMFSE
segurádsela	segurar	VMFSE
segurádnosla	segurar	VMFSE
seguráosla	segurar	VMFSE
segurádmelas	segurar	VMFPE
segurádselas	segurar	VMFPE
segurádnoslas	segurar	VMFPE
seguráoslas	segurar	VMFPE
segurado	segurar	VPM
segurados	segurar	VPMP
segurada	segurar	VPF
seguradas	segurar	VPFP
segurando	segurar	VG
segurándome	segurar	VGSE
segurándote	segurar	VGSE
segurándole	segurar	VGSE
segurándonos	segurar	VGPE
segurándoos	segurar	VGPE
segurándolo	segurar	VGMSE
segurándola	segurar	VGFSE
segurándolos	segurar	VGMPE
segurándolas	segurar	VGFPE
segurándomelo	segurar	VGMSE
segurándotelo	segurar	VGMSE
segurándoselo	segurar	VGMSE
segurándonoslo	segurar	VGMSE
segurándooslo	segurar	VGMSE
segurándomelos	segurar	VGMPE
segurándotelos	segurar	VGMPE
segurándoselos	segurar	VGMPE
segurándonoslos	segurar	VGMPE
segurándooslos	segurar	VGMPE
segurándomela	segurar	VGFSE
segurándotela	segurar	VGFSE
segurándosela	segurar	VGFSE
segurándonosla	segurar	VGFSE
segurándoosla	segurar	VGFSE
segurándomelas	segurar	VGFPE
segurándotelas	segurar	VGFPE
segurándoselas	segurar	VGFPE
segurándonoslas	segurar	VGFPE
segurándooslas	segurar	VGFPE
