sofaldo	sofaldo	O
sofaldos	sofaldo	P
sofiano	sofiano	O
sofianas	sofiano	FP
sofiana	sofiano	F
sofianos	sofiano	P
sofisma	sofisma	O
sofismas	sofisma	P
sofismo	sofismo	O
sofismos	sofismo	P
sofista	sofista	O
sofistas	sofista	P
sofistería	sofistería	O
sofisterías	sofistería	P
sofisticación	sofisticación	O
sofisticaciones	sofisticación	P
sofisticado	sofisticado	O
sofisticadas	sofisticado	FP
sofisticada	sofisticado	F
sofisticados	sofisticado	P
sofistiquez	sofistiquez	O
sofistiqueces	sofistiquez	P
sofito	sofito	O
sofitos	sofito	P
sofión	sofión	O
sofiones	sofión	P
soflama	soflama	O
soflamas	soflama	P
soflamero	soflamero	O
soflameras	soflamero	FP
soflamera	soflamero	F
soflameros	soflamero	P
sofocación	sofocación	O
sofocaciones	sofocación	P
sofocador	sofocador	O
sofocadoras	sofocador	FP
sofocadora	sofocador	F
sofocadores	sofocador	P
sofocante	sofocante	O
sofocantes	sofocante	P
sofocleo	sofocleo	O
sofocleas	sofocleo	FP
sofoclea	sofocleo	F
sofocleos	sofocleo	P
sofoco	sofoco	O
sofocos	sofoco	P
sofocón	sofocón	O
sofocones	sofocón	P
sofoquina	sofoquina	O
sofoquinas	sofoquina	P
sofrenada	sofrenada	O
sofrenadas	sofrenada	P
sofridero	sofridero	O
sofrideras	sofridero	FP
sofridera	sofridero	F
sofrideros	sofridero	P
sofrito	sofrito	O
sofritos	sofrito	P
sofrología	sofrología	O
sofrologías	sofrología	P
software	software	O
softwares	software	P
sofá	sofá	O
sofás	sofá	P
sofí	sofí	O
sofíes	sofí	P
sofísticamente	sofísticamente	O
sofístico	sofístico	O
sofísticas	sofístico	FP
sofística	sofístico	F
sofísticos	sofístico	P
sófora	sófora	O
sóforas	sófora	P
sofaldar	sofaldar	O
sofaldo	sofaldar	VIP1
sofaldas	sofaldar	VIP2
sofalda	sofaldar	VIP3
sofaldamos	sofaldar	VIP4
sofaldáis	sofaldar	VIP5
sofaldan	sofaldar	VIP6
sofaldaba	sofaldar	VII1
sofaldabas	sofaldar	VII2
sofaldábamos	sofaldar	VII4
sofaldabais	sofaldar	VII5
sofaldaban	sofaldar	VII6
sofaldaré	sofaldar	VIF1
sofaldarás	sofaldar	VIF2
sofaldará	sofaldar	VIF3
sofaldaremos	sofaldar	VIF4
sofaldaréis	sofaldar	VIF5
sofaldarán	sofaldar	VIF6
sofaldaría	sofaldar	VIC1
sofaldarías	sofaldar	VIC2
sofaldaría	sofaldar	VIC3
sofaldaríamos	sofaldar	VIC4
sofaldaríais	sofaldar	VIC5
sofaldarían	sofaldar	VIC6
sofaldé	sofaldar	VIX1
sofaldaste	sofaldar	VIX2
sofaldó	sofaldar	VIX3
sofaldasteis	sofaldar	VIX5
sofaldaron	sofaldar	VIX6
sofalde	sofaldar	VSP1
sofaldes	sofaldar	VSP2
sofaldemos	sofaldar	VSP4
sofaldéis	sofaldar	VSP5
sofalden	sofaldar	VSP6
sofaldara	sofaldar	VSX1
sofaldaras	sofaldar	VSX2
sofaldáramos	sofaldar	VSX4
sofaldarais	sofaldar	VSX5
sofaldaran	sofaldar	VSX6
sofaldare	sofaldar	VSF1
sofaldares	sofaldar	VSF2
sofaldáremos	sofaldar	VSF4
sofaldareis	sofaldar	VSF5
sofaldaren	sofaldar	VSF6
sofaldase	sofaldar	VSI1
sofaldases	sofaldar	VSI2
sofaldásemos	sofaldar	VSI4
sofaldaseis	sofaldar	VSI5
sofaldasen	sofaldar	VSI6
sofaldad	sofaldar	VMP
sofaldadme	sofaldar	VMSE
sofaldadle	sofaldar	VMSE
sofaldadnos	sofaldar	VMPE
sofaldaos	sofaldar	VMPE
sofaldadles	sofaldar	VMPE
sofaldadlo	sofaldar	VMMSE
sofaldadla	sofaldar	VMFSE
sofaldadlos	sofaldar	VMMPE
sofaldadlas	sofaldar	VMFPE
sofaldádmelo	sofaldar	VMMSE
sofaldádselo	sofaldar	VMMSE
sofaldádnoslo	sofaldar	VMMSE
sofaldáoslo	sofaldar	VMMSE
sofaldádmelos	sofaldar	VMMPE
sofaldádselos	sofaldar	VMMPE
sofaldádnoslos	sofaldar	VMMPE
sofaldáoslos	sofaldar	VMMPE
sofaldádmela	sofaldar	VMFSE
sofaldádsela	sofaldar	VMFSE
sofaldádnosla	sofaldar	VMFSE
sofaldáosla	sofaldar	VMFSE
sofaldádmelas	sofaldar	VMFPE
sofaldádselas	sofaldar	VMFPE
sofaldádnoslas	sofaldar	VMFPE
sofaldáoslas	sofaldar	VMFPE
sofaldado	sofaldar	VPM
sofaldados	sofaldar	VPMP
sofaldada	sofaldar	VPF
sofaldadas	sofaldar	VPFP
sofaldando	sofaldar	VG
sofaldándome	sofaldar	VGSE
sofaldándote	sofaldar	VGSE
sofaldándole	sofaldar	VGSE
sofaldándonos	sofaldar	VGPE
sofaldándoos	sofaldar	VGPE
sofaldándolo	sofaldar	VGMSE
sofaldándola	sofaldar	VGFSE
sofaldándolos	sofaldar	VGMPE
sofaldándolas	sofaldar	VGFPE
sofaldándomelo	sofaldar	VGMSE
sofaldándotelo	sofaldar	VGMSE
sofaldándoselo	sofaldar	VGMSE
sofaldándonoslo	sofaldar	VGMSE
sofaldándooslo	sofaldar	VGMSE
sofaldándomelos	sofaldar	VGMPE
sofaldándotelos	sofaldar	VGMPE
sofaldándoselos	sofaldar	VGMPE
sofaldándonoslos	sofaldar	VGMPE
sofaldándooslos	sofaldar	VGMPE
sofaldándomela	sofaldar	VGFSE
sofaldándotela	sofaldar	VGFSE
sofaldándosela	sofaldar	VGFSE
sofaldándonosla	sofaldar	VGFSE
sofaldándoosla	sofaldar	VGFSE
sofaldándomelas	sofaldar	VGFPE
sofaldándotelas	sofaldar	VGFPE
sofaldándoselas	sofaldar	VGFPE
sofaldándonoslas	sofaldar	VGFPE
sofaldándooslas	sofaldar	VGFPE
sofisticar	sofisticar	O
sofistico	sofisticar	VIP1
sofisticas	sofisticar	VIP2
sofistica	sofisticar	VIP3
sofisticamos	sofisticar	VIP4
sofisticáis	sofisticar	VIP5
sofistican	sofisticar	VIP6
sofisticaba	sofisticar	VII1
sofisticabas	sofisticar	VII2
sofisticábamos	sofisticar	VII4
sofisticabais	sofisticar	VII5
sofisticaban	sofisticar	VII6
sofisticaré	sofisticar	VIF1
sofisticarás	sofisticar	VIF2
sofisticará	sofisticar	VIF3
sofisticaremos	sofisticar	VIF4
sofisticaréis	sofisticar	VIF5
sofisticarán	sofisticar	VIF6
sofisticaría	sofisticar	VIC1
sofisticarías	sofisticar	VIC2
sofisticaría	sofisticar	VIC3
sofisticaríamos	sofisticar	VIC4
sofisticaríais	sofisticar	VIC5
sofisticarían	sofisticar	VIC6
sofistiqué	sofisticar	VIX1
sofisticaste	sofisticar	VIX2
sofisticó	sofisticar	VIX3
sofisticasteis	sofisticar	VIX5
sofisticaron	sofisticar	VIX6
sofistique	sofisticar	VSP1
sofistiques	sofisticar	VSP2
sofistiquemos	sofisticar	VSP4
sofistiquéis	sofisticar	VSP5
sofistiquen	sofisticar	VSP6
sofisticara	sofisticar	VSX1
sofisticaras	sofisticar	VSX2
sofisticáramos	sofisticar	VSX4
sofisticarais	sofisticar	VSX5
sofisticaran	sofisticar	VSX6
sofisticare	sofisticar	VSF1
sofisticares	sofisticar	VSF2
sofisticáremos	sofisticar	VSF4
sofisticareis	sofisticar	VSF5
sofisticaren	sofisticar	VSF6
sofisticase	sofisticar	VSI1
sofisticases	sofisticar	VSI2
sofisticásemos	sofisticar	VSI4
sofisticaseis	sofisticar	VSI5
sofisticasen	sofisticar	VSI6
sofisticad	sofisticar	VMP
sofisticadme	sofisticar	VMSE
sofisticadle	sofisticar	VMSE
sofisticadnos	sofisticar	VMPE
sofisticaos	sofisticar	VMPE
sofisticadles	sofisticar	VMPE
sofisticadlo	sofisticar	VMMSE
sofisticadla	sofisticar	VMFSE
sofisticadlos	sofisticar	VMMPE
sofisticadlas	sofisticar	VMFPE
sofisticádmelo	sofisticar	VMMSE
sofisticádselo	sofisticar	VMMSE
sofisticádnoslo	sofisticar	VMMSE
sofisticáoslo	sofisticar	VMMSE
sofisticádmelos	sofisticar	VMMPE
sofisticádselos	sofisticar	VMMPE
sofisticádnoslos	sofisticar	VMMPE
sofisticáoslos	sofisticar	VMMPE
sofisticádmela	sofisticar	VMFSE
sofisticádsela	sofisticar	VMFSE
sofisticádnosla	sofisticar	VMFSE
sofisticáosla	sofisticar	VMFSE
sofisticádmelas	sofisticar	VMFPE
sofisticádselas	sofisticar	VMFPE
sofisticádnoslas	sofisticar	VMFPE
sofisticáoslas	sofisticar	VMFPE
sofisticado	sofisticar	VPM
sofisticados	sofisticar	VPMP
sofisticada	sofisticar	VPF
sofisticadas	sofisticar	VPFP
sofisticando	sofisticar	VG
sofisticándome	sofisticar	VGSE
sofisticándote	sofisticar	VGSE
sofisticándole	sofisticar	VGSE
sofisticándonos	sofisticar	VGPE
sofisticándoos	sofisticar	VGPE
sofisticándolo	sofisticar	VGMSE
sofisticándola	sofisticar	VGFSE
sofisticándolos	sofisticar	VGMPE
sofisticándolas	sofisticar	VGFPE
sofisticándomelo	sofisticar	VGMSE
sofisticándotelo	sofisticar	VGMSE
sofisticándoselo	sofisticar	VGMSE
sofisticándonoslo	sofisticar	VGMSE
sofisticándooslo	sofisticar	VGMSE
sofisticándomelos	sofisticar	VGMPE
sofisticándotelos	sofisticar	VGMPE
sofisticándoselos	sofisticar	VGMPE
sofisticándonoslos	sofisticar	VGMPE
sofisticándooslos	sofisticar	VGMPE
sofisticándomela	sofisticar	VGFSE
sofisticándotela	sofisticar	VGFSE
sofisticándosela	sofisticar	VGFSE
sofisticándonosla	sofisticar	VGFSE
sofisticándoosla	sofisticar	VGFSE
sofisticándomelas	sofisticar	VGFPE
sofisticándotelas	sofisticar	VGFPE
sofisticándoselas	sofisticar	VGFPE
sofisticándonoslas	sofisticar	VGFPE
sofisticándooslas	sofisticar	VGFPE
soflamar	soflamar	O
soflamo	soflamar	VIP1
soflamas	soflamar	VIP2
soflama	soflamar	VIP3
soflamamos	soflamar	VIP4
soflamáis	soflamar	VIP5
soflaman	soflamar	VIP6
soflamaba	soflamar	VII1
soflamabas	soflamar	VII2
soflamábamos	soflamar	VII4
soflamabais	soflamar	VII5
soflamaban	soflamar	VII6
soflamaré	soflamar	VIF1
soflamarás	soflamar	VIF2
soflamará	soflamar	VIF3
soflamaremos	soflamar	VIF4
soflamaréis	soflamar	VIF5
soflamarán	soflamar	VIF6
soflamaría	soflamar	VIC1
soflamarías	soflamar	VIC2
soflamaría	soflamar	VIC3
soflamaríamos	soflamar	VIC4
soflamaríais	soflamar	VIC5
soflamarían	soflamar	VIC6
soflamé	soflamar	VIX1
soflamaste	soflamar	VIX2
soflamó	soflamar	VIX3
soflamasteis	soflamar	VIX5
soflamaron	soflamar	VIX6
soflame	soflamar	VSP1
soflames	soflamar	VSP2
soflamemos	soflamar	VSP4
soflaméis	soflamar	VSP5
soflamen	soflamar	VSP6
soflamara	soflamar	VSX1
soflamaras	soflamar	VSX2
soflamáramos	soflamar	VSX4
soflamarais	soflamar	VSX5
soflamaran	soflamar	VSX6
soflamare	soflamar	VSF1
soflamares	soflamar	VSF2
soflamáremos	soflamar	VSF4
soflamareis	soflamar	VSF5
soflamaren	soflamar	VSF6
soflamase	soflamar	VSI1
soflamases	soflamar	VSI2
soflamásemos	soflamar	VSI4
soflamaseis	soflamar	VSI5
soflamasen	soflamar	VSI6
soflamad	soflamar	VMP
soflamadme	soflamar	VMSE
soflamadle	soflamar	VMSE
soflamadnos	soflamar	VMPE
soflamaos	soflamar	VMPE
soflamadles	soflamar	VMPE
soflamadlo	soflamar	VMMSE
soflamadla	soflamar	VMFSE
soflamadlos	soflamar	VMMPE
soflamadlas	soflamar	VMFPE
soflamádmelo	soflamar	VMMSE
soflamádselo	soflamar	VMMSE
soflamádnoslo	soflamar	VMMSE
soflamáoslo	soflamar	VMMSE
soflamádmelos	soflamar	VMMPE
soflamádselos	soflamar	VMMPE
soflamádnoslos	soflamar	VMMPE
soflamáoslos	soflamar	VMMPE
soflamádmela	soflamar	VMFSE
soflamádsela	soflamar	VMFSE
soflamádnosla	soflamar	VMFSE
soflamáosla	soflamar	VMFSE
soflamádmelas	soflamar	VMFPE
soflamádselas	soflamar	VMFPE
soflamádnoslas	soflamar	VMFPE
soflamáoslas	soflamar	VMFPE
soflamado	soflamar	VPM
soflamados	soflamar	VPMP
soflamada	soflamar	VPF
soflamadas	soflamar	VPFP
soflamando	soflamar	VG
soflamándome	soflamar	VGSE
soflamándote	soflamar	VGSE
soflamándole	soflamar	VGSE
soflamándonos	soflamar	VGPE
soflamándoos	soflamar	VGPE
soflamándolo	soflamar	VGMSE
soflamándola	soflamar	VGFSE
soflamándolos	soflamar	VGMPE
soflamándolas	soflamar	VGFPE
soflamándomelo	soflamar	VGMSE
soflamándotelo	soflamar	VGMSE
soflamándoselo	soflamar	VGMSE
soflamándonoslo	soflamar	VGMSE
soflamándooslo	soflamar	VGMSE
soflamándomelos	soflamar	VGMPE
soflamándotelos	soflamar	VGMPE
soflamándoselos	soflamar	VGMPE
soflamándonoslos	soflamar	VGMPE
soflamándooslos	soflamar	VGMPE
soflamándomela	soflamar	VGFSE
soflamándotela	soflamar	VGFSE
soflamándosela	soflamar	VGFSE
soflamándonosla	soflamar	VGFSE
soflamándoosla	soflamar	VGFSE
soflamándomelas	soflamar	VGFPE
soflamándotelas	soflamar	VGFPE
soflamándoselas	soflamar	VGFPE
soflamándonoslas	soflamar	VGFPE
soflamándooslas	soflamar	VGFPE
sofocar	sofocar	O
sofoco	sofocar	VIP1
sofocas	sofocar	VIP2
sofoca	sofocar	VIP3
sofocamos	sofocar	VIP4
sofocáis	sofocar	VIP5
sofocan	sofocar	VIP6
sofocaba	sofocar	VII1
sofocabas	sofocar	VII2
sofocábamos	sofocar	VII4
sofocabais	sofocar	VII5
sofocaban	sofocar	VII6
sofocaré	sofocar	VIF1
sofocarás	sofocar	VIF2
sofocará	sofocar	VIF3
sofocaremos	sofocar	VIF4
sofocaréis	sofocar	VIF5
sofocarán	sofocar	VIF6
sofocaría	sofocar	VIC1
sofocarías	sofocar	VIC2
sofocaría	sofocar	VIC3
sofocaríamos	sofocar	VIC4
sofocaríais	sofocar	VIC5
sofocarían	sofocar	VIC6
sofoqué	sofocar	VIX1
sofocaste	sofocar	VIX2
sofocó	sofocar	VIX3
sofocasteis	sofocar	VIX5
sofocaron	sofocar	VIX6
sofoque	sofocar	VSP1
sofoques	sofocar	VSP2
sofoquemos	sofocar	VSP4
sofoquéis	sofocar	VSP5
sofoquen	sofocar	VSP6
sofocara	sofocar	VSX1
sofocaras	sofocar	VSX2
sofocáramos	sofocar	VSX4
sofocarais	sofocar	VSX5
sofocaran	sofocar	VSX6
sofocare	sofocar	VSF1
sofocares	sofocar	VSF2
sofocáremos	sofocar	VSF4
sofocareis	sofocar	VSF5
sofocaren	sofocar	VSF6
sofocase	sofocar	VSI1
sofocases	sofocar	VSI2
sofocásemos	sofocar	VSI4
sofocaseis	sofocar	VSI5
sofocasen	sofocar	VSI6
sofocad	sofocar	VMP
sofocadme	sofocar	VMSE
sofocadle	sofocar	VMSE
sofocadnos	sofocar	VMPE
sofocaos	sofocar	VMPE
sofocadles	sofocar	VMPE
sofocadlo	sofocar	VMMSE
sofocadla	sofocar	VMFSE
sofocadlos	sofocar	VMMPE
sofocadlas	sofocar	VMFPE
sofocádmelo	sofocar	VMMSE
sofocádselo	sofocar	VMMSE
sofocádnoslo	sofocar	VMMSE
sofocáoslo	sofocar	VMMSE
sofocádmelos	sofocar	VMMPE
sofocádselos	sofocar	VMMPE
sofocádnoslos	sofocar	VMMPE
sofocáoslos	sofocar	VMMPE
sofocádmela	sofocar	VMFSE
sofocádsela	sofocar	VMFSE
sofocádnosla	sofocar	VMFSE
sofocáosla	sofocar	VMFSE
sofocádmelas	sofocar	VMFPE
sofocádselas	sofocar	VMFPE
sofocádnoslas	sofocar	VMFPE
sofocáoslas	sofocar	VMFPE
sofocado	sofocar	VPM
sofocados	sofocar	VPMP
sofocada	sofocar	VPF
sofocadas	sofocar	VPFP
sofocando	sofocar	VG
sofocándome	sofocar	VGSE
sofocándote	sofocar	VGSE
sofocándole	sofocar	VGSE
sofocándonos	sofocar	VGPE
sofocándoos	sofocar	VGPE
sofocándolo	sofocar	VGMSE
sofocándola	sofocar	VGFSE
sofocándolos	sofocar	VGMPE
sofocándolas	sofocar	VGFPE
sofocándomelo	sofocar	VGMSE
sofocándotelo	sofocar	VGMSE
sofocándoselo	sofocar	VGMSE
sofocándonoslo	sofocar	VGMSE
sofocándooslo	sofocar	VGMSE
sofocándomelos	sofocar	VGMPE
sofocándotelos	sofocar	VGMPE
sofocándoselos	sofocar	VGMPE
sofocándonoslos	sofocar	VGMPE
sofocándooslos	sofocar	VGMPE
sofocándomela	sofocar	VGFSE
sofocándotela	sofocar	VGFSE
sofocándosela	sofocar	VGFSE
sofocándonosla	sofocar	VGFSE
sofocándoosla	sofocar	VGFSE
sofocándomelas	sofocar	VGFPE
sofocándotelas	sofocar	VGFPE
sofocándoselas	sofocar	VGFPE
sofocándonoslas	sofocar	VGFPE
sofocándooslas	sofocar	VGFPE
sofrenar	sofrenar	O
sofreno	sofrenar	VIP1
sofrenas	sofrenar	VIP2
sofrena	sofrenar	VIP3
sofrenamos	sofrenar	VIP4
sofrenáis	sofrenar	VIP5
sofrenan	sofrenar	VIP6
sofrenaba	sofrenar	VII1
sofrenabas	sofrenar	VII2
sofrenábamos	sofrenar	VII4
sofrenabais	sofrenar	VII5
sofrenaban	sofrenar	VII6
sofrenaré	sofrenar	VIF1
sofrenarás	sofrenar	VIF2
sofrenará	sofrenar	VIF3
sofrenaremos	sofrenar	VIF4
sofrenaréis	sofrenar	VIF5
sofrenarán	sofrenar	VIF6
sofrenaría	sofrenar	VIC1
sofrenarías	sofrenar	VIC2
sofrenaría	sofrenar	VIC3
sofrenaríamos	sofrenar	VIC4
sofrenaríais	sofrenar	VIC5
sofrenarían	sofrenar	VIC6
sofrené	sofrenar	VIX1
sofrenaste	sofrenar	VIX2
sofrenó	sofrenar	VIX3
sofrenasteis	sofrenar	VIX5
sofrenaron	sofrenar	VIX6
sofrene	sofrenar	VSP1
sofrenes	sofrenar	VSP2
sofrenemos	sofrenar	VSP4
sofrenéis	sofrenar	VSP5
sofrenen	sofrenar	VSP6
sofrenara	sofrenar	VSX1
sofrenaras	sofrenar	VSX2
sofrenáramos	sofrenar	VSX4
sofrenarais	sofrenar	VSX5
sofrenaran	sofrenar	VSX6
sofrenare	sofrenar	VSF1
sofrenares	sofrenar	VSF2
sofrenáremos	sofrenar	VSF4
sofrenareis	sofrenar	VSF5
sofrenaren	sofrenar	VSF6
sofrenase	sofrenar	VSI1
sofrenases	sofrenar	VSI2
sofrenásemos	sofrenar	VSI4
sofrenaseis	sofrenar	VSI5
sofrenasen	sofrenar	VSI6
sofrenad	sofrenar	VMP
sofrenadme	sofrenar	VMSE
sofrenadle	sofrenar	VMSE
sofrenadnos	sofrenar	VMPE
sofrenaos	sofrenar	VMPE
sofrenadles	sofrenar	VMPE
sofrenadlo	sofrenar	VMMSE
sofrenadla	sofrenar	VMFSE
sofrenadlos	sofrenar	VMMPE
sofrenadlas	sofrenar	VMFPE
sofrenádmelo	sofrenar	VMMSE
sofrenádselo	sofrenar	VMMSE
sofrenádnoslo	sofrenar	VMMSE
sofrenáoslo	sofrenar	VMMSE
sofrenádmelos	sofrenar	VMMPE
sofrenádselos	sofrenar	VMMPE
sofrenádnoslos	sofrenar	VMMPE
sofrenáoslos	sofrenar	VMMPE
sofrenádmela	sofrenar	VMFSE
sofrenádsela	sofrenar	VMFSE
sofrenádnosla	sofrenar	VMFSE
sofrenáosla	sofrenar	VMFSE
sofrenádmelas	sofrenar	VMFPE
sofrenádselas	sofrenar	VMFPE
sofrenádnoslas	sofrenar	VMFPE
sofrenáoslas	sofrenar	VMFPE
sofrenado	sofrenar	VPM
sofrenados	sofrenar	VPMP
sofrenada	sofrenar	VPF
sofrenadas	sofrenar	VPFP
sofrenando	sofrenar	VG
sofrenándome	sofrenar	VGSE
sofrenándote	sofrenar	VGSE
sofrenándole	sofrenar	VGSE
sofrenándonos	sofrenar	VGPE
sofrenándoos	sofrenar	VGPE
sofrenándolo	sofrenar	VGMSE
sofrenándola	sofrenar	VGFSE
sofrenándolos	sofrenar	VGMPE
sofrenándolas	sofrenar	VGFPE
sofrenándomelo	sofrenar	VGMSE
sofrenándotelo	sofrenar	VGMSE
sofrenándoselo	sofrenar	VGMSE
sofrenándonoslo	sofrenar	VGMSE
sofrenándooslo	sofrenar	VGMSE
sofrenándomelos	sofrenar	VGMPE
sofrenándotelos	sofrenar	VGMPE
sofrenándoselos	sofrenar	VGMPE
sofrenándonoslos	sofrenar	VGMPE
sofrenándooslos	sofrenar	VGMPE
sofrenándomela	sofrenar	VGFSE
sofrenándotela	sofrenar	VGFSE
sofrenándosela	sofrenar	VGFSE
sofrenándonosla	sofrenar	VGFSE
sofrenándoosla	sofrenar	VGFSE
sofrenándomelas	sofrenar	VGFPE
sofrenándotelas	sofrenar	VGFPE
sofrenándoselas	sofrenar	VGFPE
sofrenándonoslas	sofrenar	VGFPE
sofrenándooslas	sofrenar	VGFPE
