sugerencia	sugerencia	O
sugerencias	sugerencia	P
sugerente	sugerente	O
sugerentes	sugerente	P
sugeridor	sugeridor	O
sugeridoras	sugeridor	FP
sugeridora	sugeridor	F
sugeridores	sugeridor	P
sugestionable	sugestionable	O
sugestionables	sugestionable	P
sugestionador	sugestionador	O
sugestionadoras	sugestionador	FP
sugestionadora	sugestionador	F
sugestionadores	sugestionador	P
sugestivo	sugestivo	O
sugestivas	sugestivo	FP
sugestiva	sugestivo	F
sugestivos	sugestivo	P
sugestión	sugestión	O
sugestiones	sugestión	P
sugesto	sugesto	O
sugestos	sugesto	P
sugerir	sugerir	O
sugiero	sugerir	VIP1
sugieres	sugerir	VIP2
sugiere	sugerir	VIP3
sugerimos	sugerir	VIP4
sugerís	sugerir	VIP5
sugieren	sugerir	VIP6
sugería	sugerir	VII1
sugerías	sugerir	VII2
sugeríamos	sugerir	VII4
sugeríais	sugerir	VII5
sugerían	sugerir	VII6
sugeriré	sugerir	VIF1
sugerirás	sugerir	VIF2
sugerirá	sugerir	VIF3
sugeriremos	sugerir	VIF4
sugeriréis	sugerir	VIF5
sugerirán	sugerir	VIF6
sugeriría	sugerir	VIC1
sugerirías	sugerir	VIC2
sugeriría	sugerir	VIC3
sugeriríamos	sugerir	VIC4
sugeriríais	sugerir	VIC5
sugerirían	sugerir	VIC6
sugerí	sugerir	VIX1
sugeriste	sugerir	VIX2
sugirió	sugerir	VIX3
sugeristeis	sugerir	VIX5
sugirieron	sugerir	VIX6
sugiera	sugerir	VSP1
sugieras	sugerir	VSP2
sugiramos	sugerir	VSP4
sugiráis	sugerir	VSP5
sugieran	sugerir	VSP6
sugiriera	sugerir	VSX1
sugirieras	sugerir	VSX2
sugiriéramos	sugerir	VSX4
sugirierais	sugerir	VSX5
sugirieran	sugerir	VSX6
sugiriere	sugerir	VSF1
sugirieres	sugerir	VSF2
sugiriéremos	sugerir	VSF4
sugiriereis	sugerir	VSF5
sugirieren	sugerir	VSF6
sugiriese	sugerir	VSI1
sugirieses	sugerir	VSI2
sugiriésemos	sugerir	VSI4
sugirieseis	sugerir	VSI5
sugiriesen	sugerir	VSI6
sugerid	sugerir	VMP
sugeridme	sugerir	VMSE
sugeridle	sugerir	VMSE
sugeridnos	sugerir	VMPE
sugerios	sugerir	VMPE
sugeridles	sugerir	VMPE
sugeridlo	sugerir	VMMSE
sugeridla	sugerir	VMFSE
sugeridlos	sugerir	VMMPE
sugeridlas	sugerir	VMFPE
sugerídmelo	sugerir	VMMSE
sugerídselo	sugerir	VMMSE
sugerídnoslo	sugerir	VMMSE
sugeríoslo	sugerir	VMMSE
sugerídmelos	sugerir	VMMPE
sugerídselos	sugerir	VMMPE
sugerídnoslos	sugerir	VMMPE
sugeríoslos	sugerir	VMMPE
sugerídmela	sugerir	VMFSE
sugerídsela	sugerir	VMFSE
sugerídnosla	sugerir	VMFSE
sugeríosla	sugerir	VMFSE
sugerídmelas	sugerir	VMFPE
sugerídselas	sugerir	VMFPE
sugerídnoslas	sugerir	VMFPE
sugeríoslas	sugerir	VMFPE
sugerido	sugerir	VPM
sugeridos	sugerir	VPMP
sugerida	sugerir	VPF
sugeridas	sugerir	VPFP
sugiriendo	sugerir	VG
sugiriéndome	sugerir	VGSE
sugiriéndote	sugerir	VGSE
sugiriéndole	sugerir	VGSE
sugiriéndonos	sugerir	VGPE
sugiriéndoos	sugerir	VGPE
sugiriéndolo	sugerir	VGMSE
sugiriéndola	sugerir	VGFSE
sugiriéndolos	sugerir	VGMPE
sugiriéndolas	sugerir	VGFPE
sugiriéndomelo	sugerir	VGMSE
sugiriéndotelo	sugerir	VGMSE
sugiriéndoselo	sugerir	VGMSE
sugiriéndonoslo	sugerir	VGMSE
sugiriéndooslo	sugerir	VGMSE
sugiriéndomelos	sugerir	VGMPE
sugiriéndotelos	sugerir	VGMPE
sugiriéndoselos	sugerir	VGMPE
sugiriéndonoslos	sugerir	VGMPE
sugiriéndooslos	sugerir	VGMPE
sugiriéndomela	sugerir	VGFSE
sugiriéndotela	sugerir	VGFSE
sugiriéndosela	sugerir	VGFSE
sugiriéndonosla	sugerir	VGFSE
sugiriéndoosla	sugerir	VGFSE
sugiriéndomelas	sugerir	VGFPE
sugiriéndotelas	sugerir	VGFPE
sugiriéndoselas	sugerir	VGFPE
sugiriéndonoslas	sugerir	VGFPE
sugiriéndooslas	sugerir	VGFPE
sugestionar	sugestionar	O
sugestiono	sugestionar	VIP1
sugestionas	sugestionar	VIP2
sugestiona	sugestionar	VIP3
sugestionamos	sugestionar	VIP4
sugestionáis	sugestionar	VIP5
sugestionan	sugestionar	VIP6
sugestionaba	sugestionar	VII1
sugestionabas	sugestionar	VII2
sugestionábamos	sugestionar	VII4
sugestionabais	sugestionar	VII5
sugestionaban	sugestionar	VII6
sugestionaré	sugestionar	VIF1
sugestionarás	sugestionar	VIF2
sugestionará	sugestionar	VIF3
sugestionaremos	sugestionar	VIF4
sugestionaréis	sugestionar	VIF5
sugestionarán	sugestionar	VIF6
sugestionaría	sugestionar	VIC1
sugestionarías	sugestionar	VIC2
sugestionaría	sugestionar	VIC3
sugestionaríamos	sugestionar	VIC4
sugestionaríais	sugestionar	VIC5
sugestionarían	sugestionar	VIC6
sugestioné	sugestionar	VIX1
sugestionaste	sugestionar	VIX2
sugestionó	sugestionar	VIX3
sugestionasteis	sugestionar	VIX5
sugestionaron	sugestionar	VIX6
sugestione	sugestionar	VSP1
sugestiones	sugestionar	VSP2
sugestionemos	sugestionar	VSP4
sugestionéis	sugestionar	VSP5
sugestionen	sugestionar	VSP6
sugestionara	sugestionar	VSX1
sugestionaras	sugestionar	VSX2
sugestionáramos	sugestionar	VSX4
sugestionarais	sugestionar	VSX5
sugestionaran	sugestionar	VSX6
sugestionare	sugestionar	VSF1
sugestionares	sugestionar	VSF2
sugestionáremos	sugestionar	VSF4
sugestionareis	sugestionar	VSF5
sugestionaren	sugestionar	VSF6
sugestionase	sugestionar	VSI1
sugestionases	sugestionar	VSI2
sugestionásemos	sugestionar	VSI4
sugestionaseis	sugestionar	VSI5
sugestionasen	sugestionar	VSI6
sugestionad	sugestionar	VMP
sugestionadme	sugestionar	VMSE
sugestionadle	sugestionar	VMSE
sugestionadnos	sugestionar	VMPE
sugestionaos	sugestionar	VMPE
sugestionadles	sugestionar	VMPE
sugestionadlo	sugestionar	VMMSE
sugestionadla	sugestionar	VMFSE
sugestionadlos	sugestionar	VMMPE
sugestionadlas	sugestionar	VMFPE
sugestionádmelo	sugestionar	VMMSE
sugestionádselo	sugestionar	VMMSE
sugestionádnoslo	sugestionar	VMMSE
sugestionáoslo	sugestionar	VMMSE
sugestionádmelos	sugestionar	VMMPE
sugestionádselos	sugestionar	VMMPE
sugestionádnoslos	sugestionar	VMMPE
sugestionáoslos	sugestionar	VMMPE
sugestionádmela	sugestionar	VMFSE
sugestionádsela	sugestionar	VMFSE
sugestionádnosla	sugestionar	VMFSE
sugestionáosla	sugestionar	VMFSE
sugestionádmelas	sugestionar	VMFPE
sugestionádselas	sugestionar	VMFPE
sugestionádnoslas	sugestionar	VMFPE
sugestionáoslas	sugestionar	VMFPE
sugestionado	sugestionar	VPM
sugestionados	sugestionar	VPMP
sugestionada	sugestionar	VPF
sugestionadas	sugestionar	VPFP
sugestionando	sugestionar	VG
sugestionándome	sugestionar	VGSE
sugestionándote	sugestionar	VGSE
sugestionándole	sugestionar	VGSE
sugestionándonos	sugestionar	VGPE
sugestionándoos	sugestionar	VGPE
sugestionándolo	sugestionar	VGMSE
sugestionándola	sugestionar	VGFSE
sugestionándolos	sugestionar	VGMPE
sugestionándolas	sugestionar	VGFPE
sugestionándomelo	sugestionar	VGMSE
sugestionándotelo	sugestionar	VGMSE
sugestionándoselo	sugestionar	VGMSE
sugestionándonoslo	sugestionar	VGMSE
sugestionándooslo	sugestionar	VGMSE
sugestionándomelos	sugestionar	VGMPE
sugestionándotelos	sugestionar	VGMPE
sugestionándoselos	sugestionar	VGMPE
sugestionándonoslos	sugestionar	VGMPE
sugestionándooslos	sugestionar	VGMPE
sugestionándomela	sugestionar	VGFSE
sugestionándotela	sugestionar	VGFSE
sugestionándosela	sugestionar	VGFSE
sugestionándonosla	sugestionar	VGFSE
sugestionándoosla	sugestionar	VGFSE
sugestionándomelas	sugestionar	VGFPE
sugestionándotelas	sugestionar	VGFPE
sugestionándoselas	sugestionar	VGFPE
sugestionándonoslas	sugestionar	VGFPE
sugestionándooslas	sugestionar	VGFPE
