sus	su	P
sus	sus	O
susano	susano	O
susanas	susano	FP
susana	susano	F
susanos	susano	P
suscepción	suscepción	O
suscepciones	suscepción	P
susceptibilidad	susceptibilidad	O
susceptibilidades	susceptibilidad	P
susceptible	susceptible	O
susceptibles	susceptible	P
susceptivo	susceptivo	O
susceptivas	susceptivo	FP
susceptiva	susceptivo	F
susceptivos	susceptivo	P
suscitación	suscitación	O
suscitaciones	suscitación	P
suscripción	suscripción	O
suscripciones	suscripción	P
suscripto	suscripto	O
suscriptas	suscripto	FP
suscripta	suscripto	F
suscriptor	suscriptor	O
suscriptoras	suscriptor	FP
suscriptora	suscriptor	F
suscriptores	suscriptor	P
suscrito	suscrito	O
suscritas	suscrito	FP
suscrita	suscrito	F
suscritor	suscritor	O
suscritoras	suscritor	FP
suscritora	suscritor	F
suscritores	suscritor	P
susero	susero	O
suseras	susero	FP
susera	susero	F
suseros	susero	P
susidio	susidio	O
susidios	susidio	P
suso	suso	O
susodicho	susodicho	O
susodichas	susodicho	FP
susodicha	susodicho	F
susodichos	susodicho	P
suspecto	suspecto	O
suspectas	suspecto	FP
suspecta	suspecto	F
suspectos	suspecto	P
suspendedor	suspendedor	O
suspendedoras	suspendedor	FP
suspendedora	suspendedor	F
suspendedores	suspendedor	P
suspendimiento	suspendimiento	O
suspendimientos	suspendimiento	P
suspense	suspense	O
suspenses	suspense	P
suspensivo	suspensivo	O
suspensivas	suspensivo	FP
suspensiva	suspensivo	F
suspensivos	suspensivo	P
suspensión	suspensión	O
suspensiones	suspensión	P
suspenso	suspenso	O
suspensas	suspenso	FP
suspensa	suspenso	F
suspensos	suspenso	P
suspensorio	suspensorio	O
suspensorias	suspensorio	FP
suspensoria	suspensorio	F
suspensorios	suspensorio	P
suspicacia	suspicacia	O
suspicacias	suspicacia	P
suspicaz	suspicaz	O
suspicaces	suspicaz	P
suspicazmente	suspicazmente	O
suspición	suspición	O
suspiciones	suspición	P
suspiro	suspiro	O
suspiros	suspiro	P
suspiroso	suspiroso	O
suspirosas	suspiroso	FP
suspirosa	suspiroso	F
suspirosos	suspiroso	P
suspirón	suspirón	O
suspironas	suspirón	FP
suspirona	suspirón	F
suspirones	suspirón	P
sustancia	sustancia	O
sustancias	sustancia	P
sustanciación	sustanciación	O
sustanciaciones	sustanciación	P
sustancial	sustancial	O
sustanciales	sustancial	P
sustancialismo	sustancialismo	O
sustancialismos	sustancialismo	P
sustancialmente	sustancialmente	O
sustancioso	sustancioso	O
sustanciosas	sustancioso	FP
sustanciosa	sustancioso	F
sustanciosos	sustancioso	P
sustantivación	sustantivación	O
sustantivaciones	sustantivación	P
sustantivamente	sustantivamente	O
sustantividad	sustantividad	O
sustantividades	sustantividad	P
sustantivo	sustantivo	O
sustantivas	sustantivo	FP
sustantiva	sustantivo	F
sustantivos	sustantivo	P
sustenido	sustenido	O
sustenidas	sustenido	FP
sustenida	sustenido	F
sustenidos	sustenido	P
sustentable	sustentable	O
sustentables	sustentable	P
sustentación	sustentación	O
sustentaciones	sustentación	P
sustentador	sustentador	O
sustentadoras	sustentador	FP
sustentadora	sustentador	F
sustentadores	sustentador	P
sustentamiento	sustentamiento	O
sustentamientos	sustentamiento	P
sustentante	sustentante	O
sustentantes	sustentante	P
sustento	sustento	O
sustentos	sustento	P
sustentáculo	sustentáculo	O
sustentáculos	sustentáculo	P
sustitución	sustitución	O
sustituciones	sustitución	P
sustituible	sustituible	O
sustituibles	sustituible	P
sustituidor	sustituidor	O
sustituidoras	sustituidor	FP
sustituidora	sustituidor	F
sustituidores	sustituidor	P
sustitutivo	sustitutivo	O
sustitutivas	sustitutivo	FP
sustitutiva	sustitutivo	F
sustitutivos	sustitutivo	P
sustituto	sustituto	O
sustitutas	sustituto	FP
sustituta	sustituto	F
sustitutos	sustituto	P
susto	susto	O
sustos	susto	P
sustracción	sustracción	O
sustracciones	sustracción	P
sustractivo	sustractivo	O
sustractivas	sustractivo	FP
sustractiva	sustractivo	F
sustractivos	sustractivo	P
sustraendo	sustraendo	O
sustraendos	sustraendo	P
sustrato	sustrato	O
sustratos	sustrato	P
susurración	susurración	O
susurraciones	susurración	P
susurrador	susurrador	O
susurradoras	susurrador	FP
susurradora	susurrador	F
susurradores	susurrador	P
susurrante	susurrante	O
susurrantes	susurrante	P
susurrido	susurrido	O
susurridos	susurrido	P
susurro	susurro	O
susurros	susurro	P
susurrón	susurrón	O
susurronas	susurrón	FP
susurrona	susurrón	F
susurrones	susurrón	P
suscribir	suscribir	O
suscribo	suscribir	VIP1
suscribes	suscribir	VIP2
suscribe	suscribir	VIP3
suscribimos	suscribir	VIP4
suscribís	suscribir	VIP5
suscriben	suscribir	VIP6
suscribía	suscribir	VII1
suscribías	suscribir	VII2
suscribíamos	suscribir	VII4
suscribíais	suscribir	VII5
suscribían	suscribir	VII6
suscribiré	suscribir	VIF1
suscribirás	suscribir	VIF2
suscribirá	suscribir	VIF3
suscribiremos	suscribir	VIF4
suscribiréis	suscribir	VIF5
suscribirán	suscribir	VIF6
suscribiría	suscribir	VIC1
suscribirías	suscribir	VIC2
suscribiría	suscribir	VIC3
suscribiríamos	suscribir	VIC4
suscribiríais	suscribir	VIC5
suscribirían	suscribir	VIC6
suscribí	suscribir	VIX1
suscribiste	suscribir	VIX2
suscribió	suscribir	VIX3
suscribisteis	suscribir	VIX5
suscribieron	suscribir	VIX6
suscriba	suscribir	VSP1
suscribas	suscribir	VSP2
suscribamos	suscribir	VSP4
suscribáis	suscribir	VSP5
suscriban	suscribir	VSP6
suscribiera	suscribir	VSX1
suscribieras	suscribir	VSX2
suscribiéramos	suscribir	VSX4
suscribierais	suscribir	VSX5
suscribieran	suscribir	VSX6
suscribiere	suscribir	VSF1
suscribieres	suscribir	VSF2
suscribiéremos	suscribir	VSF4
suscribiereis	suscribir	VSF5
suscribieren	suscribir	VSF6
suscribiese	suscribir	VSI1
suscribieses	suscribir	VSI2
suscribiésemos	suscribir	VSI4
suscribieseis	suscribir	VSI5
suscribiesen	suscribir	VSI6
suscribid	suscribir	VMP
suscribidme	suscribir	VMSE
suscribidle	suscribir	VMSE
suscribidnos	suscribir	VMPE
suscribios	suscribir	VMPE
suscribidles	suscribir	VMPE
suscribidlo	suscribir	VMMSE
suscribidla	suscribir	VMFSE
suscribidlos	suscribir	VMMPE
suscribidlas	suscribir	VMFPE
suscribídmelo	suscribir	VMMSE
suscribídselo	suscribir	VMMSE
suscribídnoslo	suscribir	VMMSE
suscribíoslo	suscribir	VMMSE
suscribídmelos	suscribir	VMMPE
suscribídselos	suscribir	VMMPE
suscribídnoslos	suscribir	VMMPE
suscribíoslos	suscribir	VMMPE
suscribídmela	suscribir	VMFSE
suscribídsela	suscribir	VMFSE
suscribídnosla	suscribir	VMFSE
suscribíosla	suscribir	VMFSE
suscribídmelas	suscribir	VMFPE
suscribídselas	suscribir	VMFPE
suscribídnoslas	suscribir	VMFPE
suscribíoslas	suscribir	VMFPE
suscrito	suscribir	VPMS
suscritos	suscribir	VPMP
suscrita	suscribir	VPFS
suscritas	suscribir	VFP
suscribiendo	suscribir	VG
suscribiéndome	suscribir	VGSE
suscribiéndote	suscribir	VGSE
suscribiéndole	suscribir	VGSE
suscribiéndonos	suscribir	VGPE
suscribiéndoos	suscribir	VGPE
suscribiéndolo	suscribir	VGMSE
suscribiéndola	suscribir	VGFSE
suscribiéndolos	suscribir	VGMPE
suscribiéndolas	suscribir	VGFPE
suscribiéndomelo	suscribir	VGMSE
suscribiéndotelo	suscribir	VGMSE
suscribiéndoselo	suscribir	VGMSE
suscribiéndonoslo	suscribir	VGMSE
suscribiéndooslo	suscribir	VGMSE
suscribiéndomelos	suscribir	VGMPE
suscribiéndotelos	suscribir	VGMPE
suscribiéndoselos	suscribir	VGMPE
suscribiéndonoslos	suscribir	VGMPE
suscribiéndooslos	suscribir	VGMPE
suscribiéndomela	suscribir	VGFSE
suscribiéndotela	suscribir	VGFSE
suscribiéndosela	suscribir	VGFSE
suscribiéndonosla	suscribir	VGFSE
suscribiéndoosla	suscribir	VGFSE
suscribiéndomelas	suscribir	VGFPE
suscribiéndotelas	suscribir	VGFPE
suscribiéndoselas	suscribir	VGFPE
suscribiéndonoslas	suscribir	VGFPE
suscribiéndooslas	suscribir	VGFPE
sustituir	sustituir	O
sustituyo	sustituir	VIP1
sustituyes	sustituir	VIP2
sustituye	sustituir	VIP3
sustituimos	sustituir	VIP4
sustituís	sustituir	VIP5
sustituyen	sustituir	VIP6
sustituía	sustituir	VII1
sustituías	sustituir	VII2
sustituíamos	sustituir	VII4
sustituíais	sustituir	VII5
sustituían	sustituir	VII6
sustituiré	sustituir	VIF1
sustituirás	sustituir	VIF2
sustituirá	sustituir	VIF3
sustituiremos	sustituir	VIF4
sustituiréis	sustituir	VIF5
sustituirán	sustituir	VIF6
sustituiría	sustituir	VIC1
sustituirías	sustituir	VIC2
sustituiría	sustituir	VIC3
sustituiríamos	sustituir	VIC4
sustituiríais	sustituir	VIC5
sustituirían	sustituir	VIC6
sustituí	sustituir	VIX1
sustituiste	sustituir	VIX2
sustituyó	sustituir	VIX3
sustituisteis	sustituir	VIX5
sustituyeron	sustituir	VIX6
sustituya	sustituir	VSP1
sustituyas	sustituir	VSP2
sustituyamos	sustituir	VSP4
sustituyáis	sustituir	VSP5
sustituyan	sustituir	VSP6
sustituyera	sustituir	VSX1
sustituyeras	sustituir	VSX2
sustituyéramos	sustituir	VSX4
sustituyerais	sustituir	VSX5
sustituyeran	sustituir	VSX6
sustituyere	sustituir	VSF1
sustituyeres	sustituir	VSF2
sustituyéremos	sustituir	VSF4
sustituyereis	sustituir	VSF5
sustituyeren	sustituir	VSF6
sustituyese	sustituir	VSI1
sustituyeses	sustituir	VSI2
sustituyésemos	sustituir	VSI4
sustituyeseis	sustituir	VSI5
sustituyesen	sustituir	VSI6
sustituid	sustituir	VMP
sustituidme	sustituir	VMSE
sustituidle	sustituir	VMSE
sustituidnos	sustituir	VMPE
sustituios	sustituir	VMPE
sustituidles	sustituir	VMPE
sustituidlo	sustituir	VMMSE
sustituidla	sustituir	VMFSE
sustituidlos	sustituir	VMMPE
sustituidlas	sustituir	VMFPE
sustituídmelo	sustituir	VMMSE
sustituídselo	sustituir	VMMSE
sustituídnoslo	sustituir	VMMSE
sustituíoslo	sustituir	VMMSE
sustituídmelos	sustituir	VMMPE
sustituídselos	sustituir	VMMPE
sustituídnoslos	sustituir	VMMPE
sustituíoslos	sustituir	VMMPE
sustituídmela	sustituir	VMFSE
sustituídsela	sustituir	VMFSE
sustituídnosla	sustituir	VMFSE
sustituíosla	sustituir	VMFSE
sustituídmelas	sustituir	VMFPE
sustituídselas	sustituir	VMFPE
sustituídnoslas	sustituir	VMFPE
sustituíoslas	sustituir	VMFPE
sustituido	sustituir	VPM
sustituidos	sustituir	VPMP
sustituida	sustituir	VPF
sustituidas	sustituir	VPFP
sustituyiendo	sustituir	VG
sustituyiéndome	sustituir	VGSE
sustituyiéndote	sustituir	VGSE
sustituyiéndole	sustituir	VGSE
sustituyiéndonos	sustituir	VGPE
sustituyiéndoos	sustituir	VGPE
sustituyiéndolo	sustituir	VGMSE
sustituyiéndola	sustituir	VGFSE
sustituyiéndolos	sustituir	VGMPE
sustituyiéndolas	sustituir	VGFPE
sustituyiéndomelo	sustituir	VGMSE
sustituyiéndotelo	sustituir	VGMSE
sustituyiéndoselo	sustituir	VGMSE
sustituyiéndonoslo	sustituir	VGMSE
sustituyiéndooslo	sustituir	VGMSE
sustituyiéndomelos	sustituir	VGMPE
sustituyiéndotelos	sustituir	VGMPE
sustituyiéndoselos	sustituir	VGMPE
sustituyiéndonoslos	sustituir	VGMPE
sustituyiéndooslos	sustituir	VGMPE
sustituyiéndomela	sustituir	VGFSE
sustituyiéndotela	sustituir	VGFSE
sustituyiéndosela	sustituir	VGFSE
sustituyiéndonosla	sustituir	VGFSE
sustituyiéndoosla	sustituir	VGFSE
sustituyiéndomelas	sustituir	VGFPE
sustituyiéndotelas	sustituir	VGFPE
sustituyiéndoselas	sustituir	VGFPE
sustituyiéndonoslas	sustituir	VGFPE
sustituyiéndooslas	sustituir	VGFPE
suspender	suspender	O
suspendo	suspender	VIP1
suspendes	suspender	VIP2
suspende	suspender	VIP3
suspendemos	suspender	VIP4
suspendéis	suspender	VIP5
suspenden	suspender	VIP6
suspendía	suspender	VII1
suspendías	suspender	VII2
suspendíamos	suspender	VII4
suspendíais	suspender	VII5
suspendían	suspender	VII6
suspenderé	suspender	VIF1
suspenderás	suspender	VIF2
suspenderá	suspender	VIF3
suspenderemos	suspender	VIF4
suspenderéis	suspender	VIF5
suspenderán	suspender	VIF6
suspendería	suspender	VIC1
suspenderías	suspender	VIC2
suspendería	suspender	VIC3
suspenderíamos	suspender	VIC4
suspenderíais	suspender	VIC5
suspenderían	suspender	VIC6
suspendí	suspender	VIX1
suspendiste	suspender	VIX2
suspendió	suspender	VIX3
suspendisteis	suspender	VIX5
suspendieron	suspender	VIX6
suspenda	suspender	VSP1
suspendas	suspender	VSP2
suspendamos	suspender	VSP4
suspendáis	suspender	VSP5
suspendan	suspender	VSP6
suspendiera	suspender	VSX1
suspendieras	suspender	VSX2
suspendiéramos	suspender	VSX4
suspendierais	suspender	VSX5
suspendieran	suspender	VSX6
suspendiere	suspender	VSF1
suspendieres	suspender	VSF2
suspendiéremos	suspender	VSF4
suspendiereis	suspender	VSF5
suspendieren	suspender	VSF6
suspendiese	suspender	VSI1
suspendieses	suspender	VSI2
suspendiésemos	suspender	VSI4
suspendieseis	suspender	VSI5
suspendiesen	suspender	VSI6
suspended	suspender	VMP
suspendedme	suspender	VMSE
suspendedle	suspender	VMSE
suspendednos	suspender	VMPE
suspendeos	suspender	VMPE
suspendedles	suspender	VMPE
suspendedlo	suspender	VMMSE
suspendedla	suspender	VMFSE
suspendedlos	suspender	VMMPE
suspendedlas	suspender	VMFPE
suspendédmelo	suspender	VMMSE
suspendédselo	suspender	VMMSE
suspendédnoslo	suspender	VMMSE
suspendéoslo	suspender	VMMSE
suspendédmelos	suspender	VMMPE
suspendédselos	suspender	VMMPE
suspendédnoslos	suspender	VMMPE
suspendéoslos	suspender	VMMPE
suspendédmela	suspender	VMFSE
suspendédsela	suspender	VMFSE
suspendédnosla	suspender	VMFSE
suspendéosla	suspender	VMFSE
suspendédmelas	suspender	VMFPE
suspendédselas	suspender	VMFPE
suspendédnoslas	suspender	VMFPE
suspendéoslas	suspender	VMFPE
suspendido	suspender	VPM
suspendidos	suspender	VPMP
suspendida	suspender	VPF
suspendidas	suspender	VPFP
suspendiendo	suspender	VG
suspendiéndome	suspender	VGSE
suspendiéndote	suspender	VGSE
suspendiéndole	suspender	VGSE
suspendiéndonos	suspender	VGPE
suspendiéndoos	suspender	VGPE
suspendiéndolo	suspender	VGMSE
suspendiéndola	suspender	VGFSE
suspendiéndolos	suspender	VGMPE
suspendiéndolas	suspender	VGFPE
suspendiéndomelo	suspender	VGMSE
suspendiéndotelo	suspender	VGMSE
suspendiéndoselo	suspender	VGMSE
suspendiéndonoslo	suspender	VGMSE
suspendiéndooslo	suspender	VGMSE
suspendiéndomelos	suspender	VGMPE
suspendiéndotelos	suspender	VGMPE
suspendiéndoselos	suspender	VGMPE
suspendiéndonoslos	suspender	VGMPE
suspendiéndooslos	suspender	VGMPE
suspendiéndomela	suspender	VGFSE
suspendiéndotela	suspender	VGFSE
suspendiéndosela	suspender	VGFSE
suspendiéndonosla	suspender	VGFSE
suspendiéndoosla	suspender	VGFSE
suspendiéndomelas	suspender	VGFPE
suspendiéndotelas	suspender	VGFPE
suspendiéndoselas	suspender	VGFPE
suspendiéndonoslas	suspender	VGFPE
suspendiéndooslas	suspender	VGFPE
sustraer	sustraer	O
sustraes	sustraer	VIP2
sustrae	sustraer	VIP3
sustraemos	sustraer	VIP4
sustraéis	sustraer	VIP5
sustraen	sustraer	VIP6
sustraía	sustraer	VII1
sustraías	sustraer	VII2
sustraíamos	sustraer	VII4
sustraíais	sustraer	VII5
sustraían	sustraer	VII6
sustraeré	sustraer	VIF1
sustraerás	sustraer	VIF2
sustraerá	sustraer	VIF3
sustraeremos	sustraer	VIF4
sustraeréis	sustraer	VIF5
sustraerán	sustraer	VIF6
sustraería	sustraer	VIC1
sustraerías	sustraer	VIC2
sustraería	sustraer	VIC3
sustraeríamos	sustraer	VIC4
sustraeríais	sustraer	VIC5
sustraerían	sustraer	VIC6
sustraed	sustraer	VMP
sustraedme	sustraer	VMSE
sustraedle	sustraer	VMSE
sustraednos	sustraer	VMPE
sustraeos	sustraer	VMPE
sustraedles	sustraer	VMPE
sustraedlo	sustraer	VMMSE
sustraedla	sustraer	VMFSE
sustraedlos	sustraer	VMMPE
sustraedlas	sustraer	VMFPE
sustraédmelo	sustraer	VMMSE
sustraédselo	sustraer	VMMSE
sustraédnoslo	sustraer	VMMSE
sustraéoslo	sustraer	VMMSE
sustraédmelos	sustraer	VMMPE
sustraédselos	sustraer	VMMPE
sustraédnoslos	sustraer	VMMPE
sustraéoslos	sustraer	VMMPE
sustraédmela	sustraer	VMFSE
sustraédsela	sustraer	VMFSE
sustraédnosla	sustraer	VMFSE
sustraéosla	sustraer	VMFSE
sustraédmelas	sustraer	VMFPE
sustraédselas	sustraer	VMFPE
sustraédnoslas	sustraer	VMFPE
sustraéoslas	sustraer	VMFPE
sustraído	sustraer	VPM
sustraídos	sustraer	VPMP
sustraída	sustraer	VPF
sustraídas	sustraer	VPFP
sustraiendo	sustraer	VG
sustraiéndome	sustraer	VGSE
sustraiéndote	sustraer	VGSE
sustraiéndole	sustraer	VGSE
sustraiéndonos	sustraer	VGPE
sustraiéndoos	sustraer	VGPE
sustraiéndolo	sustraer	VGMSE
sustraiéndola	sustraer	VGFSE
sustraiéndolos	sustraer	VGMPE
sustraiéndolas	sustraer	VGFPE
sustraiéndomelo	sustraer	VGMSE
sustraiéndotelo	sustraer	VGMSE
sustraiéndoselo	sustraer	VGMSE
sustraiéndonoslo	sustraer	VGMSE
sustraiéndooslo	sustraer	VGMSE
sustraiéndomelos	sustraer	VGMPE
sustraiéndotelos	sustraer	VGMPE
sustraiéndoselos	sustraer	VGMPE
sustraiéndonoslos	sustraer	VGMPE
sustraiéndooslos	sustraer	VGMPE
sustraiéndomela	sustraer	VGFSE
sustraiéndotela	sustraer	VGFSE
sustraiéndosela	sustraer	VGFSE
sustraiéndonosla	sustraer	VGFSE
sustraiéndoosla	sustraer	VGFSE
sustraiéndomelas	sustraer	VGFPE
sustraiéndotelas	sustraer	VGFPE
sustraiéndoselas	sustraer	VGFPE
sustraiéndonoslas	sustraer	VGFPE
sustraiéndooslas	sustraer	VGFPE
suscitar	suscitar	O
suscito	suscitar	VIP1
suscitas	suscitar	VIP2
suscita	suscitar	VIP3
suscitamos	suscitar	VIP4
suscitáis	suscitar	VIP5
suscitan	suscitar	VIP6
suscitaba	suscitar	VII1
suscitabas	suscitar	VII2
suscitábamos	suscitar	VII4
suscitabais	suscitar	VII5
suscitaban	suscitar	VII6
suscitaré	suscitar	VIF1
suscitarás	suscitar	VIF2
suscitará	suscitar	VIF3
suscitaremos	suscitar	VIF4
suscitaréis	suscitar	VIF5
suscitarán	suscitar	VIF6
suscitaría	suscitar	VIC1
suscitarías	suscitar	VIC2
suscitaría	suscitar	VIC3
suscitaríamos	suscitar	VIC4
suscitaríais	suscitar	VIC5
suscitarían	suscitar	VIC6
suscité	suscitar	VIX1
suscitaste	suscitar	VIX2
suscitó	suscitar	VIX3
suscitasteis	suscitar	VIX5
suscitaron	suscitar	VIX6
suscite	suscitar	VSP1
suscites	suscitar	VSP2
suscitemos	suscitar	VSP4
suscitéis	suscitar	VSP5
susciten	suscitar	VSP6
suscitara	suscitar	VSX1
suscitaras	suscitar	VSX2
suscitáramos	suscitar	VSX4
suscitarais	suscitar	VSX5
suscitaran	suscitar	VSX6
suscitare	suscitar	VSF1
suscitares	suscitar	VSF2
suscitáremos	suscitar	VSF4
suscitareis	suscitar	VSF5
suscitaren	suscitar	VSF6
suscitase	suscitar	VSI1
suscitases	suscitar	VSI2
suscitásemos	suscitar	VSI4
suscitaseis	suscitar	VSI5
suscitasen	suscitar	VSI6
suscitad	suscitar	VMP
suscitadme	suscitar	VMSE
suscitadle	suscitar	VMSE
suscitadnos	suscitar	VMPE
suscitaos	suscitar	VMPE
suscitadles	suscitar	VMPE
suscitadlo	suscitar	VMMSE
suscitadla	suscitar	VMFSE
suscitadlos	suscitar	VMMPE
suscitadlas	suscitar	VMFPE
suscitádmelo	suscitar	VMMSE
suscitádselo	suscitar	VMMSE
suscitádnoslo	suscitar	VMMSE
suscitáoslo	suscitar	VMMSE
suscitádmelos	suscitar	VMMPE
suscitádselos	suscitar	VMMPE
suscitádnoslos	suscitar	VMMPE
suscitáoslos	suscitar	VMMPE
suscitádmela	suscitar	VMFSE
suscitádsela	suscitar	VMFSE
suscitádnosla	suscitar	VMFSE
suscitáosla	suscitar	VMFSE
suscitádmelas	suscitar	VMFPE
suscitádselas	suscitar	VMFPE
suscitádnoslas	suscitar	VMFPE
suscitáoslas	suscitar	VMFPE
suscitado	suscitar	VPM
suscitados	suscitar	VPMP
suscitada	suscitar	VPF
suscitadas	suscitar	VPFP
suscitando	suscitar	VG
suscitándome	suscitar	VGSE
suscitándote	suscitar	VGSE
suscitándole	suscitar	VGSE
suscitándonos	suscitar	VGPE
suscitándoos	suscitar	VGPE
suscitándolo	suscitar	VGMSE
suscitándola	suscitar	VGFSE
suscitándolos	suscitar	VGMPE
suscitándolas	suscitar	VGFPE
suscitándomelo	suscitar	VGMSE
suscitándotelo	suscitar	VGMSE
suscitándoselo	suscitar	VGMSE
suscitándonoslo	suscitar	VGMSE
suscitándooslo	suscitar	VGMSE
suscitándomelos	suscitar	VGMPE
suscitándotelos	suscitar	VGMPE
suscitándoselos	suscitar	VGMPE
suscitándonoslos	suscitar	VGMPE
suscitándooslos	suscitar	VGMPE
suscitándomela	suscitar	VGFSE
suscitándotela	suscitar	VGFSE
suscitándosela	suscitar	VGFSE
suscitándonosla	suscitar	VGFSE
suscitándoosla	suscitar	VGFSE
suscitándomelas	suscitar	VGFPE
suscitándotelas	suscitar	VGFPE
suscitándoselas	suscitar	VGFPE
suscitándonoslas	suscitar	VGFPE
suscitándooslas	suscitar	VGFPE
suspirar	suspirar	O
suspiro	suspirar	VIP1
suspiras	suspirar	VIP2
suspira	suspirar	VIP3
suspiramos	suspirar	VIP4
suspiráis	suspirar	VIP5
suspiran	suspirar	VIP6
suspiraba	suspirar	VII1
suspirabas	suspirar	VII2
suspirábamos	suspirar	VII4
suspirabais	suspirar	VII5
suspiraban	suspirar	VII6
suspiraré	suspirar	VIF1
suspirarás	suspirar	VIF2
suspirará	suspirar	VIF3
suspiraremos	suspirar	VIF4
suspiraréis	suspirar	VIF5
suspirarán	suspirar	VIF6
suspiraría	suspirar	VIC1
suspirarías	suspirar	VIC2
suspiraría	suspirar	VIC3
suspiraríamos	suspirar	VIC4
suspiraríais	suspirar	VIC5
suspirarían	suspirar	VIC6
suspiré	suspirar	VIX1
suspiraste	suspirar	VIX2
suspiró	suspirar	VIX3
suspirasteis	suspirar	VIX5
suspiraron	suspirar	VIX6
suspire	suspirar	VSP1
suspires	suspirar	VSP2
suspiremos	suspirar	VSP4
suspiréis	suspirar	VSP5
suspiren	suspirar	VSP6
suspirara	suspirar	VSX1
suspiraras	suspirar	VSX2
suspiráramos	suspirar	VSX4
suspirarais	suspirar	VSX5
suspiraran	suspirar	VSX6
suspirare	suspirar	VSF1
suspirares	suspirar	VSF2
suspiráremos	suspirar	VSF4
suspirareis	suspirar	VSF5
suspiraren	suspirar	VSF6
suspirase	suspirar	VSI1
suspirases	suspirar	VSI2
suspirásemos	suspirar	VSI4
suspiraseis	suspirar	VSI5
suspirasen	suspirar	VSI6
suspirad	suspirar	VMP
suspiradme	suspirar	VMSE
suspiradle	suspirar	VMSE
suspiradnos	suspirar	VMPE
suspiraos	suspirar	VMPE
suspiradles	suspirar	VMPE
suspirado	suspirar	VPM
suspirados	suspirar	VPMP
suspirada	suspirar	VPF
suspiradas	suspirar	VPFP
suspirando	suspirar	VG
suspirándome	suspirar	VGSE
suspirándote	suspirar	VGSE
suspirándole	suspirar	VGSE
suspirándonos	suspirar	VGPE
suspirándoos	suspirar	VGPE
sustanciar	sustanciar	O
sustancio	sustanciar	VIP1
sustancias	sustanciar	VIP2
sustancia	sustanciar	VIP3
sustanciamos	sustanciar	VIP4
sustanciáis	sustanciar	VIP5
sustancian	sustanciar	VIP6
sustanciaba	sustanciar	VII1
sustanciabas	sustanciar	VII2
sustanciábamos	sustanciar	VII4
sustanciabais	sustanciar	VII5
sustanciaban	sustanciar	VII6
sustanciaré	sustanciar	VIF1
sustanciarás	sustanciar	VIF2
sustanciará	sustanciar	VIF3
sustanciaremos	sustanciar	VIF4
sustanciaréis	sustanciar	VIF5
sustanciarán	sustanciar	VIF6
sustanciaría	sustanciar	VIC1
sustanciarías	sustanciar	VIC2
sustanciaría	sustanciar	VIC3
sustanciaríamos	sustanciar	VIC4
sustanciaríais	sustanciar	VIC5
sustanciarían	sustanciar	VIC6
sustancié	sustanciar	VIX1
sustanciaste	sustanciar	VIX2
sustanció	sustanciar	VIX3
sustanciasteis	sustanciar	VIX5
sustanciaron	sustanciar	VIX6
sustancie	sustanciar	VSP1
sustancies	sustanciar	VSP2
sustanciemos	sustanciar	VSP4
sustanciéis	sustanciar	VSP5
sustancien	sustanciar	VSP6
sustanciara	sustanciar	VSX1
sustanciaras	sustanciar	VSX2
sustanciáramos	sustanciar	VSX4
sustanciarais	sustanciar	VSX5
sustanciaran	sustanciar	VSX6
sustanciare	sustanciar	VSF1
sustanciares	sustanciar	VSF2
sustanciáremos	sustanciar	VSF4
sustanciareis	sustanciar	VSF5
sustanciaren	sustanciar	VSF6
sustanciase	sustanciar	VSI1
sustanciases	sustanciar	VSI2
sustanciásemos	sustanciar	VSI4
sustanciaseis	sustanciar	VSI5
sustanciasen	sustanciar	VSI6
sustanciad	sustanciar	VMP
sustanciadme	sustanciar	VMSE
sustanciadle	sustanciar	VMSE
sustanciadnos	sustanciar	VMPE
sustanciaos	sustanciar	VMPE
sustanciadles	sustanciar	VMPE
sustanciadlo	sustanciar	VMMSE
sustanciadla	sustanciar	VMFSE
sustanciadlos	sustanciar	VMMPE
sustanciadlas	sustanciar	VMFPE
sustanciádmelo	sustanciar	VMMSE
sustanciádselo	sustanciar	VMMSE
sustanciádnoslo	sustanciar	VMMSE
sustanciáoslo	sustanciar	VMMSE
sustanciádmelos	sustanciar	VMMPE
sustanciádselos	sustanciar	VMMPE
sustanciádnoslos	sustanciar	VMMPE
sustanciáoslos	sustanciar	VMMPE
sustanciádmela	sustanciar	VMFSE
sustanciádsela	sustanciar	VMFSE
sustanciádnosla	sustanciar	VMFSE
sustanciáosla	sustanciar	VMFSE
sustanciádmelas	sustanciar	VMFPE
sustanciádselas	sustanciar	VMFPE
sustanciádnoslas	sustanciar	VMFPE
sustanciáoslas	sustanciar	VMFPE
sustanciado	sustanciar	VPM
sustanciados	sustanciar	VPMP
sustanciada	sustanciar	VPF
sustanciadas	sustanciar	VPFP
sustanciando	sustanciar	VG
sustanciándome	sustanciar	VGSE
sustanciándote	sustanciar	VGSE
sustanciándole	sustanciar	VGSE
sustanciándonos	sustanciar	VGPE
sustanciándoos	sustanciar	VGPE
sustanciándolo	sustanciar	VGMSE
sustanciándola	sustanciar	VGFSE
sustanciándolos	sustanciar	VGMPE
sustanciándolas	sustanciar	VGFPE
sustanciándomelo	sustanciar	VGMSE
sustanciándotelo	sustanciar	VGMSE
sustanciándoselo	sustanciar	VGMSE
sustanciándonoslo	sustanciar	VGMSE
sustanciándooslo	sustanciar	VGMSE
sustanciándomelos	sustanciar	VGMPE
sustanciándotelos	sustanciar	VGMPE
sustanciándoselos	sustanciar	VGMPE
sustanciándonoslos	sustanciar	VGMPE
sustanciándooslos	sustanciar	VGMPE
sustanciándomela	sustanciar	VGFSE
sustanciándotela	sustanciar	VGFSE
sustanciándosela	sustanciar	VGFSE
sustanciándonosla	sustanciar	VGFSE
sustanciándoosla	sustanciar	VGFSE
sustanciándomelas	sustanciar	VGFPE
sustanciándotelas	sustanciar	VGFPE
sustanciándoselas	sustanciar	VGFPE
sustanciándonoslas	sustanciar	VGFPE
sustanciándooslas	sustanciar	VGFPE
sustantivar	sustantivar	O
sustantivo	sustantivar	VIP1
sustantivas	sustantivar	VIP2
sustantiva	sustantivar	VIP3
sustantivamos	sustantivar	VIP4
sustantiváis	sustantivar	VIP5
sustantivan	sustantivar	VIP6
sustantivaba	sustantivar	VII1
sustantivabas	sustantivar	VII2
sustantivábamos	sustantivar	VII4
sustantivabais	sustantivar	VII5
sustantivaban	sustantivar	VII6
sustantivaré	sustantivar	VIF1
sustantivarás	sustantivar	VIF2
sustantivará	sustantivar	VIF3
sustantivaremos	sustantivar	VIF4
sustantivaréis	sustantivar	VIF5
sustantivarán	sustantivar	VIF6
sustantivaría	sustantivar	VIC1
sustantivarías	sustantivar	VIC2
sustantivaría	sustantivar	VIC3
sustantivaríamos	sustantivar	VIC4
sustantivaríais	sustantivar	VIC5
sustantivarían	sustantivar	VIC6
sustantivé	sustantivar	VIX1
sustantivaste	sustantivar	VIX2
sustantivó	sustantivar	VIX3
sustantivasteis	sustantivar	VIX5
sustantivaron	sustantivar	VIX6
sustantive	sustantivar	VSP1
sustantives	sustantivar	VSP2
sustantivemos	sustantivar	VSP4
sustantivéis	sustantivar	VSP5
sustantiven	sustantivar	VSP6
sustantivara	sustantivar	VSX1
sustantivaras	sustantivar	VSX2
sustantiváramos	sustantivar	VSX4
sustantivarais	sustantivar	VSX5
sustantivaran	sustantivar	VSX6
sustantivare	sustantivar	VSF1
sustantivares	sustantivar	VSF2
sustantiváremos	sustantivar	VSF4
sustantivareis	sustantivar	VSF5
sustantivaren	sustantivar	VSF6
sustantivase	sustantivar	VSI1
sustantivases	sustantivar	VSI2
sustantivásemos	sustantivar	VSI4
sustantivaseis	sustantivar	VSI5
sustantivasen	sustantivar	VSI6
sustantivad	sustantivar	VMP
sustantivadme	sustantivar	VMSE
sustantivadle	sustantivar	VMSE
sustantivadnos	sustantivar	VMPE
sustantivaos	sustantivar	VMPE
sustantivadles	sustantivar	VMPE
sustantivadlo	sustantivar	VMMSE
sustantivadla	sustantivar	VMFSE
sustantivadlos	sustantivar	VMMPE
sustantivadlas	sustantivar	VMFPE
sustantivádmelo	sustantivar	VMMSE
sustantivádselo	sustantivar	VMMSE
sustantivádnoslo	sustantivar	VMMSE
sustantiváoslo	sustantivar	VMMSE
sustantivádmelos	sustantivar	VMMPE
sustantivádselos	sustantivar	VMMPE
sustantivádnoslos	sustantivar	VMMPE
sustantiváoslos	sustantivar	VMMPE
sustantivádmela	sustantivar	VMFSE
sustantivádsela	sustantivar	VMFSE
sustantivádnosla	sustantivar	VMFSE
sustantiváosla	sustantivar	VMFSE
sustantivádmelas	sustantivar	VMFPE
sustantivádselas	sustantivar	VMFPE
sustantivádnoslas	sustantivar	VMFPE
sustantiváoslas	sustantivar	VMFPE
sustantivado	sustantivar	VPM
sustantivados	sustantivar	VPMP
sustantivada	sustantivar	VPF
sustantivadas	sustantivar	VPFP
sustantivando	sustantivar	VG
sustantivándome	sustantivar	VGSE
sustantivándote	sustantivar	VGSE
sustantivándole	sustantivar	VGSE
sustantivándonos	sustantivar	VGPE
sustantivándoos	sustantivar	VGPE
sustantivándolo	sustantivar	VGMSE
sustantivándola	sustantivar	VGFSE
sustantivándolos	sustantivar	VGMPE
sustantivándolas	sustantivar	VGFPE
sustantivándomelo	sustantivar	VGMSE
sustantivándotelo	sustantivar	VGMSE
sustantivándoselo	sustantivar	VGMSE
sustantivándonoslo	sustantivar	VGMSE
sustantivándooslo	sustantivar	VGMSE
sustantivándomelos	sustantivar	VGMPE
sustantivándotelos	sustantivar	VGMPE
sustantivándoselos	sustantivar	VGMPE
sustantivándonoslos	sustantivar	VGMPE
sustantivándooslos	sustantivar	VGMPE
sustantivándomela	sustantivar	VGFSE
sustantivándotela	sustantivar	VGFSE
sustantivándosela	sustantivar	VGFSE
sustantivándonosla	sustantivar	VGFSE
sustantivándoosla	sustantivar	VGFSE
sustantivándomelas	sustantivar	VGFPE
sustantivándotelas	sustantivar	VGFPE
sustantivándoselas	sustantivar	VGFPE
sustantivándonoslas	sustantivar	VGFPE
sustantivándooslas	sustantivar	VGFPE
sustentar	sustentar	O
sustento	sustentar	VIP1
sustentas	sustentar	VIP2
sustenta	sustentar	VIP3
sustentamos	sustentar	VIP4
sustentáis	sustentar	VIP5
sustentan	sustentar	VIP6
sustentaba	sustentar	VII1
sustentabas	sustentar	VII2
sustentábamos	sustentar	VII4
sustentabais	sustentar	VII5
sustentaban	sustentar	VII6
sustentaré	sustentar	VIF1
sustentarás	sustentar	VIF2
sustentará	sustentar	VIF3
sustentaremos	sustentar	VIF4
sustentaréis	sustentar	VIF5
sustentarán	sustentar	VIF6
sustentaría	sustentar	VIC1
sustentarías	sustentar	VIC2
sustentaría	sustentar	VIC3
sustentaríamos	sustentar	VIC4
sustentaríais	sustentar	VIC5
sustentarían	sustentar	VIC6
sustenté	sustentar	VIX1
sustentaste	sustentar	VIX2
sustentó	sustentar	VIX3
sustentasteis	sustentar	VIX5
sustentaron	sustentar	VIX6
sustente	sustentar	VSP1
sustentes	sustentar	VSP2
sustentemos	sustentar	VSP4
sustentéis	sustentar	VSP5
sustenten	sustentar	VSP6
sustentara	sustentar	VSX1
sustentaras	sustentar	VSX2
sustentáramos	sustentar	VSX4
sustentarais	sustentar	VSX5
sustentaran	sustentar	VSX6
sustentare	sustentar	VSF1
sustentares	sustentar	VSF2
sustentáremos	sustentar	VSF4
sustentareis	sustentar	VSF5
sustentaren	sustentar	VSF6
sustentase	sustentar	VSI1
sustentases	sustentar	VSI2
sustentásemos	sustentar	VSI4
sustentaseis	sustentar	VSI5
sustentasen	sustentar	VSI6
sustentad	sustentar	VMP
sustentadme	sustentar	VMSE
sustentadle	sustentar	VMSE
sustentadnos	sustentar	VMPE
sustentaos	sustentar	VMPE
sustentadles	sustentar	VMPE
sustentadlo	sustentar	VMMSE
sustentadla	sustentar	VMFSE
sustentadlos	sustentar	VMMPE
sustentadlas	sustentar	VMFPE
sustentádmelo	sustentar	VMMSE
sustentádselo	sustentar	VMMSE
sustentádnoslo	sustentar	VMMSE
sustentáoslo	sustentar	VMMSE
sustentádmelos	sustentar	VMMPE
sustentádselos	sustentar	VMMPE
sustentádnoslos	sustentar	VMMPE
sustentáoslos	sustentar	VMMPE
sustentádmela	sustentar	VMFSE
sustentádsela	sustentar	VMFSE
sustentádnosla	sustentar	VMFSE
sustentáosla	sustentar	VMFSE
sustentádmelas	sustentar	VMFPE
sustentádselas	sustentar	VMFPE
sustentádnoslas	sustentar	VMFPE
sustentáoslas	sustentar	VMFPE
sustentado	sustentar	VPM
sustentados	sustentar	VPMP
sustentada	sustentar	VPF
sustentadas	sustentar	VPFP
sustentando	sustentar	VG
sustentándome	sustentar	VGSE
sustentándote	sustentar	VGSE
sustentándole	sustentar	VGSE
sustentándonos	sustentar	VGPE
sustentándoos	sustentar	VGPE
sustentándolo	sustentar	VGMSE
sustentándola	sustentar	VGFSE
sustentándolos	sustentar	VGMPE
sustentándolas	sustentar	VGFPE
sustentándomelo	sustentar	VGMSE
sustentándotelo	sustentar	VGMSE
sustentándoselo	sustentar	VGMSE
sustentándonoslo	sustentar	VGMSE
sustentándooslo	sustentar	VGMSE
sustentándomelos	sustentar	VGMPE
sustentándotelos	sustentar	VGMPE
sustentándoselos	sustentar	VGMPE
sustentándonoslos	sustentar	VGMPE
sustentándooslos	sustentar	VGMPE
sustentándomela	sustentar	VGFSE
sustentándotela	sustentar	VGFSE
sustentándosela	sustentar	VGFSE
sustentándonosla	sustentar	VGFSE
sustentándoosla	sustentar	VGFSE
sustentándomelas	sustentar	VGFPE
sustentándotelas	sustentar	VGFPE
sustentándoselas	sustentar	VGFPE
sustentándonoslas	sustentar	VGFPE
sustentándooslas	sustentar	VGFPE
sustentares	sustentar	P
susurrar	susurrar	O
susurro	susurrar	VIP1
susurras	susurrar	VIP2
susurra	susurrar	VIP3
susurramos	susurrar	VIP4
susurráis	susurrar	VIP5
susurran	susurrar	VIP6
susurraba	susurrar	VII1
susurrabas	susurrar	VII2
susurrábamos	susurrar	VII4
susurrabais	susurrar	VII5
susurraban	susurrar	VII6
susurraré	susurrar	VIF1
susurrarás	susurrar	VIF2
susurrará	susurrar	VIF3
susurraremos	susurrar	VIF4
susurraréis	susurrar	VIF5
susurrarán	susurrar	VIF6
susurraría	susurrar	VIC1
susurrarías	susurrar	VIC2
susurraría	susurrar	VIC3
susurraríamos	susurrar	VIC4
susurraríais	susurrar	VIC5
susurrarían	susurrar	VIC6
susurré	susurrar	VIX1
susurraste	susurrar	VIX2
susurró	susurrar	VIX3
susurrasteis	susurrar	VIX5
susurraron	susurrar	VIX6
susurre	susurrar	VSP1
susurres	susurrar	VSP2
susurremos	susurrar	VSP4
susurréis	susurrar	VSP5
susurren	susurrar	VSP6
susurrara	susurrar	VSX1
susurraras	susurrar	VSX2
susurráramos	susurrar	VSX4
susurrarais	susurrar	VSX5
susurraran	susurrar	VSX6
susurrare	susurrar	VSF1
susurrares	susurrar	VSF2
susurráremos	susurrar	VSF4
susurrareis	susurrar	VSF5
susurraren	susurrar	VSF6
susurrase	susurrar	VSI1
susurrases	susurrar	VSI2
susurrásemos	susurrar	VSI4
susurraseis	susurrar	VSI5
susurrasen	susurrar	VSI6
susurrad	susurrar	VMP
susurradme	susurrar	VMSE
susurradle	susurrar	VMSE
susurradnos	susurrar	VMPE
susurraos	susurrar	VMPE
susurradles	susurrar	VMPE
susurradlo	susurrar	VMMSE
susurradla	susurrar	VMFSE
susurradlos	susurrar	VMMPE
susurradlas	susurrar	VMFPE
susurrádmelo	susurrar	VMMSE
susurrádselo	susurrar	VMMSE
susurrádnoslo	susurrar	VMMSE
susurráoslo	susurrar	VMMSE
susurrádmelos	susurrar	VMMPE
susurrádselos	susurrar	VMMPE
susurrádnoslos	susurrar	VMMPE
susurráoslos	susurrar	VMMPE
susurrádmela	susurrar	VMFSE
susurrádsela	susurrar	VMFSE
susurrádnosla	susurrar	VMFSE
susurráosla	susurrar	VMFSE
susurrádmelas	susurrar	VMFPE
susurrádselas	susurrar	VMFPE
susurrádnoslas	susurrar	VMFPE
susurráoslas	susurrar	VMFPE
susurrado	susurrar	VPM
susurrados	susurrar	VPMP
susurrada	susurrar	VPF
susurradas	susurrar	VPFP
susurrando	susurrar	VG
susurrándome	susurrar	VGSE
susurrándote	susurrar	VGSE
susurrándole	susurrar	VGSE
susurrándonos	susurrar	VGPE
susurrándoos	susurrar	VGPE
susurrándolo	susurrar	VGMSE
susurrándola	susurrar	VGFSE
susurrándolos	susurrar	VGMPE
susurrándolas	susurrar	VGFPE
susurrándomelo	susurrar	VGMSE
susurrándotelo	susurrar	VGMSE
susurrándoselo	susurrar	VGMSE
susurrándonoslo	susurrar	VGMSE
susurrándooslo	susurrar	VGMSE
susurrándomelos	susurrar	VGMPE
susurrándotelos	susurrar	VGMPE
susurrándoselos	susurrar	VGMPE
susurrándonoslos	susurrar	VGMPE
susurrándooslos	susurrar	VGMPE
susurrándomela	susurrar	VGFSE
susurrándotela	susurrar	VGFSE
susurrándosela	susurrar	VGFSE
susurrándonosla	susurrar	VGFSE
susurrándoosla	susurrar	VGFSE
susurrándomelas	susurrar	VGFPE
susurrándotelas	susurrar	VGFPE
susurrándoselas	susurrar	VGFPE
susurrándonoslas	susurrar	VGFPE
susurrándooslas	susurrar	VGFPE
susurrares	susurrar	P
