tal	tal	O
tales	tal	P
tala	tala	O
talas	tala	P
talabarte	talabarte	O
talabartes	talabarte	P
talabartero	talabartero	O
talabarteras	talabartero	FP
talabartera	talabartero	F
talabarteros	talabartero	P
talabartería	talabartería	O
talabarterías	talabartería	P
talabricense	talabricense	O
talabricenses	talabricense	P
talacho	talacho	O
talachos	talacho	P
talador	talador	O
taladoras	talador	FP
taladora	talador	F
taladores	talador	P
taladrado	taladrado	O
taladrados	taladrado	P
taladrador	taladrador	O
taladradoras	taladrador	FP
taladradora	taladrador	F
taladradores	taladrador	P
taladrilla	taladrilla	O
taladrillas	taladrilla	P
taladro	taladro	O
taladros	taladro	P
talaje	talaje	O
talajes	talaje	P
talamera	talamera	O
talameras	talamera	P
talamete	talamete	O
talametes	talamete	P
talamiflora	talamiflora	O
talamifloras	talamiflora	P
talamite	talamite	O
talamites	talamite	P
talanquera	talanquera	O
talanqueras	talanquera	P
talante	talante	O
talantes	talante	P
talantoso	talantoso	O
talantosas	talantoso	FP
talantosa	talantoso	F
talantosos	talantoso	P
talasemia	talasemia	O
talasemias	talasemia	P
talasocracia	talasocracia	O
talasocracias	talasocracia	P
talasoterapia	talasoterapia	O
talasoterapias	talasoterapia	P
talaverano	talaverano	O
talaveranas	talaverano	FP
talaverana	talaverano	F
talaveranos	talaverano	P
talaya	talaya	O
talayas	talaya	P
talayote	talayote	O
talayotes	talayote	P
talchocote	talchocote	O
talchocotes	talchocote	P
talco	talco	O
talcos	talco	P
talcoso	talcoso	O
talcosas	talcoso	FP
talcosa	talcoso	F
talcosos	talcoso	P
talcualillo	talcualillo	O
talcualillas	talcualillo	FP
talcualilla	talcualillo	F
talcualillos	talcualillo	P
taled	taled	O
taledes	taled	P
talega	talega	O
talegas	talega	P
talegada	talegada	O
talegadas	talegada	P
talegazo	talegazo	O
talegazos	talegazo	P
talego	talego	O
talegos	talego	P
taleguilla	taleguilla	O
taleguillas	taleguilla	P
talente	talente	O
talentes	talente	P
talento	talento	O
talentos	talento	P
talentoso	talentoso	O
talentosas	talentoso	FP
talentosa	talentoso	F
talentosos	talentoso	P
talentudo	talentudo	O
talentudas	talentudo	FP
talentuda	talentudo	F
talentudos	talentudo	P
talero	talero	O
taleros	talero	P
talgo	talgo	O
talgos	talgo	P
talguate	talguate	O
talguates	talguate	P
talicón	talicón	O
talicones	talicón	P
talidad	talidad	O
talidades	talidad	P
talio	talio	O
talios	talio	P
talismán	talismán	O
talismanes	talismán	P
talión	talión	O
taliones	talión	P
talla	talla	O
tallas	talla	P
tallado	tallado	O
talladas	tallado	FP
tallada	tallado	F
tallados	tallado	P
tallador	tallador	O
talladoras	tallador	FP
talladora	tallador	F
talladores	tallador	P
talladura	talladura	O
talladuras	talladura	P
tallarola	tallarola	O
tallarolas	tallarola	P
tallarín	tallarín	O
tallarines	tallarín	P
talle	talle	O
talles	talle	P
taller	taller	O
talleres	taller	P
tallero	tallero	O
talleras	tallero	FP
tallera	tallero	F
talleros	tallero	P
tallista	tallista	O
tallistas	tallista	P
tallo	tallo	O
tallos	tallo	P
talludo	talludo	O
talludas	talludo	FP
talluda	talludo	F
talludos	talludo	P
tallón	tallón	O
tallones	tallón	P
talma	talma	O
talmas	talma	P
talmente	talmente	O
talmudista	talmudista	O
talmudistas	talmudista	P
talmúdico	talmúdico	O
talmúdicas	talmúdico	FP
talmúdica	talmúdico	F
talmúdicos	talmúdico	P
talo	talo	O
talos	talo	P
talofita	talofita	O
talofitas	talofita	P
talonada	talonada	O
talonadas	talonada	P
talonario	talonario	O
talonarias	talonario	FP
talonaria	talonario	F
talonarios	talonario	P
talonazo	talonazo	O
talonazos	talonazo	P
talonera	talonera	O
taloneras	talonera	P
talonero	talonero	O
taloneros	talonero	P
talpa	talpa	O
talpas	talpa	P
talparia	talparia	O
talparias	talparia	P
talpetate	talpetate	O
talpetates	talpetate	P
talpetatoso	talpetatoso	O
talpetatosas	talpetatoso	FP
talpetatosa	talpetatoso	F
talpetatosos	talpetatoso	P
talpuja	talpuja	O
talpujas	talpuja	P
talque	talque	O
talques	talque	P
talquino	talquino	O
talquinas	talquino	FP
talquina	talquino	F
talquinos	talquino	P
talquita	talquita	O
talquitas	talquita	P
taltuza	taltuza	O
taltuzas	taltuza	P
talud	talud	O
taludes	talud	P
taludín	taludín	O
taludines	taludín	P
talvez	talvez	O
talvina	talvina	O
talvinas	talvina	P
talán	talán	O
talanes	talán	P
talín	talín	O
talines	talín	P
talón	talón	O
talones	talón	P
tálamo	tálamo	O
tálamos	tálamo	P
tálea	tálea	O
táleas	tálea	P
tálero	tálero	O
táleros	tálero	P
táller	táller	O
tálleres	táller	P
tallecer	tallecer	O
tallezco	tallecer	VIP1
talleces	tallecer	VIP2
tallece	tallecer	VIP3
tallecemos	tallecer	VIP4
tallecéis	tallecer	VIP5
tallecen	tallecer	VIP6
tallecía	tallecer	VII1
tallecías	tallecer	VII2
tallecíamos	tallecer	VII4
tallecíais	tallecer	VII5
tallecían	tallecer	VII6
talleceré	tallecer	VIF1
tallecerás	tallecer	VIF2
tallecerá	tallecer	VIF3
talleceremos	tallecer	VIF4
talleceréis	tallecer	VIF5
tallecerán	tallecer	VIF6
tallecería	tallecer	VIC1
tallecerías	tallecer	VIC2
tallecería	tallecer	VIC3
talleceríamos	tallecer	VIC4
talleceríais	tallecer	VIC5
tallecerían	tallecer	VIC6
tallecí	tallecer	VIX1
talleciste	tallecer	VIX2
talleció	tallecer	VIX3
tallecisteis	tallecer	VIX5
tallecieron	tallecer	VIX6
tallezca	tallecer	VSP1
tallezcas	tallecer	VSP2
tallezcamos	tallecer	VSP4
tallezcáis	tallecer	VSP5
tallezcan	tallecer	VSP6
talleciera	tallecer	VSX1
tallecieras	tallecer	VSX2
talleciéramos	tallecer	VSX4
tallecierais	tallecer	VSX5
tallecieran	tallecer	VSX6
talleciere	tallecer	VSF1
tallecieres	tallecer	VSF2
talleciéremos	tallecer	VSF4
talleciereis	tallecer	VSF5
tallecieren	tallecer	VSF6
talleciese	tallecer	VSI1
tallecieses	tallecer	VSI2
talleciésemos	tallecer	VSI4
tallecieseis	tallecer	VSI5
talleciesen	tallecer	VSI6
talleced	tallecer	VMP
tallecedme	tallecer	VMSE
tallecedle	tallecer	VMSE
tallecednos	tallecer	VMPE
talleceos	tallecer	VMPE
tallecedles	tallecer	VMPE
tallecido	tallecer	VPM
tallecidos	tallecer	VPMP
tallecida	tallecer	VPF
tallecidas	tallecer	VPFP
talleciendo	tallecer	VG
talleciéndome	tallecer	VGSE
talleciéndote	tallecer	VGSE
talleciéndole	tallecer	VGSE
talleciéndonos	tallecer	VGPE
talleciéndoos	tallecer	VGPE
taladrar	taladrar	O
taladro	taladrar	VIP1
taladras	taladrar	VIP2
taladra	taladrar	VIP3
taladramos	taladrar	VIP4
taladráis	taladrar	VIP5
taladran	taladrar	VIP6
taladraba	taladrar	VII1
taladrabas	taladrar	VII2
taladrábamos	taladrar	VII4
taladrabais	taladrar	VII5
taladraban	taladrar	VII6
taladraré	taladrar	VIF1
taladrarás	taladrar	VIF2
taladrará	taladrar	VIF3
taladraremos	taladrar	VIF4
taladraréis	taladrar	VIF5
taladrarán	taladrar	VIF6
taladraría	taladrar	VIC1
taladrarías	taladrar	VIC2
taladraría	taladrar	VIC3
taladraríamos	taladrar	VIC4
taladraríais	taladrar	VIC5
taladrarían	taladrar	VIC6
taladré	taladrar	VIX1
taladraste	taladrar	VIX2
taladró	taladrar	VIX3
taladrasteis	taladrar	VIX5
taladraron	taladrar	VIX6
taladre	taladrar	VSP1
taladres	taladrar	VSP2
taladremos	taladrar	VSP4
taladréis	taladrar	VSP5
taladren	taladrar	VSP6
taladrara	taladrar	VSX1
taladraras	taladrar	VSX2
taladráramos	taladrar	VSX4
taladrarais	taladrar	VSX5
taladraran	taladrar	VSX6
taladrare	taladrar	VSF1
taladrares	taladrar	VSF2
taladráremos	taladrar	VSF4
taladrareis	taladrar	VSF5
taladraren	taladrar	VSF6
taladrase	taladrar	VSI1
taladrases	taladrar	VSI2
taladrásemos	taladrar	VSI4
taladraseis	taladrar	VSI5
taladrasen	taladrar	VSI6
taladrad	taladrar	VMP
taladradme	taladrar	VMSE
taladradle	taladrar	VMSE
taladradnos	taladrar	VMPE
taladraos	taladrar	VMPE
taladradles	taladrar	VMPE
taladradlo	taladrar	VMMSE
taladradla	taladrar	VMFSE
taladradlos	taladrar	VMMPE
taladradlas	taladrar	VMFPE
taladrádmelo	taladrar	VMMSE
taladrádselo	taladrar	VMMSE
taladrádnoslo	taladrar	VMMSE
taladráoslo	taladrar	VMMSE
taladrádmelos	taladrar	VMMPE
taladrádselos	taladrar	VMMPE
taladrádnoslos	taladrar	VMMPE
taladráoslos	taladrar	VMMPE
taladrádmela	taladrar	VMFSE
taladrádsela	taladrar	VMFSE
taladrádnosla	taladrar	VMFSE
taladráosla	taladrar	VMFSE
taladrádmelas	taladrar	VMFPE
taladrádselas	taladrar	VMFPE
taladrádnoslas	taladrar	VMFPE
taladráoslas	taladrar	VMFPE
taladrado	taladrar	VPM
taladrados	taladrar	VPMP
taladrada	taladrar	VPF
taladradas	taladrar	VPFP
taladrando	taladrar	VG
taladrándome	taladrar	VGSE
taladrándote	taladrar	VGSE
taladrándole	taladrar	VGSE
taladrándonos	taladrar	VGPE
taladrándoos	taladrar	VGPE
taladrándolo	taladrar	VGMSE
taladrándola	taladrar	VGFSE
taladrándolos	taladrar	VGMPE
taladrándolas	taladrar	VGFPE
taladrándomelo	taladrar	VGMSE
taladrándotelo	taladrar	VGMSE
taladrándoselo	taladrar	VGMSE
taladrándonoslo	taladrar	VGMSE
taladrándooslo	taladrar	VGMSE
taladrándomelos	taladrar	VGMPE
taladrándotelos	taladrar	VGMPE
taladrándoselos	taladrar	VGMPE
taladrándonoslos	taladrar	VGMPE
taladrándooslos	taladrar	VGMPE
taladrándomela	taladrar	VGFSE
taladrándotela	taladrar	VGFSE
taladrándosela	taladrar	VGFSE
taladrándonosla	taladrar	VGFSE
taladrándoosla	taladrar	VGFSE
taladrándomelas	taladrar	VGFPE
taladrándotelas	taladrar	VGFPE
taladrándoselas	taladrar	VGFPE
taladrándonoslas	taladrar	VGFPE
taladrándooslas	taladrar	VGFPE
talar	talar	O
talo	talar	VIP1
talas	talar	VIP2
tala	talar	VIP3
talamos	talar	VIP4
taláis	talar	VIP5
talan	talar	VIP6
talaba	talar	VII1
talabas	talar	VII2
talábamos	talar	VII4
talabais	talar	VII5
talaban	talar	VII6
talaré	talar	VIF1
talarás	talar	VIF2
talará	talar	VIF3
talaremos	talar	VIF4
talaréis	talar	VIF5
talarán	talar	VIF6
talaría	talar	VIC1
talarías	talar	VIC2
talaría	talar	VIC3
talaríamos	talar	VIC4
talaríais	talar	VIC5
talarían	talar	VIC6
talé	talar	VIX1
talaste	talar	VIX2
taló	talar	VIX3
talasteis	talar	VIX5
talaron	talar	VIX6
tale	talar	VSP1
tales	talar	VSP2
talemos	talar	VSP4
taléis	talar	VSP5
talen	talar	VSP6
talara	talar	VSX1
talaras	talar	VSX2
taláramos	talar	VSX4
talarais	talar	VSX5
talaran	talar	VSX6
talare	talar	VSF1
talares	talar	VSF2
taláremos	talar	VSF4
talareis	talar	VSF5
talaren	talar	VSF6
talase	talar	VSI1
talases	talar	VSI2
talásemos	talar	VSI4
talaseis	talar	VSI5
talasen	talar	VSI6
talad	talar	VMP
taladme	talar	VMSE
taladle	talar	VMSE
taladnos	talar	VMPE
talaos	talar	VMPE
taladles	talar	VMPE
taladlo	talar	VMMSE
taladla	talar	VMFSE
taladlos	talar	VMMPE
taladlas	talar	VMFPE
taládmelo	talar	VMMSE
taládselo	talar	VMMSE
taládnoslo	talar	VMMSE
taláoslo	talar	VMMSE
taládmelos	talar	VMMPE
taládselos	talar	VMMPE
taládnoslos	talar	VMMPE
taláoslos	talar	VMMPE
taládmela	talar	VMFSE
taládsela	talar	VMFSE
taládnosla	talar	VMFSE
taláosla	talar	VMFSE
taládmelas	talar	VMFPE
taládselas	talar	VMFPE
taládnoslas	talar	VMFPE
taláoslas	talar	VMFPE
talado	talar	VPM
talados	talar	VPMP
talada	talar	VPF
taladas	talar	VPFP
talando	talar	VG
talándome	talar	VGSE
talándote	talar	VGSE
talándole	talar	VGSE
talándonos	talar	VGPE
talándoos	talar	VGPE
talándolo	talar	VGMSE
talándola	talar	VGFSE
talándolos	talar	VGMPE
talándolas	talar	VGFPE
talándomelo	talar	VGMSE
talándotelo	talar	VGMSE
talándoselo	talar	VGMSE
talándonoslo	talar	VGMSE
talándooslo	talar	VGMSE
talándomelos	talar	VGMPE
talándotelos	talar	VGMPE
talándoselos	talar	VGMPE
talándonoslos	talar	VGMPE
talándooslos	talar	VGMPE
talándomela	talar	VGFSE
talándotela	talar	VGFSE
talándosela	talar	VGFSE
talándonosla	talar	VGFSE
talándoosla	talar	VGFSE
talándomelas	talar	VGFPE
talándotelas	talar	VGFPE
talándoselas	talar	VGFPE
talándonoslas	talar	VGFPE
talándooslas	talar	VGFPE
talares	talar	P
talionar	talionar	O
taliono	talionar	VIP1
talionas	talionar	VIP2
taliona	talionar	VIP3
talionamos	talionar	VIP4
talionáis	talionar	VIP5
talionan	talionar	VIP6
talionaba	talionar	VII1
talionabas	talionar	VII2
talionábamos	talionar	VII4
talionabais	talionar	VII5
talionaban	talionar	VII6
talionaré	talionar	VIF1
talionarás	talionar	VIF2
talionará	talionar	VIF3
talionaremos	talionar	VIF4
talionaréis	talionar	VIF5
talionarán	talionar	VIF6
talionaría	talionar	VIC1
talionarías	talionar	VIC2
talionaría	talionar	VIC3
talionaríamos	talionar	VIC4
talionaríais	talionar	VIC5
talionarían	talionar	VIC6
talioné	talionar	VIX1
talionaste	talionar	VIX2
talionó	talionar	VIX3
talionasteis	talionar	VIX5
talionaron	talionar	VIX6
talione	talionar	VSP1
taliones	talionar	VSP2
talionemos	talionar	VSP4
talionéis	talionar	VSP5
talionen	talionar	VSP6
talionara	talionar	VSX1
talionaras	talionar	VSX2
talionáramos	talionar	VSX4
talionarais	talionar	VSX5
talionaran	talionar	VSX6
talionare	talionar	VSF1
talionares	talionar	VSF2
talionáremos	talionar	VSF4
talionareis	talionar	VSF5
talionaren	talionar	VSF6
talionase	talionar	VSI1
talionases	talionar	VSI2
talionásemos	talionar	VSI4
talionaseis	talionar	VSI5
talionasen	talionar	VSI6
talionad	talionar	VMP
talionadme	talionar	VMSE
talionadle	talionar	VMSE
talionadnos	talionar	VMPE
talionaos	talionar	VMPE
talionadles	talionar	VMPE
talionadlo	talionar	VMMSE
talionadla	talionar	VMFSE
talionadlos	talionar	VMMPE
talionadlas	talionar	VMFPE
talionádmelo	talionar	VMMSE
talionádselo	talionar	VMMSE
talionádnoslo	talionar	VMMSE
talionáoslo	talionar	VMMSE
talionádmelos	talionar	VMMPE
talionádselos	talionar	VMMPE
talionádnoslos	talionar	VMMPE
talionáoslos	talionar	VMMPE
talionádmela	talionar	VMFSE
talionádsela	talionar	VMFSE
talionádnosla	talionar	VMFSE
talionáosla	talionar	VMFSE
talionádmelas	talionar	VMFPE
talionádselas	talionar	VMFPE
talionádnoslas	talionar	VMFPE
talionáoslas	talionar	VMFPE
talionado	talionar	VPM
talionados	talionar	VPMP
talionada	talionar	VPF
talionadas	talionar	VPFP
talionando	talionar	VG
talionándome	talionar	VGSE
talionándote	talionar	VGSE
talionándole	talionar	VGSE
talionándonos	talionar	VGPE
talionándoos	talionar	VGPE
talionándolo	talionar	VGMSE
talionándola	talionar	VGFSE
talionándolos	talionar	VGMPE
talionándolas	talionar	VGFPE
talionándomelo	talionar	VGMSE
talionándotelo	talionar	VGMSE
talionándoselo	talionar	VGMSE
talionándonoslo	talionar	VGMSE
talionándooslo	talionar	VGMSE
talionándomelos	talionar	VGMPE
talionándotelos	talionar	VGMPE
talionándoselos	talionar	VGMPE
talionándonoslos	talionar	VGMPE
talionándooslos	talionar	VGMPE
talionándomela	talionar	VGFSE
talionándotela	talionar	VGFSE
talionándosela	talionar	VGFSE
talionándonosla	talionar	VGFSE
talionándoosla	talionar	VGFSE
talionándomelas	talionar	VGFPE
talionándotelas	talionar	VGFPE
talionándoselas	talionar	VGFPE
talionándonoslas	talionar	VGFPE
talionándooslas	talionar	VGFPE
tallar	tallar	O
tallo	tallar	VIP1
tallas	tallar	VIP2
talla	tallar	VIP3
tallamos	tallar	VIP4
talláis	tallar	VIP5
tallan	tallar	VIP6
tallaba	tallar	VII1
tallabas	tallar	VII2
tallábamos	tallar	VII4
tallabais	tallar	VII5
tallaban	tallar	VII6
tallaré	tallar	VIF1
tallarás	tallar	VIF2
tallará	tallar	VIF3
tallaremos	tallar	VIF4
tallaréis	tallar	VIF5
tallarán	tallar	VIF6
tallaría	tallar	VIC1
tallarías	tallar	VIC2
tallaría	tallar	VIC3
tallaríamos	tallar	VIC4
tallaríais	tallar	VIC5
tallarían	tallar	VIC6
tallé	tallar	VIX1
tallaste	tallar	VIX2
talló	tallar	VIX3
tallasteis	tallar	VIX5
tallaron	tallar	VIX6
talle	tallar	VSP1
talles	tallar	VSP2
tallemos	tallar	VSP4
talléis	tallar	VSP5
tallen	tallar	VSP6
tallara	tallar	VSX1
tallaras	tallar	VSX2
talláramos	tallar	VSX4
tallarais	tallar	VSX5
tallaran	tallar	VSX6
tallare	tallar	VSF1
tallares	tallar	VSF2
talláremos	tallar	VSF4
tallareis	tallar	VSF5
tallaren	tallar	VSF6
tallase	tallar	VSI1
tallases	tallar	VSI2
tallásemos	tallar	VSI4
tallaseis	tallar	VSI5
tallasen	tallar	VSI6
tallad	tallar	VMP
talladme	tallar	VMSE
talladle	tallar	VMSE
talladnos	tallar	VMPE
tallaos	tallar	VMPE
talladles	tallar	VMPE
talladlo	tallar	VMMSE
talladla	tallar	VMFSE
talladlos	tallar	VMMPE
talladlas	tallar	VMFPE
talládmelo	tallar	VMMSE
talládselo	tallar	VMMSE
talládnoslo	tallar	VMMSE
talláoslo	tallar	VMMSE
talládmelos	tallar	VMMPE
talládselos	tallar	VMMPE
talládnoslos	tallar	VMMPE
talláoslos	tallar	VMMPE
talládmela	tallar	VMFSE
talládsela	tallar	VMFSE
talládnosla	tallar	VMFSE
talláosla	tallar	VMFSE
talládmelas	tallar	VMFPE
talládselas	tallar	VMFPE
talládnoslas	tallar	VMFPE
talláoslas	tallar	VMFPE
tallado	tallar	VPM
tallados	tallar	VPMP
tallada	tallar	VPF
talladas	tallar	VPFP
tallando	tallar	VG
tallándome	tallar	VGSE
tallándote	tallar	VGSE
tallándole	tallar	VGSE
tallándonos	tallar	VGPE
tallándoos	tallar	VGPE
tallándolo	tallar	VGMSE
tallándola	tallar	VGFSE
tallándolos	tallar	VGMPE
tallándolas	tallar	VGFPE
tallándomelo	tallar	VGMSE
tallándotelo	tallar	VGMSE
tallándoselo	tallar	VGMSE
tallándonoslo	tallar	VGMSE
tallándooslo	tallar	VGMSE
tallándomelos	tallar	VGMPE
tallándotelos	tallar	VGMPE
tallándoselos	tallar	VGMPE
tallándonoslos	tallar	VGMPE
tallándooslos	tallar	VGMPE
tallándomela	tallar	VGFSE
tallándotela	tallar	VGFSE
tallándosela	tallar	VGFSE
tallándonosla	tallar	VGFSE
tallándoosla	tallar	VGFSE
tallándomelas	tallar	VGFPE
tallándotelas	tallar	VGFPE
tallándoselas	tallar	VGFPE
tallándonoslas	tallar	VGFPE
tallándooslas	tallar	VGFPE
tallares	tallar	P
talonear	talonear	O
taloneo	talonear	VIP1
taloneas	talonear	VIP2
talonea	talonear	VIP3
taloneamos	talonear	VIP4
taloneáis	talonear	VIP5
talonean	talonear	VIP6
taloneaba	talonear	VII1
taloneabas	talonear	VII2
taloneábamos	talonear	VII4
taloneabais	talonear	VII5
taloneaban	talonear	VII6
talonearé	talonear	VIF1
talonearás	talonear	VIF2
taloneará	talonear	VIF3
talonearemos	talonear	VIF4
talonearéis	talonear	VIF5
talonearán	talonear	VIF6
talonearía	talonear	VIC1
talonearías	talonear	VIC2
talonearía	talonear	VIC3
talonearíamos	talonear	VIC4
talonearíais	talonear	VIC5
talonearían	talonear	VIC6
taloneé	talonear	VIX1
taloneaste	talonear	VIX2
taloneó	talonear	VIX3
taloneasteis	talonear	VIX5
talonearon	talonear	VIX6
talonee	talonear	VSP1
talonees	talonear	VSP2
taloneemos	talonear	VSP4
taloneéis	talonear	VSP5
taloneen	talonear	VSP6
taloneara	talonear	VSX1
talonearas	talonear	VSX2
taloneáramos	talonear	VSX4
talonearais	talonear	VSX5
talonearan	talonear	VSX6
taloneare	talonear	VSF1
taloneares	talonear	VSF2
taloneáremos	talonear	VSF4
taloneareis	talonear	VSF5
talonearen	talonear	VSF6
talonease	talonear	VSI1
taloneases	talonear	VSI2
taloneásemos	talonear	VSI4
taloneaseis	talonear	VSI5
taloneasen	talonear	VSI6
talonead	talonear	VMP
taloneadme	talonear	VMSE
taloneadle	talonear	VMSE
taloneadnos	talonear	VMPE
taloneaos	talonear	VMPE
taloneadles	talonear	VMPE
taloneadlo	talonear	VMMSE
taloneadla	talonear	VMFSE
taloneadlos	talonear	VMMPE
taloneadlas	talonear	VMFPE
taloneádmelo	talonear	VMMSE
taloneádselo	talonear	VMMSE
taloneádnoslo	talonear	VMMSE
taloneáoslo	talonear	VMMSE
taloneádmelos	talonear	VMMPE
taloneádselos	talonear	VMMPE
taloneádnoslos	talonear	VMMPE
taloneáoslos	talonear	VMMPE
taloneádmela	talonear	VMFSE
taloneádsela	talonear	VMFSE
taloneádnosla	talonear	VMFSE
taloneáosla	talonear	VMFSE
taloneádmelas	talonear	VMFPE
taloneádselas	talonear	VMFPE
taloneádnoslas	talonear	VMFPE
taloneáoslas	talonear	VMFPE
taloneado	talonear	VPM
taloneados	talonear	VPMP
taloneada	talonear	VPF
taloneadas	talonear	VPFP
taloneando	talonear	VG
taloneándome	talonear	VGSE
taloneándote	talonear	VGSE
taloneándole	talonear	VGSE
taloneándonos	talonear	VGPE
taloneándoos	talonear	VGPE
taloneándolo	talonear	VGMSE
taloneándola	talonear	VGFSE
taloneándolos	talonear	VGMPE
taloneándolas	talonear	VGFPE
taloneándomelo	talonear	VGMSE
taloneándotelo	talonear	VGMSE
taloneándoselo	talonear	VGMSE
taloneándonoslo	talonear	VGMSE
taloneándooslo	talonear	VGMSE
taloneándomelos	talonear	VGMPE
taloneándotelos	talonear	VGMPE
taloneándoselos	talonear	VGMPE
taloneándonoslos	talonear	VGMPE
taloneándooslos	talonear	VGMPE
taloneándomela	talonear	VGFSE
taloneándotela	talonear	VGFSE
taloneándosela	talonear	VGFSE
taloneándonosla	talonear	VGFSE
taloneándoosla	talonear	VGFSE
taloneándomelas	talonear	VGFPE
taloneándotelas	talonear	VGFPE
taloneándoselas	talonear	VGFPE
taloneándonoslas	talonear	VGFPE
taloneándooslas	talonear	VGFPE
