ten	ten	O
tenes	ten	P
tena	tena	O
tenas	tena	P
tenace	tenace	O
tenaces	tenace	P
tenacero	tenacero	O
tenaceras	tenacero	FP
tenacera	tenacero	F
tenaceros	tenacero	P
tenacidad	tenacidad	O
tenacidades	tenacidad	P
tenacillas	tenacillas	O
tenada	tenada	O
tenadas	tenada	P
tenallón	tenallón	O
tenallones	tenallón	P
tenamaste	tenamaste	O
tenamastes	tenamaste	P
tenante	tenante	O
tenantes	tenante	P
tenate	tenate	O
tenates	tenate	P
tenaz	tenaz	O
tenaces	tenaz	P
tenaza	tenaza	O
tenazas	tenaza	P
tenazada	tenazada	O
tenazadas	tenazada	P
tenazazo	tenazazo	O
tenazazos	tenazazo	P
tenazuelas	tenazuelas	O
tenazón	tenazón	O
tenazones	tenazón	P
tenca	tenca	O
tencas	tenca	P
tención	tención	O
tenciones	tención	P
tendajo	tendajo	O
tendajos	tendajo	P
tendal	tendal	O
tendales	tendal	P
tendalada	tendalada	O
tendaladas	tendalada	P
tendalera	tendalera	O
tendaleras	tendalera	P
tendalero	tendalero	O
tendaleros	tendalero	P
tendedera	tendedera	O
tendederas	tendedera	P
tendedero	tendedero	O
tendederos	tendedero	P
tendedor	tendedor	O
tendedoras	tendedor	FP
tendedora	tendedor	F
tendedores	tendedor	P
tendedura	tendedura	O
tendeduras	tendedura	P
tendejón	tendejón	O
tendejones	tendejón	P
tendel	tendel	O
tendeles	tendel	P
tendencia	tendencia	O
tendencias	tendencia	P
tendencial	tendencial	O
tendenciales	tendencial	P
tendenciosidad	tendenciosidad	O
tendenciosidades	tendenciosidad	P
tendencioso	tendencioso	O
tendenciosas	tendencioso	FP
tendenciosa	tendencioso	F
tendenciosos	tendencioso	P
tendente	tendente	O
tendentes	tendente	P
tenderete	tenderete	O
tenderetes	tenderete	P
tendero	tendero	O
tenderas	tendero	FP
tendera	tendero	F
tenderos	tendero	P
tendidamente	tendidamente	O
tendido	tendido	O
tendidas	tendido	FP
tendida	tendido	F
tendidos	tendido	P
tendiente	tendiente	O
tendientes	tendiente	P
tendinitis	tendinitis	O
tendinoso	tendinoso	O
tendinosas	tendinoso	FP
tendinosa	tendinoso	F
tendinosos	tendinoso	P
tendón	tendón	O
tendones	tendón	P
tenebrario	tenebrario	O
tenebrarios	tenebrario	P
tenebregoso	tenebregoso	O
tenebregosas	tenebregoso	FP
tenebregosa	tenebregoso	F
tenebregosos	tenebregoso	P
tenebregura	tenebregura	O
tenebreguras	tenebregura	P
tenebrismo	tenebrismo	O
tenebrismos	tenebrismo	P
tenebrista	tenebrista	O
tenebristas	tenebrista	P
tenebrosamente	tenebrosamente	O
tenebrosidad	tenebrosidad	O
tenebrosidades	tenebrosidad	P
tenebroso	tenebroso	O
tenebrosas	tenebroso	FP
tenebrosa	tenebroso	F
tenebrosos	tenebroso	P
tenedero	tenedero	O
tenederos	tenedero	P
tenedor	tenedor	O
tenedoras	tenedor	FP
tenedora	tenedor	F
tenedores	tenedor	P
tenedorcillo	tenedorcillo	O
tenedorcillos	tenedorcillo	P
teneduría	teneduría	O
tenedurías	teneduría	P
tenencia	tenencia	O
tenencias	tenencia	P
teneres	teneres	O
tenería	tenería	O
tenerías	tenería	P
tenesmo	tenesmo	O
tenesmos	tenesmo	P
tengue	tengue	O
tengues	tengue	P
tenguerengue	tenguerengue	O
tenguerengues	tenguerengue	P
tenia	tenia	O
tenias	tenia	P
teniasis	teniasis	O
tenida	tenida	O
tenidas	tenida	P
tenienta	tenienta	O
tenientas	tenienta	P
tenientazgo	tenientazgo	O
tenientazgos	tenientazgo	P
teniente	teniente	O
tenientes	teniente	P
tenique	tenique	O
teniques	tenique	P
tenis	tenis	O
tenista	tenista	O
tenistas	tenista	P
tenor	tenor	O
tenores	tenor	P
tenora	tenora	O
tenoras	tenora	P
tenorino	tenorino	O
tenorinos	tenorino	P
tenorio	tenorio	O
tenorios	tenorio	P
tensino	tensino	O
tensinas	tensino	FP
tensina	tensino	F
tensinos	tensino	P
tensiómetro	tensiómetro	O
tensiómetros	tensiómetro	P
tensión	tensión	O
tensiones	tensión	P
tenso	tenso	O
tensas	tenso	FP
tensa	tenso	F
tensos	tenso	P
tensor	tensor	O
tensoras	tensor	FP
tensora	tensor	F
tensores	tensor	P
tensorial	tensorial	O
tensoriales	tensorial	P
tensón	tensón	O
tensones	tensón	P
tentabuey	tentabuey	O
tentabueyes	tentabuey	P
tentación	tentación	O
tentaciones	tentación	P
tentacular	tentacular	O
tentaculares	tentacular	P
tentadero	tentadero	O
tentaderos	tentadero	P
tentado	tentado	O
tentados	tentado	P
tentador	tentador	O
tentadoras	tentador	FP
tentadora	tentador	F
tentadores	tentador	P
tentadura	tentadura	O
tentaduras	tentadura	P
tentaruja	tentaruja	O
tentarujas	tentaruja	P
tentativo	tentativo	O
tentativas	tentativo	FP
tentativa	tentativo	F
tentativos	tentativo	P
tentemozo	tentemozo	O
tentemozos	tentemozo	P
tentempié	tentempié	O
tentempiés	tentempié	P
tentenelaire	tentenelaire	O
tentenelaires	tentenelaire	P
tentetieso	tentetieso	O
tentetiesos	tentetieso	P
tentáculo	tentáculo	O
tentáculos	tentáculo	P
tentón	tentón	O
tentones	tentón	P
tenue	tenue	O
tenues	tenue	P
tenuidad	tenuidad	O
tenuidades	tenuidad	P
tenuirrostro	tenuirrostro	O
tenuirrostros	tenuirrostro	P
tenuta	tenuta	O
tenutas	tenuta	P
tenutario	tenutario	O
tenutarias	tenutario	FP
tenutaria	tenutario	F
tenutarios	tenutario	P
tenzón	tenzón	O
tenzones	tenzón	P
tenáculo	tenáculo	O
tenáculos	tenáculo	P
tenífugo	tenífugo	O
tenífugas	tenífugo	FP
tenífuga	tenífugo	F
tenífugos	tenífugo	P
tenístico	tenístico	O
tenísticas	tenístico	FP
tenística	tenístico	F
tenísticos	tenístico	P
teña	teña	O
teñas	teña	P
teñible	teñible	O
teñibles	teñible	P
teñido	teñido	O
teñidos	teñido	P
teñidura	teñidura	O
teñiduras	teñidura	P
ténder	ténder	O
ténderes	ténder	P
teñir	teñir	O
teñimos	teñir	VIP4
teñís	teñir	VIP5
teñía	teñir	VII1
teñías	teñir	VII2
teñíamos	teñir	VII4
teñíais	teñir	VII5
teñían	teñir	VII6
teñiré	teñir	VIF1
teñirás	teñir	VIF2
teñirá	teñir	VIF3
teñiremos	teñir	VIF4
teñiréis	teñir	VIF5
teñirán	teñir	VIF6
teñiría	teñir	VIC1
teñirías	teñir	VIC2
teñiría	teñir	VIC3
teñiríamos	teñir	VIC4
teñiríais	teñir	VIC5
teñirían	teñir	VIC6
teñí	teñir	VIX1
teñiste	teñir	VIX2
teñisteis	teñir	VIX5
teñid	teñir	VMP
teñidme	teñir	VMSE
teñidle	teñir	VMSE
teñidnos	teñir	VMPE
teñios	teñir	VMPE
teñidles	teñir	VMPE
teñidlo	teñir	VMMSE
teñidla	teñir	VMFSE
teñidlos	teñir	VMMPE
teñidlas	teñir	VMFPE
teñídmelo	teñir	VMMSE
teñídselo	teñir	VMMSE
teñídnoslo	teñir	VMMSE
teñíoslo	teñir	VMMSE
teñídmelos	teñir	VMMPE
teñídselos	teñir	VMMPE
teñídnoslos	teñir	VMMPE
teñíoslos	teñir	VMMPE
teñídmela	teñir	VMFSE
teñídsela	teñir	VMFSE
teñídnosla	teñir	VMFSE
teñíosla	teñir	VMFSE
teñídmelas	teñir	VMFPE
teñídselas	teñir	VMFPE
teñídnoslas	teñir	VMFPE
teñíoslas	teñir	VMFPE
teñido	teñir	VPM
teñidos	teñir	VPMP
teñida	teñir	VPF
teñidas	teñir	VPFP
tender	tender	O
tendemos	tender	VIP4
tendéis	tender	VIP5
tendía	tender	VII1
tendías	tender	VII2
tendíamos	tender	VII4
tendíais	tender	VII5
tendían	tender	VII6
tenderé	tender	VIF1
tenderás	tender	VIF2
tenderá	tender	VIF3
tenderemos	tender	VIF4
tenderéis	tender	VIF5
tenderán	tender	VIF6
tendería	tender	VIC1
tenderías	tender	VIC2
tendería	tender	VIC3
tenderíamos	tender	VIC4
tenderíais	tender	VIC5
tenderían	tender	VIC6
tendí	tender	VIX1
tendiste	tender	VIX2
tendió	tender	VIX3
tendisteis	tender	VIX5
tendieron	tender	VIX6
tendamos	tender	VSP4
tendáis	tender	VSP5
tendiera	tender	VSX1
tendieras	tender	VSX2
tendiéramos	tender	VSX4
tendierais	tender	VSX5
tendieran	tender	VSX6
tendiere	tender	VSF1
tendieres	tender	VSF2
tendiéremos	tender	VSF4
tendiereis	tender	VSF5
tendieren	tender	VSF6
tendiese	tender	VSI1
tendieses	tender	VSI2
tendiésemos	tender	VSI4
tendieseis	tender	VSI5
tendiesen	tender	VSI6
tended	tender	VMP
tendedme	tender	VMSE
tendedle	tender	VMSE
tendednos	tender	VMPE
tendeos	tender	VMPE
tendedles	tender	VMPE
tendedlo	tender	VMMSE
tendedla	tender	VMFSE
tendedlos	tender	VMMPE
tendedlas	tender	VMFPE
tendédmelo	tender	VMMSE
tendédselo	tender	VMMSE
tendédnoslo	tender	VMMSE
tendéoslo	tender	VMMSE
tendédmelos	tender	VMMPE
tendédselos	tender	VMMPE
tendédnoslos	tender	VMMPE
tendéoslos	tender	VMMPE
tendédmela	tender	VMFSE
tendédsela	tender	VMFSE
tendédnosla	tender	VMFSE
tendéosla	tender	VMFSE
tendédmelas	tender	VMFPE
tendédselas	tender	VMFPE
tendédnoslas	tender	VMFPE
tendéoslas	tender	VMFPE
tendido	tender	VPM
tendidos	tender	VPMP
tendida	tender	VPF
tendidas	tender	VPFP
tendiendo	tender	VG
tendiéndome	tender	VGSE
tendiéndote	tender	VGSE
tendiéndole	tender	VGSE
tendiéndonos	tender	VGPE
tendiéndoos	tender	VGPE
tendiéndolo	tender	VGMSE
tendiéndola	tender	VGFSE
tendiéndolos	tender	VGMPE
tendiéndolas	tender	VGFPE
tendiéndomelo	tender	VGMSE
tendiéndotelo	tender	VGMSE
tendiéndoselo	tender	VGMSE
tendiéndonoslo	tender	VGMSE
tendiéndooslo	tender	VGMSE
tendiéndomelos	tender	VGMPE
tendiéndotelos	tender	VGMPE
tendiéndoselos	tender	VGMPE
tendiéndonoslos	tender	VGMPE
tendiéndooslos	tender	VGMPE
tendiéndomela	tender	VGFSE
tendiéndotela	tender	VGFSE
tendiéndosela	tender	VGFSE
tendiéndonosla	tender	VGFSE
tendiéndoosla	tender	VGFSE
tendiéndomelas	tender	VGFPE
tendiéndotelas	tender	VGFPE
tendiéndoselas	tender	VGFPE
tendiéndonoslas	tender	VGFPE
tendiéndooslas	tender	VGFPE
tener	tener	O
tenes	tener	VIP2
tene	tener	VIP3
tenemos	tener	VIP4
tenéis	tener	VIP5
tenen	tener	VIP6
tenía	tener	VII1
tenías	tener	VII2
teníamos	tener	VII4
teníais	tener	VII5
tenían	tener	VII6
teneré	tener	VIF1
tenerás	tener	VIF2
tenerá	tener	VIF3
teneremos	tener	VIF4
teneréis	tener	VIF5
tenerán	tener	VIF6
tenería	tener	VIC1
tenerías	tener	VIC2
tenería	tener	VIC3
teneríamos	tener	VIC4
teneríais	tener	VIC5
tenerían	tener	VIC6
tened	tener	VMP
tenedme	tener	VMSE
tenedle	tener	VMSE
tenednos	tener	VMPE
teneos	tener	VMPE
tenedles	tener	VMPE
tenedlo	tener	VMMSE
tenedla	tener	VMFSE
tenedlos	tener	VMMPE
tenedlas	tener	VMFPE
tenédmelo	tener	VMMSE
tenédselo	tener	VMMSE
tenédnoslo	tener	VMMSE
tenéoslo	tener	VMMSE
tenédmelos	tener	VMMPE
tenédselos	tener	VMMPE
tenédnoslos	tener	VMMPE
tenéoslos	tener	VMMPE
tenédmela	tener	VMFSE
tenédsela	tener	VMFSE
tenédnosla	tener	VMFSE
tenéosla	tener	VMFSE
tenédmelas	tener	VMFPE
tenédselas	tener	VMFPE
tenédnoslas	tener	VMFPE
tenéoslas	tener	VMFPE
tenido	tener	VPM
tenidos	tener	VPMP
tenida	tener	VPF
tenidas	tener	VPFP
teniendo	tener	VG
teniéndome	tener	VGSE
teniéndote	tener	VGSE
teniéndole	tener	VGSE
teniéndonos	tener	VGPE
teniéndoos	tener	VGPE
teniéndolo	tener	VGMSE
teniéndola	tener	VGFSE
teniéndolos	tener	VGMPE
teniéndolas	tener	VGFPE
teniéndomelo	tener	VGMSE
teniéndotelo	tener	VGMSE
teniéndoselo	tener	VGMSE
teniéndonoslo	tener	VGMSE
teniéndooslo	tener	VGMSE
teniéndomelos	tener	VGMPE
teniéndotelos	tener	VGMPE
teniéndoselos	tener	VGMPE
teniéndonoslos	tener	VGMPE
teniéndooslos	tener	VGMPE
teniéndomela	tener	VGFSE
teniéndotela	tener	VGFSE
teniéndosela	tener	VGFSE
teniéndonosla	tener	VGFSE
teniéndoosla	tener	VGFSE
teniéndomelas	tener	VGFPE
teniéndotelas	tener	VGFPE
teniéndoselas	tener	VGFPE
teniéndonoslas	tener	VGFPE
teniéndooslas	tener	VGFPE
tenacear	tenacear	O
tenaceo	tenacear	VIP1
tenaceas	tenacear	VIP2
tenacea	tenacear	VIP3
tenaceamos	tenacear	VIP4
tenaceáis	tenacear	VIP5
tenacean	tenacear	VIP6
tenaceaba	tenacear	VII1
tenaceabas	tenacear	VII2
tenaceábamos	tenacear	VII4
tenaceabais	tenacear	VII5
tenaceaban	tenacear	VII6
tenacearé	tenacear	VIF1
tenacearás	tenacear	VIF2
tenaceará	tenacear	VIF3
tenacearemos	tenacear	VIF4
tenacearéis	tenacear	VIF5
tenacearán	tenacear	VIF6
tenacearía	tenacear	VIC1
tenacearías	tenacear	VIC2
tenacearía	tenacear	VIC3
tenacearíamos	tenacear	VIC4
tenacearíais	tenacear	VIC5
tenacearían	tenacear	VIC6
tenaceé	tenacear	VIX1
tenaceaste	tenacear	VIX2
tenaceó	tenacear	VIX3
tenaceasteis	tenacear	VIX5
tenacearon	tenacear	VIX6
tenacee	tenacear	VSP1
tenacees	tenacear	VSP2
tenaceemos	tenacear	VSP4
tenaceéis	tenacear	VSP5
tenaceen	tenacear	VSP6
tenaceara	tenacear	VSX1
tenacearas	tenacear	VSX2
tenaceáramos	tenacear	VSX4
tenacearais	tenacear	VSX5
tenacearan	tenacear	VSX6
tenaceare	tenacear	VSF1
tenaceares	tenacear	VSF2
tenaceáremos	tenacear	VSF4
tenaceareis	tenacear	VSF5
tenacearen	tenacear	VSF6
tenacease	tenacear	VSI1
tenaceases	tenacear	VSI2
tenaceásemos	tenacear	VSI4
tenaceaseis	tenacear	VSI5
tenaceasen	tenacear	VSI6
tenacead	tenacear	VMP
tenaceadme	tenacear	VMSE
tenaceadle	tenacear	VMSE
tenaceadnos	tenacear	VMPE
tenaceaos	tenacear	VMPE
tenaceadles	tenacear	VMPE
tenaceadlo	tenacear	VMMSE
tenaceadla	tenacear	VMFSE
tenaceadlos	tenacear	VMMPE
tenaceadlas	tenacear	VMFPE
tenaceádmelo	tenacear	VMMSE
tenaceádselo	tenacear	VMMSE
tenaceádnoslo	tenacear	VMMSE
tenaceáoslo	tenacear	VMMSE
tenaceádmelos	tenacear	VMMPE
tenaceádselos	tenacear	VMMPE
tenaceádnoslos	tenacear	VMMPE
tenaceáoslos	tenacear	VMMPE
tenaceádmela	tenacear	VMFSE
tenaceádsela	tenacear	VMFSE
tenaceádnosla	tenacear	VMFSE
tenaceáosla	tenacear	VMFSE
tenaceádmelas	tenacear	VMFPE
tenaceádselas	tenacear	VMFPE
tenaceádnoslas	tenacear	VMFPE
tenaceáoslas	tenacear	VMFPE
tenaceado	tenacear	VPM
tenaceados	tenacear	VPMP
tenaceada	tenacear	VPF
tenaceadas	tenacear	VPFP
tenaceando	tenacear	VG
tenaceándome	tenacear	VGSE
tenaceándote	tenacear	VGSE
tenaceándole	tenacear	VGSE
tenaceándonos	tenacear	VGPE
tenaceándoos	tenacear	VGPE
tenaceándolo	tenacear	VGMSE
tenaceándola	tenacear	VGFSE
tenaceándolos	tenacear	VGMPE
tenaceándolas	tenacear	VGFPE
tenaceándomelo	tenacear	VGMSE
tenaceándotelo	tenacear	VGMSE
tenaceándoselo	tenacear	VGMSE
tenaceándonoslo	tenacear	VGMSE
tenaceándooslo	tenacear	VGMSE
tenaceándomelos	tenacear	VGMPE
tenaceándotelos	tenacear	VGMPE
tenaceándoselos	tenacear	VGMPE
tenaceándonoslos	tenacear	VGMPE
tenaceándooslos	tenacear	VGMPE
tenaceándomela	tenacear	VGFSE
tenaceándotela	tenacear	VGFSE
tenaceándosela	tenacear	VGFSE
tenaceándonosla	tenacear	VGFSE
tenaceándoosla	tenacear	VGFSE
tenaceándomelas	tenacear	VGFPE
tenaceándotelas	tenacear	VGFPE
tenaceándoselas	tenacear	VGFPE
tenaceándonoslas	tenacear	VGFPE
tenaceándooslas	tenacear	VGFPE
tensar	tensar	O
tenso	tensar	VIP1
tensas	tensar	VIP2
tensa	tensar	VIP3
tensamos	tensar	VIP4
tensáis	tensar	VIP5
tensan	tensar	VIP6
tensaba	tensar	VII1
tensabas	tensar	VII2
tensábamos	tensar	VII4
tensabais	tensar	VII5
tensaban	tensar	VII6
tensaré	tensar	VIF1
tensarás	tensar	VIF2
tensará	tensar	VIF3
tensaremos	tensar	VIF4
tensaréis	tensar	VIF5
tensarán	tensar	VIF6
tensaría	tensar	VIC1
tensarías	tensar	VIC2
tensaría	tensar	VIC3
tensaríamos	tensar	VIC4
tensaríais	tensar	VIC5
tensarían	tensar	VIC6
tensé	tensar	VIX1
tensaste	tensar	VIX2
tensó	tensar	VIX3
tensasteis	tensar	VIX5
tensaron	tensar	VIX6
tense	tensar	VSP1
tenses	tensar	VSP2
tensemos	tensar	VSP4
tenséis	tensar	VSP5
tensen	tensar	VSP6
tensara	tensar	VSX1
tensaras	tensar	VSX2
tensáramos	tensar	VSX4
tensarais	tensar	VSX5
tensaran	tensar	VSX6
tensare	tensar	VSF1
tensares	tensar	VSF2
tensáremos	tensar	VSF4
tensareis	tensar	VSF5
tensaren	tensar	VSF6
tensase	tensar	VSI1
tensases	tensar	VSI2
tensásemos	tensar	VSI4
tensaseis	tensar	VSI5
tensasen	tensar	VSI6
tensad	tensar	VMP
tensadme	tensar	VMSE
tensadle	tensar	VMSE
tensadnos	tensar	VMPE
tensaos	tensar	VMPE
tensadles	tensar	VMPE
tensadlo	tensar	VMMSE
tensadla	tensar	VMFSE
tensadlos	tensar	VMMPE
tensadlas	tensar	VMFPE
tensádmelo	tensar	VMMSE
tensádselo	tensar	VMMSE
tensádnoslo	tensar	VMMSE
tensáoslo	tensar	VMMSE
tensádmelos	tensar	VMMPE
tensádselos	tensar	VMMPE
tensádnoslos	tensar	VMMPE
tensáoslos	tensar	VMMPE
tensádmela	tensar	VMFSE
tensádsela	tensar	VMFSE
tensádnosla	tensar	VMFSE
tensáosla	tensar	VMFSE
tensádmelas	tensar	VMFPE
tensádselas	tensar	VMFPE
tensádnoslas	tensar	VMFPE
tensáoslas	tensar	VMFPE
tensado	tensar	VPM
tensados	tensar	VPMP
tensada	tensar	VPF
tensadas	tensar	VPFP
tensando	tensar	VG
tensándome	tensar	VGSE
tensándote	tensar	VGSE
tensándole	tensar	VGSE
tensándonos	tensar	VGPE
tensándoos	tensar	VGPE
tensándolo	tensar	VGMSE
tensándola	tensar	VGFSE
tensándolos	tensar	VGMPE
tensándolas	tensar	VGFPE
tensándomelo	tensar	VGMSE
tensándotelo	tensar	VGMSE
tensándoselo	tensar	VGMSE
tensándonoslo	tensar	VGMSE
tensándooslo	tensar	VGMSE
tensándomelos	tensar	VGMPE
tensándotelos	tensar	VGMPE
tensándoselos	tensar	VGMPE
tensándonoslos	tensar	VGMPE
tensándooslos	tensar	VGMPE
tensándomela	tensar	VGFSE
tensándotela	tensar	VGFSE
tensándosela	tensar	VGFSE
tensándonosla	tensar	VGFSE
tensándoosla	tensar	VGFSE
tensándomelas	tensar	VGFPE
tensándotelas	tensar	VGFPE
tensándoselas	tensar	VGFPE
tensándonoslas	tensar	VGFPE
tensándooslas	tensar	VGFPE
tentalear	tentalear	O
tentaleo	tentalear	VIP1
tentaleas	tentalear	VIP2
tentalea	tentalear	VIP3
tentaleamos	tentalear	VIP4
tentaleáis	tentalear	VIP5
tentalean	tentalear	VIP6
tentaleaba	tentalear	VII1
tentaleabas	tentalear	VII2
tentaleábamos	tentalear	VII4
tentaleabais	tentalear	VII5
tentaleaban	tentalear	VII6
tentalearé	tentalear	VIF1
tentalearás	tentalear	VIF2
tentaleará	tentalear	VIF3
tentalearemos	tentalear	VIF4
tentalearéis	tentalear	VIF5
tentalearán	tentalear	VIF6
tentalearía	tentalear	VIC1
tentalearías	tentalear	VIC2
tentalearía	tentalear	VIC3
tentalearíamos	tentalear	VIC4
tentalearíais	tentalear	VIC5
tentalearían	tentalear	VIC6
tentaleé	tentalear	VIX1
tentaleaste	tentalear	VIX2
tentaleó	tentalear	VIX3
tentaleasteis	tentalear	VIX5
tentalearon	tentalear	VIX6
tentalee	tentalear	VSP1
tentalees	tentalear	VSP2
tentaleemos	tentalear	VSP4
tentaleéis	tentalear	VSP5
tentaleen	tentalear	VSP6
tentaleara	tentalear	VSX1
tentalearas	tentalear	VSX2
tentaleáramos	tentalear	VSX4
tentalearais	tentalear	VSX5
tentalearan	tentalear	VSX6
tentaleare	tentalear	VSF1
tentaleares	tentalear	VSF2
tentaleáremos	tentalear	VSF4
tentaleareis	tentalear	VSF5
tentalearen	tentalear	VSF6
tentalease	tentalear	VSI1
tentaleases	tentalear	VSI2
tentaleásemos	tentalear	VSI4
tentaleaseis	tentalear	VSI5
tentaleasen	tentalear	VSI6
tentalead	tentalear	VMP
tentaleadme	tentalear	VMSE
tentaleadle	tentalear	VMSE
tentaleadnos	tentalear	VMPE
tentaleaos	tentalear	VMPE
tentaleadles	tentalear	VMPE
tentaleadlo	tentalear	VMMSE
tentaleadla	tentalear	VMFSE
tentaleadlos	tentalear	VMMPE
tentaleadlas	tentalear	VMFPE
tentaleádmelo	tentalear	VMMSE
tentaleádselo	tentalear	VMMSE
tentaleádnoslo	tentalear	VMMSE
tentaleáoslo	tentalear	VMMSE
tentaleádmelos	tentalear	VMMPE
tentaleádselos	tentalear	VMMPE
tentaleádnoslos	tentalear	VMMPE
tentaleáoslos	tentalear	VMMPE
tentaleádmela	tentalear	VMFSE
tentaleádsela	tentalear	VMFSE
tentaleádnosla	tentalear	VMFSE
tentaleáosla	tentalear	VMFSE
tentaleádmelas	tentalear	VMFPE
tentaleádselas	tentalear	VMFPE
tentaleádnoslas	tentalear	VMFPE
tentaleáoslas	tentalear	VMFPE
tentaleado	tentalear	VPM
tentaleados	tentalear	VPMP
tentaleada	tentalear	VPF
tentaleadas	tentalear	VPFP
tentaleando	tentalear	VG
tentaleándome	tentalear	VGSE
tentaleándote	tentalear	VGSE
tentaleándole	tentalear	VGSE
tentaleándonos	tentalear	VGPE
tentaleándoos	tentalear	VGPE
tentaleándolo	tentalear	VGMSE
tentaleándola	tentalear	VGFSE
tentaleándolos	tentalear	VGMPE
tentaleándolas	tentalear	VGFPE
tentaleándomelo	tentalear	VGMSE
tentaleándotelo	tentalear	VGMSE
tentaleándoselo	tentalear	VGMSE
tentaleándonoslo	tentalear	VGMSE
tentaleándooslo	tentalear	VGMSE
tentaleándomelos	tentalear	VGMPE
tentaleándotelos	tentalear	VGMPE
tentaleándoselos	tentalear	VGMPE
tentaleándonoslos	tentalear	VGMPE
tentaleándooslos	tentalear	VGMPE
tentaleándomela	tentalear	VGFSE
tentaleándotela	tentalear	VGFSE
tentaleándosela	tentalear	VGFSE
tentaleándonosla	tentalear	VGFSE
tentaleándoosla	tentalear	VGFSE
tentaleándomelas	tentalear	VGFPE
tentaleándotelas	tentalear	VGFPE
tentaleándoselas	tentalear	VGFPE
tentaleándonoslas	tentalear	VGFPE
tentaleándooslas	tentalear	VGFPE
tentaleares	tentalear	P
tentar	tentar	O
tentamos	tentar	VIP4
tentáis	tentar	VIP5
tentaba	tentar	VII1
tentabas	tentar	VII2
tentábamos	tentar	VII4
tentabais	tentar	VII5
tentaban	tentar	VII6
tentaré	tentar	VIF1
tentarás	tentar	VIF2
tentará	tentar	VIF3
tentaremos	tentar	VIF4
tentaréis	tentar	VIF5
tentarán	tentar	VIF6
tentaría	tentar	VIC1
tentarías	tentar	VIC2
tentaría	tentar	VIC3
tentaríamos	tentar	VIC4
tentaríais	tentar	VIC5
tentarían	tentar	VIC6
tenté	tentar	VIX1
tentaste	tentar	VIX2
tentó	tentar	VIX3
tentasteis	tentar	VIX5
tentaron	tentar	VIX6
tentemos	tentar	VSP4
tentéis	tentar	VSP5
tentara	tentar	VSX1
tentaras	tentar	VSX2
tentáramos	tentar	VSX4
tentarais	tentar	VSX5
tentaran	tentar	VSX6
tentare	tentar	VSF1
tentares	tentar	VSF2
tentáremos	tentar	VSF4
tentareis	tentar	VSF5
tentaren	tentar	VSF6
tentase	tentar	VSI1
tentases	tentar	VSI2
tentásemos	tentar	VSI4
tentaseis	tentar	VSI5
tentasen	tentar	VSI6
tentad	tentar	VMP
tentadme	tentar	VMSE
tentadle	tentar	VMSE
tentadnos	tentar	VMPE
tentaos	tentar	VMPE
tentadles	tentar	VMPE
tentadlo	tentar	VMMSE
tentadla	tentar	VMFSE
tentadlos	tentar	VMMPE
tentadlas	tentar	VMFPE
tentádmelo	tentar	VMMSE
tentádselo	tentar	VMMSE
tentádnoslo	tentar	VMMSE
tentáoslo	tentar	VMMSE
tentádmelos	tentar	VMMPE
tentádselos	tentar	VMMPE
tentádnoslos	tentar	VMMPE
tentáoslos	tentar	VMMPE
tentádmela	tentar	VMFSE
tentádsela	tentar	VMFSE
tentádnosla	tentar	VMFSE
tentáosla	tentar	VMFSE
tentádmelas	tentar	VMFPE
tentádselas	tentar	VMFPE
tentádnoslas	tentar	VMFPE
tentáoslas	tentar	VMFPE
tentado	tentar	VPM
tentados	tentar	VPMP
tentada	tentar	VPF
tentadas	tentar	VPFP
tentando	tentar	VG
tentándome	tentar	VGSE
tentándote	tentar	VGSE
tentándole	tentar	VGSE
tentándonos	tentar	VGPE
tentándoos	tentar	VGPE
tentándolo	tentar	VGMSE
tentándola	tentar	VGFSE
tentándolos	tentar	VGMPE
tentándolas	tentar	VGFPE
tentándomelo	tentar	VGMSE
tentándotelo	tentar	VGMSE
tentándoselo	tentar	VGMSE
tentándonoslo	tentar	VGMSE
tentándooslo	tentar	VGMSE
tentándomelos	tentar	VGMPE
tentándotelos	tentar	VGMPE
tentándoselos	tentar	VGMPE
tentándonoslos	tentar	VGMPE
tentándooslos	tentar	VGMPE
tentándomela	tentar	VGFSE
tentándotela	tentar	VGFSE
tentándosela	tentar	VGFSE
tentándonosla	tentar	VGFSE
tentándoosla	tentar	VGFSE
tentándomelas	tentar	VGFPE
tentándotelas	tentar	VGFPE
tentándoselas	tentar	VGFPE
tentándonoslas	tentar	VGFPE
tentándooslas	tentar	VGFPE
