tina	tina	O
tinas	tina	P
tinaco	tinaco	O
tinacos	tinaco	P
tinada	tinada	O
tinadas	tinada	P
tinado	tinado	O
tinados	tinado	P
tinador	tinador	O
tinadores	tinador	P
tinaja	tinaja	O
tinajas	tinaja	P
tinajero	tinajero	O
tinajeras	tinajero	FP
tinajera	tinajero	F
tinajeros	tinajero	P
tinajería	tinajería	O
tinajerías	tinajería	P
tinajón	tinajón	O
tinajones	tinajón	P
tinamaste	tinamaste	O
tinamastes	tinamaste	P
tinapá	tinapá	O
tinapás	tinapá	P
tinca	tinca	O
tincas	tinca	P
tincazo	tincazo	O
tincazos	tincazo	P
tinción	tinción	O
tinciones	tinción	P
tindalización	tindalización	O
tindalizaciones	tindalización	P
tindalo	tindalo	O
tindalos	tindalo	P
tindío	tindío	O
tindíos	tindío	P
tinelar	tinelar	O
tinelares	tinelar	P
tinelero	tinelero	O
tineleras	tinelero	FP
tinelera	tinelero	F
tineleros	tinelero	P
tinelo	tinelo	O
tinelos	tinelo	P
tinerfeño	tinerfeño	O
tinerfeñas	tinerfeño	FP
tinerfeña	tinerfeño	F
tinerfeños	tinerfeño	P
tinge	tinge	O
tinges	tinge	P
tingible	tingible	O
tingibles	tingible	P
tingitano	tingitano	O
tingitanas	tingitano	FP
tingitana	tingitano	F
tingitanos	tingitano	P
tingladillo	tingladillo	O
tingladillos	tingladillo	P
tinglado	tinglado	O
tinglados	tinglado	P
tingle	tingle	O
tingles	tingle	P
tinicla	tinicla	O
tiniclas	tinicla	P
tiniebla	tiniebla	O
tinieblas	tiniebla	P
tinillo	tinillo	O
tinillos	tinillo	P
tino	tino	O
tinos	tino	P
tinola	tinola	O
tinolas	tinola	P
tinta	tinta	O
tintas	tinta	P
tinte	tinte	O
tintes	tinte	P
tinterazo	tinterazo	O
tinterazos	tinterazo	P
tinterillada	tinterillada	O
tinterilladas	tinterillada	P
tinterillo	tinterillo	O
tinterillos	tinterillo	P
tintero	tintero	O
tinteros	tintero	P
tintilla	tintilla	O
tintillas	tintilla	P
tintillo	tintillo	O
tintillos	tintillo	P
tintineante	tintineante	O
tintineantes	tintineante	P
tintineo	tintineo	O
tintineos	tintineo	P
tintirintín	tintirintín	O
tintirintines	tintirintín	P
tinto	tinto	O
tintas	tinto	FP
tinta	tinto	F
tintos	tinto	P
tintor	tintor	O
tintores	tintor	P
tintorera	tintorera	O
tintoreras	tintorera	P
tintorero	tintorero	O
tintoreras	tintorero	FP
tintorera	tintorero	F
tintoreros	tintorero	P
tintorería	tintorería	O
tintorerías	tintorería	P
tintorro	tintorro	O
tintorros	tintorro	P
tintura	tintura	O
tinturas	tintura	P
tintín	tintín	O
tintines	tintín	P
tintóreo	tintóreo	O
tintóreas	tintóreo	FP
tintórea	tintóreo	F
tintóreos	tintóreo	P
tiña	tiña	O
tiñas	tiña	P
tiñería	tiñería	O
tiñerías	tiñería	P
tiñoso	tiñoso	O
tiñosas	tiñoso	FP
tiñosa	tiñoso	F
tiñosos	tiñoso	P
tiñuela	tiñuela	O
tiñuelas	tiñuela	P
tínea	tínea	O
tíneas	tínea	P
tiño	teñir	VIP1
tiñes	teñir	VIP2
tiñe	teñir	VIP3
tiñen	teñir	VIP6
tiñió	teñir	VIX3
tiñieron	teñir	VIX6
tiña	teñir	VSP1
tiñas	teñir	VSP2
tiñamos	teñir	VSP4
tiñáis	teñir	VSP5
tiñan	teñir	VSP6
tiñiera	teñir	VSX1
tiñieras	teñir	VSX2
tiñiéramos	teñir	VSX4
tiñierais	teñir	VSX5
tiñieran	teñir	VSX6
tiñiere	teñir	VSF1
tiñieres	teñir	VSF2
tiñiéremos	teñir	VSF4
tiñiereis	teñir	VSF5
tiñieren	teñir	VSF6
tiñiese	teñir	VSI1
tiñieses	teñir	VSI2
tiñiésemos	teñir	VSI4
tiñieseis	teñir	VSI5
tiñiesen	teñir	VSI6
tiñiendo	teñir	VG
tiñiéndome	teñir	VGSE
tiñiéndote	teñir	VGSE
tiñiéndole	teñir	VGSE
tiñiéndonos	teñir	VGPE
tiñiéndoos	teñir	VGPE
tiñiéndolo	teñir	VGMSE
tiñiéndola	teñir	VGFSE
tiñiéndolos	teñir	VGMPE
tiñiéndolas	teñir	VGFPE
tiñiéndomelo	teñir	VGMSE
tiñiéndotelo	teñir	VGMSE
tiñiéndoselo	teñir	VGMSE
tiñiéndonoslo	teñir	VGMSE
tiñiéndooslo	teñir	VGMSE
tiñiéndomelos	teñir	VGMPE
tiñiéndotelos	teñir	VGMPE
tiñiéndoselos	teñir	VGMPE
tiñiéndonoslos	teñir	VGMPE
tiñiéndooslos	teñir	VGMPE
tiñiéndomela	teñir	VGFSE
tiñiéndotela	teñir	VGFSE
tiñiéndosela	teñir	VGFSE
tiñiéndonosla	teñir	VGFSE
tiñiéndoosla	teñir	VGFSE
tiñiéndomelas	teñir	VGFPE
tiñiéndotelas	teñir	VGFPE
tiñiéndoselas	teñir	VGFPE
tiñiéndonoslas	teñir	VGFPE
tiñiéndooslas	teñir	VGFPE
tincar	tincar	O
tinco	tincar	VIP1
tincas	tincar	VIP2
tinca	tincar	VIP3
tincamos	tincar	VIP4
tincáis	tincar	VIP5
tincan	tincar	VIP6
tincaba	tincar	VII1
tincabas	tincar	VII2
tincábamos	tincar	VII4
tincabais	tincar	VII5
tincaban	tincar	VII6
tincaré	tincar	VIF1
tincarás	tincar	VIF2
tincará	tincar	VIF3
tincaremos	tincar	VIF4
tincaréis	tincar	VIF5
tincarán	tincar	VIF6
tincaría	tincar	VIC1
tincarías	tincar	VIC2
tincaría	tincar	VIC3
tincaríamos	tincar	VIC4
tincaríais	tincar	VIC5
tincarían	tincar	VIC6
tinqué	tincar	VIX1
tincaste	tincar	VIX2
tincó	tincar	VIX3
tincasteis	tincar	VIX5
tincaron	tincar	VIX6
tinque	tincar	VSP1
tinques	tincar	VSP2
tinquemos	tincar	VSP4
tinquéis	tincar	VSP5
tinquen	tincar	VSP6
tincara	tincar	VSX1
tincaras	tincar	VSX2
tincáramos	tincar	VSX4
tincarais	tincar	VSX5
tincaran	tincar	VSX6
tincare	tincar	VSF1
tincares	tincar	VSF2
tincáremos	tincar	VSF4
tincareis	tincar	VSF5
tincaren	tincar	VSF6
tincase	tincar	VSI1
tincases	tincar	VSI2
tincásemos	tincar	VSI4
tincaseis	tincar	VSI5
tincasen	tincar	VSI6
tincad	tincar	VMP
tincadme	tincar	VMSE
tincadle	tincar	VMSE
tincadnos	tincar	VMPE
tincaos	tincar	VMPE
tincadles	tincar	VMPE
tincadlo	tincar	VMMSE
tincadla	tincar	VMFSE
tincadlos	tincar	VMMPE
tincadlas	tincar	VMFPE
tincádmelo	tincar	VMMSE
tincádselo	tincar	VMMSE
tincádnoslo	tincar	VMMSE
tincáoslo	tincar	VMMSE
tincádmelos	tincar	VMMPE
tincádselos	tincar	VMMPE
tincádnoslos	tincar	VMMPE
tincáoslos	tincar	VMMPE
tincádmela	tincar	VMFSE
tincádsela	tincar	VMFSE
tincádnosla	tincar	VMFSE
tincáosla	tincar	VMFSE
tincádmelas	tincar	VMFPE
tincádselas	tincar	VMFPE
tincádnoslas	tincar	VMFPE
tincáoslas	tincar	VMFPE
tincado	tincar	VPM
tincados	tincar	VPMP
tincada	tincar	VPF
tincadas	tincar	VPFP
tincando	tincar	VG
tincándome	tincar	VGSE
tincándote	tincar	VGSE
tincándole	tincar	VGSE
tincándonos	tincar	VGPE
tincándoos	tincar	VGPE
tincándolo	tincar	VGMSE
tincándola	tincar	VGFSE
tincándolos	tincar	VGMPE
tincándolas	tincar	VGFPE
tincándomelo	tincar	VGMSE
tincándotelo	tincar	VGMSE
tincándoselo	tincar	VGMSE
tincándonoslo	tincar	VGMSE
tincándooslo	tincar	VGMSE
tincándomelos	tincar	VGMPE
tincándotelos	tincar	VGMPE
tincándoselos	tincar	VGMPE
tincándonoslos	tincar	VGMPE
tincándooslos	tincar	VGMPE
tincándomela	tincar	VGFSE
tincándotela	tincar	VGFSE
tincándosela	tincar	VGFSE
tincándonosla	tincar	VGFSE
tincándoosla	tincar	VGFSE
tincándomelas	tincar	VGFPE
tincándotelas	tincar	VGFPE
tincándoselas	tincar	VGFPE
tincándonoslas	tincar	VGFPE
tincándooslas	tincar	VGFPE
tindalizar	tindalizar	O
tindalizo	tindalizar	VIP1
tindalizas	tindalizar	VIP2
tindaliza	tindalizar	VIP3
tindalizamos	tindalizar	VIP4
tindalizáis	tindalizar	VIP5
tindalizan	tindalizar	VIP6
tindalizaba	tindalizar	VII1
tindalizabas	tindalizar	VII2
tindalizábamos	tindalizar	VII4
tindalizabais	tindalizar	VII5
tindalizaban	tindalizar	VII6
tindalizaré	tindalizar	VIF1
tindalizarás	tindalizar	VIF2
tindalizará	tindalizar	VIF3
tindalizaremos	tindalizar	VIF4
tindalizaréis	tindalizar	VIF5
tindalizarán	tindalizar	VIF6
tindalizaría	tindalizar	VIC1
tindalizarías	tindalizar	VIC2
tindalizaría	tindalizar	VIC3
tindalizaríamos	tindalizar	VIC4
tindalizaríais	tindalizar	VIC5
tindalizarían	tindalizar	VIC6
tindalicé	tindalizar	VIX1
tindalizaste	tindalizar	VIX2
tindalizó	tindalizar	VIX3
tindalizasteis	tindalizar	VIX5
tindalizaron	tindalizar	VIX6
tindalice	tindalizar	VSP1
tindalices	tindalizar	VSP2
tindalicemos	tindalizar	VSP4
tindalicéis	tindalizar	VSP5
tindalicen	tindalizar	VSP6
tindalizara	tindalizar	VSX1
tindalizaras	tindalizar	VSX2
tindalizáramos	tindalizar	VSX4
tindalizarais	tindalizar	VSX5
tindalizaran	tindalizar	VSX6
tindalizare	tindalizar	VSF1
tindalizares	tindalizar	VSF2
tindalizáremos	tindalizar	VSF4
tindalizareis	tindalizar	VSF5
tindalizaren	tindalizar	VSF6
tindalizase	tindalizar	VSI1
tindalizases	tindalizar	VSI2
tindalizásemos	tindalizar	VSI4
tindalizaseis	tindalizar	VSI5
tindalizasen	tindalizar	VSI6
tindalizad	tindalizar	VMP
tindalizadme	tindalizar	VMSE
tindalizadle	tindalizar	VMSE
tindalizadnos	tindalizar	VMPE
tindalizaos	tindalizar	VMPE
tindalizadles	tindalizar	VMPE
tindalizadlo	tindalizar	VMMSE
tindalizadla	tindalizar	VMFSE
tindalizadlos	tindalizar	VMMPE
tindalizadlas	tindalizar	VMFPE
tindalizádmelo	tindalizar	VMMSE
tindalizádselo	tindalizar	VMMSE
tindalizádnoslo	tindalizar	VMMSE
tindalizáoslo	tindalizar	VMMSE
tindalizádmelos	tindalizar	VMMPE
tindalizádselos	tindalizar	VMMPE
tindalizádnoslos	tindalizar	VMMPE
tindalizáoslos	tindalizar	VMMPE
tindalizádmela	tindalizar	VMFSE
tindalizádsela	tindalizar	VMFSE
tindalizádnosla	tindalizar	VMFSE
tindalizáosla	tindalizar	VMFSE
tindalizádmelas	tindalizar	VMFPE
tindalizádselas	tindalizar	VMFPE
tindalizádnoslas	tindalizar	VMFPE
tindalizáoslas	tindalizar	VMFPE
tindalizado	tindalizar	VPM
tindalizados	tindalizar	VPMP
tindalizada	tindalizar	VPF
tindalizadas	tindalizar	VPFP
tindalizando	tindalizar	VG
tindalizándome	tindalizar	VGSE
tindalizándote	tindalizar	VGSE
tindalizándole	tindalizar	VGSE
tindalizándonos	tindalizar	VGPE
tindalizándoos	tindalizar	VGPE
tindalizándolo	tindalizar	VGMSE
tindalizándola	tindalizar	VGFSE
tindalizándolos	tindalizar	VGMPE
tindalizándolas	tindalizar	VGFPE
tindalizándomelo	tindalizar	VGMSE
tindalizándotelo	tindalizar	VGMSE
tindalizándoselo	tindalizar	VGMSE
tindalizándonoslo	tindalizar	VGMSE
tindalizándooslo	tindalizar	VGMSE
tindalizándomelos	tindalizar	VGMPE
tindalizándotelos	tindalizar	VGMPE
tindalizándoselos	tindalizar	VGMPE
tindalizándonoslos	tindalizar	VGMPE
tindalizándooslos	tindalizar	VGMPE
tindalizándomela	tindalizar	VGFSE
tindalizándotela	tindalizar	VGFSE
tindalizándosela	tindalizar	VGFSE
tindalizándonosla	tindalizar	VGFSE
tindalizándoosla	tindalizar	VGFSE
tindalizándomelas	tindalizar	VGFPE
tindalizándotelas	tindalizar	VGFPE
tindalizándoselas	tindalizar	VGFPE
tindalizándonoslas	tindalizar	VGFPE
tindalizándooslas	tindalizar	VGFPE
tintar	tintar	O
tinto	tintar	VIP1
tintas	tintar	VIP2
tinta	tintar	VIP3
tintamos	tintar	VIP4
tintáis	tintar	VIP5
tintan	tintar	VIP6
tintaba	tintar	VII1
tintabas	tintar	VII2
tintábamos	tintar	VII4
tintabais	tintar	VII5
tintaban	tintar	VII6
tintaré	tintar	VIF1
tintarás	tintar	VIF2
tintará	tintar	VIF3
tintaremos	tintar	VIF4
tintaréis	tintar	VIF5
tintarán	tintar	VIF6
tintaría	tintar	VIC1
tintarías	tintar	VIC2
tintaría	tintar	VIC3
tintaríamos	tintar	VIC4
tintaríais	tintar	VIC5
tintarían	tintar	VIC6
tinté	tintar	VIX1
tintaste	tintar	VIX2
tintó	tintar	VIX3
tintasteis	tintar	VIX5
tintaron	tintar	VIX6
tinte	tintar	VSP1
tintes	tintar	VSP2
tintemos	tintar	VSP4
tintéis	tintar	VSP5
tinten	tintar	VSP6
tintara	tintar	VSX1
tintaras	tintar	VSX2
tintáramos	tintar	VSX4
tintarais	tintar	VSX5
tintaran	tintar	VSX6
tintare	tintar	VSF1
tintares	tintar	VSF2
tintáremos	tintar	VSF4
tintareis	tintar	VSF5
tintaren	tintar	VSF6
tintase	tintar	VSI1
tintases	tintar	VSI2
tintásemos	tintar	VSI4
tintaseis	tintar	VSI5
tintasen	tintar	VSI6
tintad	tintar	VMP
tintadme	tintar	VMSE
tintadle	tintar	VMSE
tintadnos	tintar	VMPE
tintaos	tintar	VMPE
tintadles	tintar	VMPE
tintadlo	tintar	VMMSE
tintadla	tintar	VMFSE
tintadlos	tintar	VMMPE
tintadlas	tintar	VMFPE
tintádmelo	tintar	VMMSE
tintádselo	tintar	VMMSE
tintádnoslo	tintar	VMMSE
tintáoslo	tintar	VMMSE
tintádmelos	tintar	VMMPE
tintádselos	tintar	VMMPE
tintádnoslos	tintar	VMMPE
tintáoslos	tintar	VMMPE
tintádmela	tintar	VMFSE
tintádsela	tintar	VMFSE
tintádnosla	tintar	VMFSE
tintáosla	tintar	VMFSE
tintádmelas	tintar	VMFPE
tintádselas	tintar	VMFPE
tintádnoslas	tintar	VMFPE
tintáoslas	tintar	VMFPE
tintado	tintar	VPM
tintados	tintar	VPMP
tintada	tintar	VPF
tintadas	tintar	VPFP
tintando	tintar	VG
tintándome	tintar	VGSE
tintándote	tintar	VGSE
tintándole	tintar	VGSE
tintándonos	tintar	VGPE
tintándoos	tintar	VGPE
tintándolo	tintar	VGMSE
tintándola	tintar	VGFSE
tintándolos	tintar	VGMPE
tintándolas	tintar	VGFPE
tintándomelo	tintar	VGMSE
tintándotelo	tintar	VGMSE
tintándoselo	tintar	VGMSE
tintándonoslo	tintar	VGMSE
tintándooslo	tintar	VGMSE
tintándomelos	tintar	VGMPE
tintándotelos	tintar	VGMPE
tintándoselos	tintar	VGMPE
tintándonoslos	tintar	VGMPE
tintándooslos	tintar	VGMPE
tintándomela	tintar	VGFSE
tintándotela	tintar	VGFSE
tintándosela	tintar	VGFSE
tintándonosla	tintar	VGFSE
tintándoosla	tintar	VGFSE
tintándomelas	tintar	VGFPE
tintándotelas	tintar	VGFPE
tintándoselas	tintar	VGFPE
tintándonoslas	tintar	VGFPE
tintándooslas	tintar	VGFPE
tintinar	tintinar	O
tintino	tintinar	VIP1
tintinas	tintinar	VIP2
tintina	tintinar	VIP3
tintinamos	tintinar	VIP4
tintináis	tintinar	VIP5
tintinan	tintinar	VIP6
tintinaba	tintinar	VII1
tintinabas	tintinar	VII2
tintinábamos	tintinar	VII4
tintinabais	tintinar	VII5
tintinaban	tintinar	VII6
tintinaré	tintinar	VIF1
tintinarás	tintinar	VIF2
tintinará	tintinar	VIF3
tintinaremos	tintinar	VIF4
tintinaréis	tintinar	VIF5
tintinarán	tintinar	VIF6
tintinaría	tintinar	VIC1
tintinarías	tintinar	VIC2
tintinaría	tintinar	VIC3
tintinaríamos	tintinar	VIC4
tintinaríais	tintinar	VIC5
tintinarían	tintinar	VIC6
tintiné	tintinar	VIX1
tintinaste	tintinar	VIX2
tintinó	tintinar	VIX3
tintinasteis	tintinar	VIX5
tintinaron	tintinar	VIX6
tintine	tintinar	VSP1
tintines	tintinar	VSP2
tintinemos	tintinar	VSP4
tintinéis	tintinar	VSP5
tintinen	tintinar	VSP6
tintinara	tintinar	VSX1
tintinaras	tintinar	VSX2
tintináramos	tintinar	VSX4
tintinarais	tintinar	VSX5
tintinaran	tintinar	VSX6
tintinare	tintinar	VSF1
tintinares	tintinar	VSF2
tintináremos	tintinar	VSF4
tintinareis	tintinar	VSF5
tintinaren	tintinar	VSF6
tintinase	tintinar	VSI1
tintinases	tintinar	VSI2
tintinásemos	tintinar	VSI4
tintinaseis	tintinar	VSI5
tintinasen	tintinar	VSI6
tintinad	tintinar	VMP
tintinadme	tintinar	VMSE
tintinadle	tintinar	VMSE
tintinadnos	tintinar	VMPE
tintinaos	tintinar	VMPE
tintinadles	tintinar	VMPE
tintinado	tintinar	VPM
tintinados	tintinar	VPMP
tintinada	tintinar	VPF
tintinadas	tintinar	VPFP
tintinando	tintinar	VG
tintinándome	tintinar	VGSE
tintinándote	tintinar	VGSE
tintinándole	tintinar	VGSE
tintinándonos	tintinar	VGPE
tintinándoos	tintinar	VGPE
tintinear	tintinear	O
tintineo	tintinear	VIP1
tintineas	tintinear	VIP2
tintinea	tintinear	VIP3
tintineamos	tintinear	VIP4
tintineáis	tintinear	VIP5
tintinean	tintinear	VIP6
tintineaba	tintinear	VII1
tintineabas	tintinear	VII2
tintineábamos	tintinear	VII4
tintineabais	tintinear	VII5
tintineaban	tintinear	VII6
tintinearé	tintinear	VIF1
tintinearás	tintinear	VIF2
tintineará	tintinear	VIF3
tintinearemos	tintinear	VIF4
tintinearéis	tintinear	VIF5
tintinearán	tintinear	VIF6
tintinearía	tintinear	VIC1
tintinearías	tintinear	VIC2
tintinearía	tintinear	VIC3
tintinearíamos	tintinear	VIC4
tintinearíais	tintinear	VIC5
tintinearían	tintinear	VIC6
tintineé	tintinear	VIX1
tintineaste	tintinear	VIX2
tintineó	tintinear	VIX3
tintineasteis	tintinear	VIX5
tintinearon	tintinear	VIX6
tintinee	tintinear	VSP1
tintinees	tintinear	VSP2
tintineemos	tintinear	VSP4
tintineéis	tintinear	VSP5
tintineen	tintinear	VSP6
tintineara	tintinear	VSX1
tintinearas	tintinear	VSX2
tintineáramos	tintinear	VSX4
tintinearais	tintinear	VSX5
tintinearan	tintinear	VSX6
tintineare	tintinear	VSF1
tintineares	tintinear	VSF2
tintineáremos	tintinear	VSF4
tintineareis	tintinear	VSF5
tintinearen	tintinear	VSF6
tintinease	tintinear	VSI1
tintineases	tintinear	VSI2
tintineásemos	tintinear	VSI4
tintineaseis	tintinear	VSI5
tintineasen	tintinear	VSI6
tintinead	tintinear	VMP
tintineadme	tintinear	VMSE
tintineadle	tintinear	VMSE
tintineadnos	tintinear	VMPE
tintineaos	tintinear	VMPE
tintineadles	tintinear	VMPE
tintineado	tintinear	VPM
tintineados	tintinear	VPMP
tintineada	tintinear	VPF
tintineadas	tintinear	VPFP
tintineando	tintinear	VG
tintineándome	tintinear	VGSE
tintineándote	tintinear	VGSE
tintineándole	tintinear	VGSE
tintineándonos	tintinear	VGPE
tintineándoos	tintinear	VGPE
tinturar	tinturar	O
tinturo	tinturar	VIP1
tinturas	tinturar	VIP2
tintura	tinturar	VIP3
tinturamos	tinturar	VIP4
tinturáis	tinturar	VIP5
tinturan	tinturar	VIP6
tinturaba	tinturar	VII1
tinturabas	tinturar	VII2
tinturábamos	tinturar	VII4
tinturabais	tinturar	VII5
tinturaban	tinturar	VII6
tinturaré	tinturar	VIF1
tinturarás	tinturar	VIF2
tinturará	tinturar	VIF3
tinturaremos	tinturar	VIF4
tinturaréis	tinturar	VIF5
tinturarán	tinturar	VIF6
tinturaría	tinturar	VIC1
tinturarías	tinturar	VIC2
tinturaría	tinturar	VIC3
tinturaríamos	tinturar	VIC4
tinturaríais	tinturar	VIC5
tinturarían	tinturar	VIC6
tinturé	tinturar	VIX1
tinturaste	tinturar	VIX2
tinturó	tinturar	VIX3
tinturasteis	tinturar	VIX5
tinturaron	tinturar	VIX6
tinture	tinturar	VSP1
tintures	tinturar	VSP2
tinturemos	tinturar	VSP4
tinturéis	tinturar	VSP5
tinturen	tinturar	VSP6
tinturara	tinturar	VSX1
tinturaras	tinturar	VSX2
tinturáramos	tinturar	VSX4
tinturarais	tinturar	VSX5
tinturaran	tinturar	VSX6
tinturare	tinturar	VSF1
tinturares	tinturar	VSF2
tinturáremos	tinturar	VSF4
tinturareis	tinturar	VSF5
tinturaren	tinturar	VSF6
tinturase	tinturar	VSI1
tinturases	tinturar	VSI2
tinturásemos	tinturar	VSI4
tinturaseis	tinturar	VSI5
tinturasen	tinturar	VSI6
tinturad	tinturar	VMP
tinturadme	tinturar	VMSE
tinturadle	tinturar	VMSE
tinturadnos	tinturar	VMPE
tinturaos	tinturar	VMPE
tinturadles	tinturar	VMPE
tinturado	tinturar	VPM
tinturados	tinturar	VPMP
tinturada	tinturar	VPF
tinturadas	tinturar	VPFP
tinturando	tinturar	VG
tinturándome	tinturar	VGSE
tinturándote	tinturar	VGSE
tinturándole	tinturar	VGSE
tinturándonos	tinturar	VGPE
tinturándoos	tinturar	VGPE
