toba	toba	O
tobas	toba	P
tobaja	tobaja	O
tobajas	tobaja	P
toballa	toballa	O
toballas	toballa	P
toballeta	toballeta	O
toballetas	toballeta	P
tobar	tobar	O
tobares	tobar	P
tobelleta	tobelleta	O
tobelletas	tobelleta	P
tobera	tobera	O
toberas	tobera	P
tobiano	tobiano	O
tobianas	tobiano	FP
tobiana	tobiano	F
tobianos	tobiano	P
tobillero	tobillero	O
tobilleras	tobillero	FP
tobillera	tobillero	F
tobilleros	tobillero	P
tobillo	tobillo	O
tobillos	tobillo	P
toboba	toboba	O
tobobas	toboba	P
tobogán	tobogán	O
toboganes	tobogán	P
tobosesco	tobosesco	O
tobosescas	tobosesco	FP
tobosesca	tobosesco	F
tobosescos	tobosesco	P
toboseño	toboseño	O
toboseñas	toboseño	FP
toboseña	toboseño	F
toboseños	toboseño	P
tobosino	tobosino	O
tobosinas	tobosino	FP
tobosina	tobosino	F
tobosinos	tobosino	P
toboso	toboso	O
tobosas	toboso	FP
tobosa	toboso	F
tobosos	toboso	P
