viola	viola	O
violas	viola	P
violación	violación	O
violaciones	violación	P
violado	violado	O
violadas	violado	FP
violada	violado	F
violados	violado	P
violador	violador	O
violadoras	violador	FP
violadora	violador	F
violadores	violador	P
violencia	violencia	O
violencias	violencia	P
violentamente	violentamente	O
violento	violento	O
violentas	violento	FP
violenta	violento	F
violentos	violento	P
violero	violero	O
violeros	violero	P
violeta	violeta	O
violetas	violeta	P
violetera	violetera	O
violeteras	violetera	P
violetero	violetero	O
violeteros	violetero	P
violeto	violeto	O
violetos	violeto	P
violinista	violinista	O
violinistas	violinista	P
violoncelista	violoncelista	O
violoncelistas	violoncelista	P
violoncelo	violoncelo	O
violoncelos	violoncelo	P
violonchelista	violonchelista	O
violonchelistas	violonchelista	P
violonchelo	violonchelo	O
violonchelos	violonchelo	P
violáceo	violáceo	O
violáceas	violáceo	FP
violácea	violáceo	F
violáceos	violáceo	P
violín	violín	O
violines	violín	P
violón	violón	O
violones	violón	P
vió	ver	VIX3
violar	violar	O
violo	violar	VIP1
violas	violar	VIP2
viola	violar	VIP3
violamos	violar	VIP4
violáis	violar	VIP5
violan	violar	VIP6
violaba	violar	VII1
violabas	violar	VII2
violábamos	violar	VII4
violabais	violar	VII5
violaban	violar	VII6
violaré	violar	VIF1
violarás	violar	VIF2
violará	violar	VIF3
violaremos	violar	VIF4
violaréis	violar	VIF5
violarán	violar	VIF6
violaría	violar	VIC1
violarías	violar	VIC2
violaría	violar	VIC3
violaríamos	violar	VIC4
violaríais	violar	VIC5
violarían	violar	VIC6
violé	violar	VIX1
violaste	violar	VIX2
violó	violar	VIX3
violasteis	violar	VIX5
violaron	violar	VIX6
viole	violar	VSP1
violes	violar	VSP2
violemos	violar	VSP4
violéis	violar	VSP5
violen	violar	VSP6
violara	violar	VSX1
violaras	violar	VSX2
violáramos	violar	VSX4
violarais	violar	VSX5
violaran	violar	VSX6
violare	violar	VSF1
violares	violar	VSF2
violáremos	violar	VSF4
violareis	violar	VSF5
violaren	violar	VSF6
violase	violar	VSI1
violases	violar	VSI2
violásemos	violar	VSI4
violaseis	violar	VSI5
violasen	violar	VSI6
violad	violar	VMP
violadme	violar	VMSE
violadle	violar	VMSE
violadnos	violar	VMPE
violaos	violar	VMPE
violadles	violar	VMPE
violadlo	violar	VMMSE
violadla	violar	VMFSE
violadlos	violar	VMMPE
violadlas	violar	VMFPE
violádmelo	violar	VMMSE
violádselo	violar	VMMSE
violádnoslo	violar	VMMSE
violáoslo	violar	VMMSE
violádmelos	violar	VMMPE
violádselos	violar	VMMPE
violádnoslos	violar	VMMPE
violáoslos	violar	VMMPE
violádmela	violar	VMFSE
violádsela	violar	VMFSE
violádnosla	violar	VMFSE
violáosla	violar	VMFSE
violádmelas	violar	VMFPE
violádselas	violar	VMFPE
violádnoslas	violar	VMFPE
violáoslas	violar	VMFPE
violado	violar	VPM
violados	violar	VPMP
violada	violar	VPF
violadas	violar	VPFP
violando	violar	VG
violándome	violar	VGSE
violándote	violar	VGSE
violándole	violar	VGSE
violándonos	violar	VGPE
violándoos	violar	VGPE
violándolo	violar	VGMSE
violándola	violar	VGFSE
violándolos	violar	VGMPE
violándolas	violar	VGFPE
violándomelo	violar	VGMSE
violándotelo	violar	VGMSE
violándoselo	violar	VGMSE
violándonoslo	violar	VGMSE
violándooslo	violar	VGMSE
violándomelos	violar	VGMPE
violándotelos	violar	VGMPE
violándoselos	violar	VGMPE
violándonoslos	violar	VGMPE
violándooslos	violar	VGMPE
violándomela	violar	VGFSE
violándotela	violar	VGFSE
violándosela	violar	VGFSE
violándonosla	violar	VGFSE
violándoosla	violar	VGFSE
violándomelas	violar	VGFPE
violándotelas	violar	VGFPE
violándoselas	violar	VGFPE
violándonoslas	violar	VGFPE
violándooslas	violar	VGFPE
violares	violar	P
violentar	violentar	O
violento	violentar	VIP1
violentas	violentar	VIP2
violenta	violentar	VIP3
violentamos	violentar	VIP4
violentáis	violentar	VIP5
violentan	violentar	VIP6
violentaba	violentar	VII1
violentabas	violentar	VII2
violentábamos	violentar	VII4
violentabais	violentar	VII5
violentaban	violentar	VII6
violentaré	violentar	VIF1
violentarás	violentar	VIF2
violentará	violentar	VIF3
violentaremos	violentar	VIF4
violentaréis	violentar	VIF5
violentarán	violentar	VIF6
violentaría	violentar	VIC1
violentarías	violentar	VIC2
violentaría	violentar	VIC3
violentaríamos	violentar	VIC4
violentaríais	violentar	VIC5
violentarían	violentar	VIC6
violenté	violentar	VIX1
violentaste	violentar	VIX2
violentó	violentar	VIX3
violentasteis	violentar	VIX5
violentaron	violentar	VIX6
violente	violentar	VSP1
violentes	violentar	VSP2
violentemos	violentar	VSP4
violentéis	violentar	VSP5
violenten	violentar	VSP6
violentara	violentar	VSX1
violentaras	violentar	VSX2
violentáramos	violentar	VSX4
violentarais	violentar	VSX5
violentaran	violentar	VSX6
violentare	violentar	VSF1
violentares	violentar	VSF2
violentáremos	violentar	VSF4
violentareis	violentar	VSF5
violentaren	violentar	VSF6
violentase	violentar	VSI1
violentases	violentar	VSI2
violentásemos	violentar	VSI4
violentaseis	violentar	VSI5
violentasen	violentar	VSI6
violentad	violentar	VMP
violentadme	violentar	VMSE
violentadle	violentar	VMSE
violentadnos	violentar	VMPE
violentaos	violentar	VMPE
violentadles	violentar	VMPE
violentadlo	violentar	VMMSE
violentadla	violentar	VMFSE
violentadlos	violentar	VMMPE
violentadlas	violentar	VMFPE
violentádmelo	violentar	VMMSE
violentádselo	violentar	VMMSE
violentádnoslo	violentar	VMMSE
violentáoslo	violentar	VMMSE
violentádmelos	violentar	VMMPE
violentádselos	violentar	VMMPE
violentádnoslos	violentar	VMMPE
violentáoslos	violentar	VMMPE
violentádmela	violentar	VMFSE
violentádsela	violentar	VMFSE
violentádnosla	violentar	VMFSE
violentáosla	violentar	VMFSE
violentádmelas	violentar	VMFPE
violentádselas	violentar	VMFPE
violentádnoslas	violentar	VMFPE
violentáoslas	violentar	VMFPE
violentado	violentar	VPM
violentados	violentar	VPMP
violentada	violentar	VPF
violentadas	violentar	VPFP
violentando	violentar	VG
violentándome	violentar	VGSE
violentándote	violentar	VGSE
violentándole	violentar	VGSE
violentándonos	violentar	VGPE
violentándoos	violentar	VGPE
violentándolo	violentar	VGMSE
violentándola	violentar	VGFSE
violentándolos	violentar	VGMPE
violentándolas	violentar	VGFPE
violentándomelo	violentar	VGMSE
violentándotelo	violentar	VGMSE
violentándoselo	violentar	VGMSE
violentándonoslo	violentar	VGMSE
violentándooslo	violentar	VGMSE
violentándomelos	violentar	VGMPE
violentándotelos	violentar	VGMPE
violentándoselos	violentar	VGMPE
violentándonoslos	violentar	VGMPE
violentándooslos	violentar	VGMPE
violentándomela	violentar	VGFSE
violentándotela	violentar	VGFSE
violentándosela	violentar	VGFSE
violentándonosla	violentar	VGFSE
violentándoosla	violentar	VGFSE
violentándomelas	violentar	VGFPE
violentándotelas	violentar	VGFPE
violentándoselas	violentar	VGFPE
violentándonoslas	violentar	VGFPE
violentándooslas	violentar	VGFPE
