vid	vid	O
vides	vid	P
vida	vida	O
vidas	vida	P
vidalita	vidalita	O
vidalitas	vidalita	P
vidarra	vidarra	O
vidarras	vidarra	P
vide	vide	O
vides	vide	P
videncia	videncia	O
videncias	videncia	P
vidente	vidente	O
videntes	vidente	P
videoaficionado	videoaficionado	O
videoaficionadas	videoaficionado	FP
videoaficionada	videoaficionado	F
videoaficionados	videoaficionado	P
videocinta	videocinta	O
videocintas	videocinta	P
videoclip	videoclip	O
videoclipes	videoclip	P
videoclub	videoclub	O
videoclubes	videoclub	P
videoconferencia	videoconferencia	O
videoconferencias	videoconferencia	P
videoconsola	videoconsola	O
videoconsolas	videoconsola	P
videocámara	videocámara	O
videocámaras	videocámara	P
videodisco	videodisco	O
videodiscos	videodisco	P
videofrecuencia	videofrecuencia	O
videofrecuencias	videofrecuencia	P
videograbación	videograbación	O
videograbaciones	videograbación	P
videojuego	videojuego	O
videojuegos	videojuego	P
videoteca	videoteca	O
videotecas	videoteca	P
videoteléfono	videoteléfono	O
videoteléfonos	videoteléfono	P
vidorra	vidorra	O
vidorras	vidorra	P
vidorria	vidorria	O
vidorrias	vidorria	P
vidriado	vidriado	O
vidriadas	vidriado	FP
vidriada	vidriado	F
vidriados	vidriado	P
vidriera	vidriera	O
vidrieras	vidriera	P
vidriero	vidriero	O
vidrieras	vidriero	FP
vidriera	vidriero	F
vidrieros	vidriero	P
vidriería	vidriería	O
vidrierías	vidriería	P
vidrio	vidrio	O
vidrios	vidrio	P
vidriosidad	vidriosidad	O
vidriosidades	vidriosidad	P
vidrioso	vidrioso	O
vidriosas	vidrioso	FP
vidriosa	vidrioso	F
vidriosos	vidrioso	P
vidro	vidro	O
vidros	vidro	P
vidual	vidual	O
viduales	vidual	P
vidueño	vidueño	O
vidueños	vidueño	P
vidurria	vidurria	O
vidurrias	vidurria	P
viduño	viduño	O
viduños	viduño	P
vídeo	vídeo	O
vídeos	vídeo	P
vidriar	vidriar	O
vidrio	vidriar	VIP1
vidrias	vidriar	VIP2
vidria	vidriar	VIP3
vidriamos	vidriar	VIP4
vidriáis	vidriar	VIP5
vidrian	vidriar	VIP6
vidriaba	vidriar	VII1
vidriabas	vidriar	VII2
vidriábamos	vidriar	VII4
vidriabais	vidriar	VII5
vidriaban	vidriar	VII6
vidriaré	vidriar	VIF1
vidriarás	vidriar	VIF2
vidriará	vidriar	VIF3
vidriaremos	vidriar	VIF4
vidriaréis	vidriar	VIF5
vidriarán	vidriar	VIF6
vidriaría	vidriar	VIC1
vidriarías	vidriar	VIC2
vidriaría	vidriar	VIC3
vidriaríamos	vidriar	VIC4
vidriaríais	vidriar	VIC5
vidriarían	vidriar	VIC6
vidrié	vidriar	VIX1
vidriaste	vidriar	VIX2
vidrió	vidriar	VIX3
vidriasteis	vidriar	VIX5
vidriaron	vidriar	VIX6
vidrie	vidriar	VSP1
vidries	vidriar	VSP2
vidriemos	vidriar	VSP4
vidriéis	vidriar	VSP5
vidrien	vidriar	VSP6
vidriara	vidriar	VSX1
vidriaras	vidriar	VSX2
vidriáramos	vidriar	VSX4
vidriarais	vidriar	VSX5
vidriaran	vidriar	VSX6
vidriare	vidriar	VSF1
vidriares	vidriar	VSF2
vidriáremos	vidriar	VSF4
vidriareis	vidriar	VSF5
vidriaren	vidriar	VSF6
vidriase	vidriar	VSI1
vidriases	vidriar	VSI2
vidriásemos	vidriar	VSI4
vidriaseis	vidriar	VSI5
vidriasen	vidriar	VSI6
vidriad	vidriar	VMP
vidriadme	vidriar	VMSE
vidriadle	vidriar	VMSE
vidriadnos	vidriar	VMPE
vidriaos	vidriar	VMPE
vidriadles	vidriar	VMPE
vidriadlo	vidriar	VMMSE
vidriadla	vidriar	VMFSE
vidriadlos	vidriar	VMMPE
vidriadlas	vidriar	VMFPE
vidriádmelo	vidriar	VMMSE
vidriádselo	vidriar	VMMSE
vidriádnoslo	vidriar	VMMSE
vidriáoslo	vidriar	VMMSE
vidriádmelos	vidriar	VMMPE
vidriádselos	vidriar	VMMPE
vidriádnoslos	vidriar	VMMPE
vidriáoslos	vidriar	VMMPE
vidriádmela	vidriar	VMFSE
vidriádsela	vidriar	VMFSE
vidriádnosla	vidriar	VMFSE
vidriáosla	vidriar	VMFSE
vidriádmelas	vidriar	VMFPE
vidriádselas	vidriar	VMFPE
vidriádnoslas	vidriar	VMFPE
vidriáoslas	vidriar	VMFPE
vidriado	vidriar	VPM
vidriados	vidriar	VPMP
vidriada	vidriar	VPF
vidriadas	vidriar	VPFP
vidriando	vidriar	VG
vidriándome	vidriar	VGSE
vidriándote	vidriar	VGSE
vidriándole	vidriar	VGSE
vidriándonos	vidriar	VGPE
vidriándoos	vidriar	VGPE
vidriándolo	vidriar	VGMSE
vidriándola	vidriar	VGFSE
vidriándolos	vidriar	VGMPE
vidriándolas	vidriar	VGFPE
vidriándomelo	vidriar	VGMSE
vidriándotelo	vidriar	VGMSE
vidriándoselo	vidriar	VGMSE
vidriándonoslo	vidriar	VGMSE
vidriándooslo	vidriar	VGMSE
vidriándomelos	vidriar	VGMPE
vidriándotelos	vidriar	VGMPE
vidriándoselos	vidriar	VGMPE
vidriándonoslos	vidriar	VGMPE
vidriándooslos	vidriar	VGMPE
vidriándomela	vidriar	VGFSE
vidriándotela	vidriar	VGFSE
vidriándosela	vidriar	VGFSE
vidriándonosla	vidriar	VGFSE
vidriándoosla	vidriar	VGFSE
vidriándomelas	vidriar	VGFPE
vidriándotelas	vidriar	VGFPE
vidriándoselas	vidriar	VGFPE
vidriándonoslas	vidriar	VGFPE
vidriándooslas	vidriar	VGFPE
