vivac	vivac	O
vivaces	vivac	P
vivacidad	vivacidad	O
vivacidades	vivacidad	P
vivalavirgen	vivalavirgen	O
vivalavirgenes	vivalavirgen	P
vivales	vivales	O
vivamente	vivamente	O
vivandero	vivandero	O
vivanderas	vivandero	FP
vivandera	vivandero	F
vivanderos	vivandero	P
vivaque	vivaque	O
vivaques	vivaque	P
vivaracho	vivaracho	O
vivarachas	vivaracho	FP
vivaracha	vivaracho	F
vivarachos	vivaracho	P
vivariense	vivariense	O
vivarienses	vivariense	P
vivaz	vivaz	O
vivaces	vivaz	P
vivencia	vivencia	O
vivencias	vivencia	P
vivencial	vivencial	O
vivenciales	vivencial	P
vivera	vivera	O
viveras	vivera	P
viveral	viveral	O
viverales	viveral	P
viverista	viverista	O
viveristas	viverista	P
vivero	vivero	O
viveros	vivero	P
vivez	vivez	O
viveces	vivez	P
viveza	viveza	O
vivezas	viveza	P
vividero	vividero	O
vivideras	vividero	FP
vividera	vividero	F
vivideros	vividero	P
vivido	vivido	O
vividas	vivido	FP
vivida	vivido	F
vividos	vivido	P
vividor	vividor	O
vividoras	vividor	FP
vividora	vividor	F
vividores	vividor	P
vivienda	vivienda	O
viviendas	vivienda	P
viviente	viviente	O
vivientes	viviente	P
vivificación	vivificación	O
vivificaciones	vivificación	P
vivificador	vivificador	O
vivificadoras	vivificador	FP
vivificadora	vivificador	F
vivificadores	vivificador	P
vivificante	vivificante	O
vivificantes	vivificante	P
vivificativo	vivificativo	O
vivificativas	vivificativo	FP
vivificativa	vivificativo	F
vivificativos	vivificativo	P
vivijagua	vivijagua	O
vivijaguas	vivijagua	P
vivisección	vivisección	O
vivisecciones	vivisección	P
vivismo	vivismo	O
vivismos	vivismo	P
vivista	vivista	O
vivistas	vivista	P
vivo	vivo	O
vivas	vivo	FP
viva	vivo	F
vivos	vivo	P
vivérrido	vivérrido	O
vivérridas	vivérrido	FP
vivérrida	vivérrido	F
vivérridos	vivérrido	P
vivífico	vivífico	O
vivíficas	vivífico	FP
vivífica	vivífico	F
vivíficos	vivífico	P
vivíparo	vivíparo	O
vivíparas	vivíparo	FP
vivípara	vivíparo	F
vivíparos	vivíparo	P
víveres	víveres	O
vívido	vívido	O
vívidas	vívido	FP
vívida	vívido	F
vívidos	vívido	P
vivir	vivir	O
vivo	vivir	VIP1
vives	vivir	VIP2
vive	vivir	VIP3
vivimos	vivir	VIP4
vivís	vivir	VIP5
viven	vivir	VIP6
vivía	vivir	VII1
vivías	vivir	VII2
vivíamos	vivir	VII4
vivíais	vivir	VII5
vivían	vivir	VII6
viviré	vivir	VIF1
vivirás	vivir	VIF2
vivirá	vivir	VIF3
viviremos	vivir	VIF4
viviréis	vivir	VIF5
vivirán	vivir	VIF6
viviría	vivir	VIC1
vivirías	vivir	VIC2
viviría	vivir	VIC3
viviríamos	vivir	VIC4
viviríais	vivir	VIC5
vivirían	vivir	VIC6
viví	vivir	VIX1
viviste	vivir	VIX2
vivió	vivir	VIX3
vivisteis	vivir	VIX5
vivieron	vivir	VIX6
viva	vivir	VSP1
vivas	vivir	VSP2
vivamos	vivir	VSP4
viváis	vivir	VSP5
vivan	vivir	VSP6
viviera	vivir	VSX1
vivieras	vivir	VSX2
viviéramos	vivir	VSX4
vivierais	vivir	VSX5
vivieran	vivir	VSX6
viviere	vivir	VSF1
vivieres	vivir	VSF2
viviéremos	vivir	VSF4
viviereis	vivir	VSF5
vivieren	vivir	VSF6
viviese	vivir	VSI1
vivieses	vivir	VSI2
viviésemos	vivir	VSI4
vivieseis	vivir	VSI5
viviesen	vivir	VSI6
vivid	vivir	VMP
vividme	vivir	VMSE
vividle	vivir	VMSE
vividnos	vivir	VMPE
vivios	vivir	VMPE
vividles	vivir	VMPE
vividlo	vivir	VMMSE
vividla	vivir	VMFSE
vividlos	vivir	VMMPE
vividlas	vivir	VMFPE
vivídmelo	vivir	VMMSE
vivídselo	vivir	VMMSE
vivídnoslo	vivir	VMMSE
vivíoslo	vivir	VMMSE
vivídmelos	vivir	VMMPE
vivídselos	vivir	VMMPE
vivídnoslos	vivir	VMMPE
vivíoslos	vivir	VMMPE
vivídmela	vivir	VMFSE
vivídsela	vivir	VMFSE
vivídnosla	vivir	VMFSE
vivíosla	vivir	VMFSE
vivídmelas	vivir	VMFPE
vivídselas	vivir	VMFPE
vivídnoslas	vivir	VMFPE
vivíoslas	vivir	VMFPE
vivido	vivir	VPM
vividos	vivir	VPMP
vivida	vivir	VPF
vividas	vivir	VPFP
viviendo	vivir	VG
viviéndome	vivir	VGSE
viviéndote	vivir	VGSE
viviéndole	vivir	VGSE
viviéndonos	vivir	VGPE
viviéndoos	vivir	VGPE
viviéndolo	vivir	VGMSE
viviéndola	vivir	VGFSE
viviéndolos	vivir	VGMPE
viviéndolas	vivir	VGFPE
viviéndomelo	vivir	VGMSE
viviéndotelo	vivir	VGMSE
viviéndoselo	vivir	VGMSE
viviéndonoslo	vivir	VGMSE
viviéndooslo	vivir	VGMSE
viviéndomelos	vivir	VGMPE
viviéndotelos	vivir	VGMPE
viviéndoselos	vivir	VGMPE
viviéndonoslos	vivir	VGMPE
viviéndooslos	vivir	VGMPE
viviéndomela	vivir	VGFSE
viviéndotela	vivir	VGFSE
viviéndosela	vivir	VGFSE
viviéndonosla	vivir	VGFSE
viviéndoosla	vivir	VGFSE
viviéndomelas	vivir	VGFPE
viviéndotelas	vivir	VGFPE
viviéndoselas	vivir	VGFPE
viviéndonoslas	vivir	VGFPE
viviéndooslas	vivir	VGFPE
vivires	vivir	P
vivaquear	vivaquear	O
vivaqueo	vivaquear	VIP1
vivaqueas	vivaquear	VIP2
vivaquea	vivaquear	VIP3
vivaqueamos	vivaquear	VIP4
vivaqueáis	vivaquear	VIP5
vivaquean	vivaquear	VIP6
vivaqueaba	vivaquear	VII1
vivaqueabas	vivaquear	VII2
vivaqueábamos	vivaquear	VII4
vivaqueabais	vivaquear	VII5
vivaqueaban	vivaquear	VII6
vivaquearé	vivaquear	VIF1
vivaquearás	vivaquear	VIF2
vivaqueará	vivaquear	VIF3
vivaquearemos	vivaquear	VIF4
vivaquearéis	vivaquear	VIF5
vivaquearán	vivaquear	VIF6
vivaquearía	vivaquear	VIC1
vivaquearías	vivaquear	VIC2
vivaquearía	vivaquear	VIC3
vivaquearíamos	vivaquear	VIC4
vivaquearíais	vivaquear	VIC5
vivaquearían	vivaquear	VIC6
vivaqueé	vivaquear	VIX1
vivaqueaste	vivaquear	VIX2
vivaqueó	vivaquear	VIX3
vivaqueasteis	vivaquear	VIX5
vivaquearon	vivaquear	VIX6
vivaquee	vivaquear	VSP1
vivaquees	vivaquear	VSP2
vivaqueemos	vivaquear	VSP4
vivaqueéis	vivaquear	VSP5
vivaqueen	vivaquear	VSP6
vivaqueara	vivaquear	VSX1
vivaquearas	vivaquear	VSX2
vivaqueáramos	vivaquear	VSX4
vivaquearais	vivaquear	VSX5
vivaquearan	vivaquear	VSX6
vivaqueare	vivaquear	VSF1
vivaqueares	vivaquear	VSF2
vivaqueáremos	vivaquear	VSF4
vivaqueareis	vivaquear	VSF5
vivaquearen	vivaquear	VSF6
vivaquease	vivaquear	VSI1
vivaqueases	vivaquear	VSI2
vivaqueásemos	vivaquear	VSI4
vivaqueaseis	vivaquear	VSI5
vivaqueasen	vivaquear	VSI6
vivaquead	vivaquear	VMP
vivaqueadme	vivaquear	VMSE
vivaqueadle	vivaquear	VMSE
vivaqueadnos	vivaquear	VMPE
vivaqueaos	vivaquear	VMPE
vivaqueadles	vivaquear	VMPE
vivaqueado	vivaquear	VPM
vivaqueados	vivaquear	VPMP
vivaqueada	vivaquear	VPF
vivaqueadas	vivaquear	VPFP
vivaqueando	vivaquear	VG
vivaqueándome	vivaquear	VGSE
vivaqueándote	vivaquear	VGSE
vivaqueándole	vivaquear	VGSE
vivaqueándonos	vivaquear	VGPE
vivaqueándoos	vivaquear	VGPE
vivar	vivar	O
vivo	vivar	VIP1
vivas	vivar	VIP2
viva	vivar	VIP3
vivamos	vivar	VIP4
viváis	vivar	VIP5
vivan	vivar	VIP6
vivaba	vivar	VII1
vivabas	vivar	VII2
vivábamos	vivar	VII4
vivabais	vivar	VII5
vivaban	vivar	VII6
vivaré	vivar	VIF1
vivarás	vivar	VIF2
vivará	vivar	VIF3
vivaremos	vivar	VIF4
vivaréis	vivar	VIF5
vivarán	vivar	VIF6
vivaría	vivar	VIC1
vivarías	vivar	VIC2
vivaría	vivar	VIC3
vivaríamos	vivar	VIC4
vivaríais	vivar	VIC5
vivarían	vivar	VIC6
vivé	vivar	VIX1
vivaste	vivar	VIX2
vivó	vivar	VIX3
vivasteis	vivar	VIX5
vivaron	vivar	VIX6
vive	vivar	VSP1
vives	vivar	VSP2
vivemos	vivar	VSP4
vivéis	vivar	VSP5
viven	vivar	VSP6
vivara	vivar	VSX1
vivaras	vivar	VSX2
viváramos	vivar	VSX4
vivarais	vivar	VSX5
vivaran	vivar	VSX6
vivare	vivar	VSF1
vivares	vivar	VSF2
viváremos	vivar	VSF4
vivareis	vivar	VSF5
vivaren	vivar	VSF6
vivase	vivar	VSI1
vivases	vivar	VSI2
vivásemos	vivar	VSI4
vivaseis	vivar	VSI5
vivasen	vivar	VSI6
vivad	vivar	VMP
vivadme	vivar	VMSE
vivadle	vivar	VMSE
vivadnos	vivar	VMPE
vivaos	vivar	VMPE
vivadles	vivar	VMPE
vivadlo	vivar	VMMSE
vivadla	vivar	VMFSE
vivadlos	vivar	VMMPE
vivadlas	vivar	VMFPE
vivádmelo	vivar	VMMSE
vivádselo	vivar	VMMSE
vivádnoslo	vivar	VMMSE
viváoslo	vivar	VMMSE
vivádmelos	vivar	VMMPE
vivádselos	vivar	VMMPE
vivádnoslos	vivar	VMMPE
viváoslos	vivar	VMMPE
vivádmela	vivar	VMFSE
vivádsela	vivar	VMFSE
vivádnosla	vivar	VMFSE
viváosla	vivar	VMFSE
vivádmelas	vivar	VMFPE
vivádselas	vivar	VMFPE
vivádnoslas	vivar	VMFPE
viváoslas	vivar	VMFPE
vivado	vivar	VPM
vivados	vivar	VPMP
vivada	vivar	VPF
vivadas	vivar	VPFP
vivando	vivar	VG
vivándome	vivar	VGSE
vivándote	vivar	VGSE
vivándole	vivar	VGSE
vivándonos	vivar	VGPE
vivándoos	vivar	VGPE
vivándolo	vivar	VGMSE
vivándola	vivar	VGFSE
vivándolos	vivar	VGMPE
vivándolas	vivar	VGFPE
vivándomelo	vivar	VGMSE
vivándotelo	vivar	VGMSE
vivándoselo	vivar	VGMSE
vivándonoslo	vivar	VGMSE
vivándooslo	vivar	VGMSE
vivándomelos	vivar	VGMPE
vivándotelos	vivar	VGMPE
vivándoselos	vivar	VGMPE
vivándonoslos	vivar	VGMPE
vivándooslos	vivar	VGMPE
vivándomela	vivar	VGFSE
vivándotela	vivar	VGFSE
vivándosela	vivar	VGFSE
vivándonosla	vivar	VGFSE
vivándoosla	vivar	VGFSE
vivándomelas	vivar	VGFPE
vivándotelas	vivar	VGFPE
vivándoselas	vivar	VGFPE
vivándonoslas	vivar	VGFPE
vivándooslas	vivar	VGFPE
vivares	vivar	P
vivificar	vivificar	O
vivifico	vivificar	VIP1
vivificas	vivificar	VIP2
vivifica	vivificar	VIP3
vivificamos	vivificar	VIP4
vivificáis	vivificar	VIP5
vivifican	vivificar	VIP6
vivificaba	vivificar	VII1
vivificabas	vivificar	VII2
vivificábamos	vivificar	VII4
vivificabais	vivificar	VII5
vivificaban	vivificar	VII6
vivificaré	vivificar	VIF1
vivificarás	vivificar	VIF2
vivificará	vivificar	VIF3
vivificaremos	vivificar	VIF4
vivificaréis	vivificar	VIF5
vivificarán	vivificar	VIF6
vivificaría	vivificar	VIC1
vivificarías	vivificar	VIC2
vivificaría	vivificar	VIC3
vivificaríamos	vivificar	VIC4
vivificaríais	vivificar	VIC5
vivificarían	vivificar	VIC6
vivifiqué	vivificar	VIX1
vivificaste	vivificar	VIX2
vivificó	vivificar	VIX3
vivificasteis	vivificar	VIX5
vivificaron	vivificar	VIX6
vivifique	vivificar	VSP1
vivifiques	vivificar	VSP2
vivifiquemos	vivificar	VSP4
vivifiquéis	vivificar	VSP5
vivifiquen	vivificar	VSP6
vivificara	vivificar	VSX1
vivificaras	vivificar	VSX2
vivificáramos	vivificar	VSX4
vivificarais	vivificar	VSX5
vivificaran	vivificar	VSX6
vivificare	vivificar	VSF1
vivificares	vivificar	VSF2
vivificáremos	vivificar	VSF4
vivificareis	vivificar	VSF5
vivificaren	vivificar	VSF6
vivificase	vivificar	VSI1
vivificases	vivificar	VSI2
vivificásemos	vivificar	VSI4
vivificaseis	vivificar	VSI5
vivificasen	vivificar	VSI6
vivificad	vivificar	VMP
vivificadme	vivificar	VMSE
vivificadle	vivificar	VMSE
vivificadnos	vivificar	VMPE
vivificaos	vivificar	VMPE
vivificadles	vivificar	VMPE
vivificadlo	vivificar	VMMSE
vivificadla	vivificar	VMFSE
vivificadlos	vivificar	VMMPE
vivificadlas	vivificar	VMFPE
vivificádmelo	vivificar	VMMSE
vivificádselo	vivificar	VMMSE
vivificádnoslo	vivificar	VMMSE
vivificáoslo	vivificar	VMMSE
vivificádmelos	vivificar	VMMPE
vivificádselos	vivificar	VMMPE
vivificádnoslos	vivificar	VMMPE
vivificáoslos	vivificar	VMMPE
vivificádmela	vivificar	VMFSE
vivificádsela	vivificar	VMFSE
vivificádnosla	vivificar	VMFSE
vivificáosla	vivificar	VMFSE
vivificádmelas	vivificar	VMFPE
vivificádselas	vivificar	VMFPE
vivificádnoslas	vivificar	VMFPE
vivificáoslas	vivificar	VMFPE
vivificado	vivificar	VPM
vivificados	vivificar	VPMP
vivificada	vivificar	VPF
vivificadas	vivificar	VPFP
vivificando	vivificar	VG
vivificándome	vivificar	VGSE
vivificándote	vivificar	VGSE
vivificándole	vivificar	VGSE
vivificándonos	vivificar	VGPE
vivificándoos	vivificar	VGPE
vivificándolo	vivificar	VGMSE
vivificándola	vivificar	VGFSE
vivificándolos	vivificar	VGMPE
vivificándolas	vivificar	VGFPE
vivificándomelo	vivificar	VGMSE
vivificándotelo	vivificar	VGMSE
vivificándoselo	vivificar	VGMSE
vivificándonoslo	vivificar	VGMSE
vivificándooslo	vivificar	VGMSE
vivificándomelos	vivificar	VGMPE
vivificándotelos	vivificar	VGMPE
vivificándoselos	vivificar	VGMPE
vivificándonoslos	vivificar	VGMPE
vivificándooslos	vivificar	VGMPE
vivificándomela	vivificar	VGFSE
vivificándotela	vivificar	VGFSE
vivificándosela	vivificar	VGFSE
vivificándonosla	vivificar	VGFSE
vivificándoosla	vivificar	VGFSE
vivificándomelas	vivificar	VGFPE
vivificándotelas	vivificar	VGFPE
vivificándoselas	vivificar	VGFPE
vivificándonoslas	vivificar	VGFPE
vivificándooslas	vivificar	VGFPE
