zurano	zurano	O
zuranas	zurano	FP
zurana	zurano	F
zuranos	zurano	P
zurba	zurba	O
zurbas	zurba	P
zurcida	zurcida	O
zurcidas	zurcida	P
zurcidera	zurcidera	O
zurcideras	zurcidera	P
zurcido	zurcido	O
zurcidos	zurcido	P
zurcidor	zurcidor	O
zurcidoras	zurcidor	FP
zurcidora	zurcidor	F
zurcidores	zurcidor	P
zurcidura	zurcidura	O
zurciduras	zurcidura	P
zurda	zurda	O
zurdas	zurda	P
zurdal	zurdal	O
zurdales	zurdal	P
zurdazo	zurdazo	O
zurdazos	zurdazo	P
zurdera	zurdera	O
zurderas	zurdera	P
zurdería	zurdería	O
zurderías	zurdería	P
zurdo	zurdo	O
zurdas	zurdo	FP
zurda	zurdo	F
zurdos	zurdo	P
zureo	zureo	O
zureos	zureo	P
zurito	zurito	O
zuritas	zurito	FP
zurita	zurito	F
zuritos	zurito	P
zuriza	zuriza	O
zurizas	zuriza	P
zuro	zuro	O
zuras	zuro	FP
zura	zuro	F
zuros	zuro	P
zurra	zurra	O
zurras	zurra	P
zurracapote	zurracapote	O
zurracapotes	zurracapote	P
zurraco	zurraco	O
zurracos	zurraco	P
zurrado	zurrado	O
zurrados	zurrado	P
zurrador	zurrador	O
zurradoras	zurrador	FP
zurradora	zurrador	F
zurradores	zurrador	P
zurrapa	zurrapa	O
zurrapas	zurrapa	P
zurrapiento	zurrapiento	O
zurrapientas	zurrapiento	FP
zurrapienta	zurrapiento	F
zurrapientos	zurrapiento	P
zurraposo	zurraposo	O
zurraposas	zurraposo	FP
zurraposa	zurraposo	F
zurraposos	zurraposo	P
zurreta	zurreta	O
zurretas	zurreta	P
zurria	zurria	O
zurrias	zurria	P
zurriaga	zurriaga	O
zurriagas	zurriaga	P
zurriagazo	zurriagazo	O
zurriagazos	zurriagazo	P
zurriago	zurriago	O
zurriagos	zurriago	P
zurribanda	zurribanda	O
zurribandas	zurribanda	P
zurriburri	zurriburri	O
zurriburris	zurriburri	P
zurrido	zurrido	O
zurridos	zurrido	P
zurrona	zurrona	O
zurronas	zurrona	P
zurronada	zurronada	O
zurronadas	zurronada	P
zurrumba	zurrumba	O
zurrumbas	zurrumba	P
zurrumbera	zurrumbera	O
zurrumberas	zurrumbera	P
zurrusco	zurrusco	O
zurruscos	zurrusco	P
zurrón	zurrón	O
zurrones	zurrón	P
zurubí	zurubí	O
zurubíes	zurubí	P
zurugía	zurugía	O
zurugías	zurugía	P
zurujano	zurujano	O
zurujanos	zurujano	P
zurullo	zurullo	O
zurullos	zurullo	P
zurumbo	zurumbo	O
zurumbas	zurumbo	FP
zurumba	zurumbo	F
zurumbos	zurumbo	P
zurumbático	zurumbático	O
zurumbáticas	zurumbático	FP
zurumbática	zurumbático	F
zurumbáticos	zurumbático	P
zurupeto	zurupeto	O
zurupetos	zurupeto	P
zurcir	zurcir	O
zurco	zurcir	VIP1
zurces	zurcir	VIP2
zurce	zurcir	VIP3
zurcimos	zurcir	VIP4
zurcís	zurcir	VIP5
zurcen	zurcir	VIP6
zurcía	zurcir	VII1
zurcías	zurcir	VII2
zurcíamos	zurcir	VII4
zurcíais	zurcir	VII5
zurcían	zurcir	VII6
zurciré	zurcir	VIF1
zurcirás	zurcir	VIF2
zurcirá	zurcir	VIF3
zurciremos	zurcir	VIF4
zurciréis	zurcir	VIF5
zurcirán	zurcir	VIF6
zurciría	zurcir	VIC1
zurcirías	zurcir	VIC2
zurciría	zurcir	VIC3
zurciríamos	zurcir	VIC4
zurciríais	zurcir	VIC5
zurcirían	zurcir	VIC6
zurcí	zurcir	VIX1
zurciste	zurcir	VIX2
zurció	zurcir	VIX3
zurcisteis	zurcir	VIX5
zurcieron	zurcir	VIX6
zurca	zurcir	VSP1
zurcas	zurcir	VSP2
zurcamos	zurcir	VSP4
zurcáis	zurcir	VSP5
zurcan	zurcir	VSP6
zurciera	zurcir	VSX1
zurcieras	zurcir	VSX2
zurciéramos	zurcir	VSX4
zurcierais	zurcir	VSX5
zurcieran	zurcir	VSX6
zurciere	zurcir	VSF1
zurcieres	zurcir	VSF2
zurciéremos	zurcir	VSF4
zurciereis	zurcir	VSF5
zurcieren	zurcir	VSF6
zurciese	zurcir	VSI1
zurcieses	zurcir	VSI2
zurciésemos	zurcir	VSI4
zurcieseis	zurcir	VSI5
zurciesen	zurcir	VSI6
zurcid	zurcir	VMP
zurcidme	zurcir	VMSE
zurcidle	zurcir	VMSE
zurcidnos	zurcir	VMPE
zurcios	zurcir	VMPE
zurcidles	zurcir	VMPE
zurcidlo	zurcir	VMMSE
zurcidla	zurcir	VMFSE
zurcidlos	zurcir	VMMPE
zurcidlas	zurcir	VMFPE
zurcídmelo	zurcir	VMMSE
zurcídselo	zurcir	VMMSE
zurcídnoslo	zurcir	VMMSE
zurcíoslo	zurcir	VMMSE
zurcídmelos	zurcir	VMMPE
zurcídselos	zurcir	VMMPE
zurcídnoslos	zurcir	VMMPE
zurcíoslos	zurcir	VMMPE
zurcídmela	zurcir	VMFSE
zurcídsela	zurcir	VMFSE
zurcídnosla	zurcir	VMFSE
zurcíosla	zurcir	VMFSE
zurcídmelas	zurcir	VMFPE
zurcídselas	zurcir	VMFPE
zurcídnoslas	zurcir	VMFPE
zurcíoslas	zurcir	VMFPE
zurcido	zurcir	VPM
zurcidos	zurcir	VPMP
zurcida	zurcir	VPF
zurcidas	zurcir	VPFP
zurciendo	zurcir	VG
zurciéndome	zurcir	VGSE
zurciéndote	zurcir	VGSE
zurciéndole	zurcir	VGSE
zurciéndonos	zurcir	VGPE
zurciéndoos	zurcir	VGPE
zurciéndolo	zurcir	VGMSE
zurciéndola	zurcir	VGFSE
zurciéndolos	zurcir	VGMPE
zurciéndolas	zurcir	VGFPE
zurciéndomelo	zurcir	VGMSE
zurciéndotelo	zurcir	VGMSE
zurciéndoselo	zurcir	VGMSE
zurciéndonoslo	zurcir	VGMSE
zurciéndooslo	zurcir	VGMSE
zurciéndomelos	zurcir	VGMPE
zurciéndotelos	zurcir	VGMPE
zurciéndoselos	zurcir	VGMPE
zurciéndonoslos	zurcir	VGMPE
zurciéndooslos	zurcir	VGMPE
zurciéndomela	zurcir	VGFSE
zurciéndotela	zurcir	VGFSE
zurciéndosela	zurcir	VGFSE
zurciéndonosla	zurcir	VGFSE
zurciéndoosla	zurcir	VGFSE
zurciéndomelas	zurcir	VGFPE
zurciéndotelas	zurcir	VGFPE
zurciéndoselas	zurcir	VGFPE
zurciéndonoslas	zurcir	VGFPE
zurciéndooslas	zurcir	VGFPE
zurdir	zurdir	O
zurdo	zurdir	VIP1
zurdes	zurdir	VIP2
zurde	zurdir	VIP3
zurdimos	zurdir	VIP4
zurdís	zurdir	VIP5
zurden	zurdir	VIP6
zurdía	zurdir	VII1
zurdías	zurdir	VII2
zurdíamos	zurdir	VII4
zurdíais	zurdir	VII5
zurdían	zurdir	VII6
zurdiré	zurdir	VIF1
zurdirás	zurdir	VIF2
zurdirá	zurdir	VIF3
zurdiremos	zurdir	VIF4
zurdiréis	zurdir	VIF5
zurdirán	zurdir	VIF6
zurdiría	zurdir	VIC1
zurdirías	zurdir	VIC2
zurdiría	zurdir	VIC3
zurdiríamos	zurdir	VIC4
zurdiríais	zurdir	VIC5
zurdirían	zurdir	VIC6
zurdí	zurdir	VIX1
zurdiste	zurdir	VIX2
zurdió	zurdir	VIX3
zurdisteis	zurdir	VIX5
zurdieron	zurdir	VIX6
zurda	zurdir	VSP1
zurdas	zurdir	VSP2
zurdamos	zurdir	VSP4
zurdáis	zurdir	VSP5
zurdan	zurdir	VSP6
zurdiera	zurdir	VSX1
zurdieras	zurdir	VSX2
zurdiéramos	zurdir	VSX4
zurdierais	zurdir	VSX5
zurdieran	zurdir	VSX6
zurdiere	zurdir	VSF1
zurdieres	zurdir	VSF2
zurdiéremos	zurdir	VSF4
zurdiereis	zurdir	VSF5
zurdieren	zurdir	VSF6
zurdiese	zurdir	VSI1
zurdieses	zurdir	VSI2
zurdiésemos	zurdir	VSI4
zurdieseis	zurdir	VSI5
zurdiesen	zurdir	VSI6
zurdid	zurdir	VMP
zurdidme	zurdir	VMSE
zurdidle	zurdir	VMSE
zurdidnos	zurdir	VMPE
zurdios	zurdir	VMPE
zurdidles	zurdir	VMPE
zurdidlo	zurdir	VMMSE
zurdidla	zurdir	VMFSE
zurdidlos	zurdir	VMMPE
zurdidlas	zurdir	VMFPE
zurdídmelo	zurdir	VMMSE
zurdídselo	zurdir	VMMSE
zurdídnoslo	zurdir	VMMSE
zurdíoslo	zurdir	VMMSE
zurdídmelos	zurdir	VMMPE
zurdídselos	zurdir	VMMPE
zurdídnoslos	zurdir	VMMPE
zurdíoslos	zurdir	VMMPE
zurdídmela	zurdir	VMFSE
zurdídsela	zurdir	VMFSE
zurdídnosla	zurdir	VMFSE
zurdíosla	zurdir	VMFSE
zurdídmelas	zurdir	VMFPE
zurdídselas	zurdir	VMFPE
zurdídnoslas	zurdir	VMFPE
zurdíoslas	zurdir	VMFPE
zurdido	zurdir	VPM
zurdidos	zurdir	VPMP
zurdida	zurdir	VPF
zurdidas	zurdir	VPFP
zurdiendo	zurdir	VG
zurdiéndome	zurdir	VGSE
zurdiéndote	zurdir	VGSE
zurdiéndole	zurdir	VGSE
zurdiéndonos	zurdir	VGPE
zurdiéndoos	zurdir	VGPE
zurdiéndolo	zurdir	VGMSE
zurdiéndola	zurdir	VGFSE
zurdiéndolos	zurdir	VGMPE
zurdiéndolas	zurdir	VGFPE
zurdiéndomelo	zurdir	VGMSE
zurdiéndotelo	zurdir	VGMSE
zurdiéndoselo	zurdir	VGMSE
zurdiéndonoslo	zurdir	VGMSE
zurdiéndooslo	zurdir	VGMSE
zurdiéndomelos	zurdir	VGMPE
zurdiéndotelos	zurdir	VGMPE
zurdiéndoselos	zurdir	VGMPE
zurdiéndonoslos	zurdir	VGMPE
zurdiéndooslos	zurdir	VGMPE
zurdiéndomela	zurdir	VGFSE
zurdiéndotela	zurdir	VGFSE
zurdiéndosela	zurdir	VGFSE
zurdiéndonosla	zurdir	VGFSE
zurdiéndoosla	zurdir	VGFSE
zurdiéndomelas	zurdir	VGFPE
zurdiéndotelas	zurdir	VGFPE
zurdiéndoselas	zurdir	VGFPE
zurdiéndonoslas	zurdir	VGFPE
zurdiéndooslas	zurdir	VGFPE
zurrir	zurrir	O
zurro	zurrir	VIP1
zurres	zurrir	VIP2
zurre	zurrir	VIP3
zurrimos	zurrir	VIP4
zurrís	zurrir	VIP5
zurren	zurrir	VIP6
zurría	zurrir	VII1
zurrías	zurrir	VII2
zurríamos	zurrir	VII4
zurríais	zurrir	VII5
zurrían	zurrir	VII6
zurriré	zurrir	VIF1
zurrirás	zurrir	VIF2
zurrirá	zurrir	VIF3
zurriremos	zurrir	VIF4
zurriréis	zurrir	VIF5
zurrirán	zurrir	VIF6
zurriría	zurrir	VIC1
zurrirías	zurrir	VIC2
zurriría	zurrir	VIC3
zurriríamos	zurrir	VIC4
zurriríais	zurrir	VIC5
zurrirían	zurrir	VIC6
zurrí	zurrir	VIX1
zurriste	zurrir	VIX2
zurrió	zurrir	VIX3
zurristeis	zurrir	VIX5
zurrieron	zurrir	VIX6
zurra	zurrir	VSP1
zurras	zurrir	VSP2
zurramos	zurrir	VSP4
zurráis	zurrir	VSP5
zurran	zurrir	VSP6
zurriera	zurrir	VSX1
zurrieras	zurrir	VSX2
zurriéramos	zurrir	VSX4
zurrierais	zurrir	VSX5
zurrieran	zurrir	VSX6
zurriere	zurrir	VSF1
zurrieres	zurrir	VSF2
zurriéremos	zurrir	VSF4
zurriereis	zurrir	VSF5
zurrieren	zurrir	VSF6
zurriese	zurrir	VSI1
zurrieses	zurrir	VSI2
zurriésemos	zurrir	VSI4
zurrieseis	zurrir	VSI5
zurriesen	zurrir	VSI6
zurrid	zurrir	VMP
zurridme	zurrir	VMSE
zurridle	zurrir	VMSE
zurridnos	zurrir	VMPE
zurrios	zurrir	VMPE
zurridles	zurrir	VMPE
zurrido	zurrir	VPM
zurridos	zurrir	VPMP
zurrida	zurrir	VPF
zurridas	zurrir	VPFP
zurriendo	zurrir	VG
zurriéndome	zurrir	VGSE
zurriéndote	zurrir	VGSE
zurriéndole	zurrir	VGSE
zurriéndonos	zurrir	VGPE
zurriéndoos	zurrir	VGPE
zurdear	zurdear	O
zurdeo	zurdear	VIP1
zurdeas	zurdear	VIP2
zurdea	zurdear	VIP3
zurdeamos	zurdear	VIP4
zurdeáis	zurdear	VIP5
zurdean	zurdear	VIP6
zurdeaba	zurdear	VII1
zurdeabas	zurdear	VII2
zurdeábamos	zurdear	VII4
zurdeabais	zurdear	VII5
zurdeaban	zurdear	VII6
zurdearé	zurdear	VIF1
zurdearás	zurdear	VIF2
zurdeará	zurdear	VIF3
zurdearemos	zurdear	VIF4
zurdearéis	zurdear	VIF5
zurdearán	zurdear	VIF6
zurdearía	zurdear	VIC1
zurdearías	zurdear	VIC2
zurdearía	zurdear	VIC3
zurdearíamos	zurdear	VIC4
zurdearíais	zurdear	VIC5
zurdearían	zurdear	VIC6
zurdeé	zurdear	VIX1
zurdeaste	zurdear	VIX2
zurdeó	zurdear	VIX3
zurdeasteis	zurdear	VIX5
zurdearon	zurdear	VIX6
zurdee	zurdear	VSP1
zurdees	zurdear	VSP2
zurdeemos	zurdear	VSP4
zurdeéis	zurdear	VSP5
zurdeen	zurdear	VSP6
zurdeara	zurdear	VSX1
zurdearas	zurdear	VSX2
zurdeáramos	zurdear	VSX4
zurdearais	zurdear	VSX5
zurdearan	zurdear	VSX6
zurdeare	zurdear	VSF1
zurdeares	zurdear	VSF2
zurdeáremos	zurdear	VSF4
zurdeareis	zurdear	VSF5
zurdearen	zurdear	VSF6
zurdease	zurdear	VSI1
zurdeases	zurdear	VSI2
zurdeásemos	zurdear	VSI4
zurdeaseis	zurdear	VSI5
zurdeasen	zurdear	VSI6
zurdead	zurdear	VMP
zurdeadme	zurdear	VMSE
zurdeadle	zurdear	VMSE
zurdeadnos	zurdear	VMPE
zurdeaos	zurdear	VMPE
zurdeadles	zurdear	VMPE
zurdeado	zurdear	VPM
zurdeados	zurdear	VPMP
zurdeada	zurdear	VPF
zurdeadas	zurdear	VPFP
zurdeando	zurdear	VG
zurdeándome	zurdear	VGSE
zurdeándote	zurdear	VGSE
zurdeándole	zurdear	VGSE
zurdeándonos	zurdear	VGPE
zurdeándoos	zurdear	VGPE
zurear	zurear	O
zureo	zurear	VIP1
zureas	zurear	VIP2
zurea	zurear	VIP3
zureamos	zurear	VIP4
zureáis	zurear	VIP5
zurean	zurear	VIP6
zureaba	zurear	VII1
zureabas	zurear	VII2
zureábamos	zurear	VII4
zureabais	zurear	VII5
zureaban	zurear	VII6
zurearé	zurear	VIF1
zurearás	zurear	VIF2
zureará	zurear	VIF3
zurearemos	zurear	VIF4
zurearéis	zurear	VIF5
zurearán	zurear	VIF6
zurearía	zurear	VIC1
zurearías	zurear	VIC2
zurearía	zurear	VIC3
zurearíamos	zurear	VIC4
zurearíais	zurear	VIC5
zurearían	zurear	VIC6
zureé	zurear	VIX1
zureaste	zurear	VIX2
zureó	zurear	VIX3
zureasteis	zurear	VIX5
zurearon	zurear	VIX6
zuree	zurear	VSP1
zurees	zurear	VSP2
zureemos	zurear	VSP4
zureéis	zurear	VSP5
zureen	zurear	VSP6
zureara	zurear	VSX1
zurearas	zurear	VSX2
zureáramos	zurear	VSX4
zurearais	zurear	VSX5
zurearan	zurear	VSX6
zureare	zurear	VSF1
zureares	zurear	VSF2
zureáremos	zurear	VSF4
zureareis	zurear	VSF5
zurearen	zurear	VSF6
zurease	zurear	VSI1
zureases	zurear	VSI2
zureásemos	zurear	VSI4
zureaseis	zurear	VSI5
zureasen	zurear	VSI6
zuread	zurear	VMP
zureadme	zurear	VMSE
zureadle	zurear	VMSE
zureadnos	zurear	VMPE
zureaos	zurear	VMPE
zureadles	zurear	VMPE
zureado	zurear	VPM
zureados	zurear	VPMP
zureada	zurear	VPF
zureadas	zurear	VPFP
zureando	zurear	VG
zureándome	zurear	VGSE
zureándote	zurear	VGSE
zureándole	zurear	VGSE
zureándonos	zurear	VGPE
zureándoos	zurear	VGPE
zurrar	zurrar	O
zurro	zurrar	VIP1
zurras	zurrar	VIP2
zurra	zurrar	VIP3
zurramos	zurrar	VIP4
zurráis	zurrar	VIP5
zurran	zurrar	VIP6
zurraba	zurrar	VII1
zurrabas	zurrar	VII2
zurrábamos	zurrar	VII4
zurrabais	zurrar	VII5
zurraban	zurrar	VII6
zurraré	zurrar	VIF1
zurrarás	zurrar	VIF2
zurrará	zurrar	VIF3
zurraremos	zurrar	VIF4
zurraréis	zurrar	VIF5
zurrarán	zurrar	VIF6
zurraría	zurrar	VIC1
zurrarías	zurrar	VIC2
zurraría	zurrar	VIC3
zurraríamos	zurrar	VIC4
zurraríais	zurrar	VIC5
zurrarían	zurrar	VIC6
zurré	zurrar	VIX1
zurraste	zurrar	VIX2
zurró	zurrar	VIX3
zurrasteis	zurrar	VIX5
zurraron	zurrar	VIX6
zurre	zurrar	VSP1
zurres	zurrar	VSP2
zurremos	zurrar	VSP4
zurréis	zurrar	VSP5
zurren	zurrar	VSP6
zurrara	zurrar	VSX1
zurraras	zurrar	VSX2
zurráramos	zurrar	VSX4
zurrarais	zurrar	VSX5
zurraran	zurrar	VSX6
zurrare	zurrar	VSF1
zurrares	zurrar	VSF2
zurráremos	zurrar	VSF4
zurrareis	zurrar	VSF5
zurraren	zurrar	VSF6
zurrase	zurrar	VSI1
zurrases	zurrar	VSI2
zurrásemos	zurrar	VSI4
zurraseis	zurrar	VSI5
zurrasen	zurrar	VSI6
zurrad	zurrar	VMP
zurradme	zurrar	VMSE
zurradle	zurrar	VMSE
zurradnos	zurrar	VMPE
zurraos	zurrar	VMPE
zurradles	zurrar	VMPE
zurradlo	zurrar	VMMSE
zurradla	zurrar	VMFSE
zurradlos	zurrar	VMMPE
zurradlas	zurrar	VMFPE
zurrádmelo	zurrar	VMMSE
zurrádselo	zurrar	VMMSE
zurrádnoslo	zurrar	VMMSE
zurráoslo	zurrar	VMMSE
zurrádmelos	zurrar	VMMPE
zurrádselos	zurrar	VMMPE
zurrádnoslos	zurrar	VMMPE
zurráoslos	zurrar	VMMPE
zurrádmela	zurrar	VMFSE
zurrádsela	zurrar	VMFSE
zurrádnosla	zurrar	VMFSE
zurráosla	zurrar	VMFSE
zurrádmelas	zurrar	VMFPE
zurrádselas	zurrar	VMFPE
zurrádnoslas	zurrar	VMFPE
zurráoslas	zurrar	VMFPE
zurrado	zurrar	VPM
zurrados	zurrar	VPMP
zurrada	zurrar	VPF
zurradas	zurrar	VPFP
zurrando	zurrar	VG
zurrándome	zurrar	VGSE
zurrándote	zurrar	VGSE
zurrándole	zurrar	VGSE
zurrándonos	zurrar	VGPE
zurrándoos	zurrar	VGPE
zurrándolo	zurrar	VGMSE
zurrándola	zurrar	VGFSE
zurrándolos	zurrar	VGMPE
zurrándolas	zurrar	VGFPE
zurrándomelo	zurrar	VGMSE
zurrándotelo	zurrar	VGMSE
zurrándoselo	zurrar	VGMSE
zurrándonoslo	zurrar	VGMSE
zurrándooslo	zurrar	VGMSE
zurrándomelos	zurrar	VGMPE
zurrándotelos	zurrar	VGMPE
zurrándoselos	zurrar	VGMPE
zurrándonoslos	zurrar	VGMPE
zurrándooslos	zurrar	VGMPE
zurrándomela	zurrar	VGFSE
zurrándotela	zurrar	VGFSE
zurrándosela	zurrar	VGFSE
zurrándonosla	zurrar	VGFSE
zurrándoosla	zurrar	VGFSE
zurrándomelas	zurrar	VGFPE
zurrándotelas	zurrar	VGFPE
zurrándoselas	zurrar	VGFPE
zurrándonoslas	zurrar	VGFPE
zurrándooslas	zurrar	VGFPE
zurrar	zurrar	O
zurro	zurrar	VIP1
zurras	zurrar	VIP2
zurra	zurrar	VIP3
zurramos	zurrar	VIP4
zurráis	zurrar	VIP5
zurran	zurrar	VIP6
zurraba	zurrar	VII1
zurrabas	zurrar	VII2
zurrábamos	zurrar	VII4
zurrabais	zurrar	VII5
zurraban	zurrar	VII6
zurraré	zurrar	VIF1
zurrarás	zurrar	VIF2
zurrará	zurrar	VIF3
zurraremos	zurrar	VIF4
zurraréis	zurrar	VIF5
zurrarán	zurrar	VIF6
zurraría	zurrar	VIC1
zurrarías	zurrar	VIC2
zurraría	zurrar	VIC3
zurraríamos	zurrar	VIC4
zurraríais	zurrar	VIC5
zurrarían	zurrar	VIC6
zurré	zurrar	VIX1
zurraste	zurrar	VIX2
zurró	zurrar	VIX3
zurrasteis	zurrar	VIX5
zurraron	zurrar	VIX6
zurre	zurrar	VSP1
zurres	zurrar	VSP2
zurremos	zurrar	VSP4
zurréis	zurrar	VSP5
zurren	zurrar	VSP6
zurrara	zurrar	VSX1
zurraras	zurrar	VSX2
zurráramos	zurrar	VSX4
zurrarais	zurrar	VSX5
zurraran	zurrar	VSX6
zurrare	zurrar	VSF1
zurrares	zurrar	VSF2
zurráremos	zurrar	VSF4
zurrareis	zurrar	VSF5
zurraren	zurrar	VSF6
zurrase	zurrar	VSI1
zurrases	zurrar	VSI2
zurrásemos	zurrar	VSI4
zurraseis	zurrar	VSI5
zurrasen	zurrar	VSI6
zurrad	zurrar	VMP
zurradme	zurrar	VMSE
zurradle	zurrar	VMSE
zurradnos	zurrar	VMPE
zurraos	zurrar	VMPE
zurradles	zurrar	VMPE
zurradlo	zurrar	VMMSE
zurradla	zurrar	VMFSE
zurradlos	zurrar	VMMPE
zurradlas	zurrar	VMFPE
zurrádmelo	zurrar	VMMSE
zurrádselo	zurrar	VMMSE
zurrádnoslo	zurrar	VMMSE
zurráoslo	zurrar	VMMSE
zurrádmelos	zurrar	VMMPE
zurrádselos	zurrar	VMMPE
zurrádnoslos	zurrar	VMMPE
zurráoslos	zurrar	VMMPE
zurrádmela	zurrar	VMFSE
zurrádsela	zurrar	VMFSE
zurrádnosla	zurrar	VMFSE
zurráosla	zurrar	VMFSE
zurrádmelas	zurrar	VMFPE
zurrádselas	zurrar	VMFPE
zurrádnoslas	zurrar	VMFPE
zurráoslas	zurrar	VMFPE
zurrado	zurrar	VPM
zurrados	zurrar	VPMP
zurrada	zurrar	VPF
zurradas	zurrar	VPFP
zurrando	zurrar	VG
zurrándome	zurrar	VGSE
zurrándote	zurrar	VGSE
zurrándole	zurrar	VGSE
zurrándonos	zurrar	VGPE
zurrándoos	zurrar	VGPE
zurrándolo	zurrar	VGMSE
zurrándola	zurrar	VGFSE
zurrándolos	zurrar	VGMPE
zurrándolas	zurrar	VGFPE
zurrándomelo	zurrar	VGMSE
zurrándotelo	zurrar	VGMSE
zurrándoselo	zurrar	VGMSE
zurrándonoslo	zurrar	VGMSE
zurrándooslo	zurrar	VGMSE
zurrándomelos	zurrar	VGMPE
zurrándotelos	zurrar	VGMPE
zurrándoselos	zurrar	VGMPE
zurrándonoslos	zurrar	VGMPE
zurrándooslos	zurrar	VGMPE
zurrándomela	zurrar	VGFSE
zurrándotela	zurrar	VGFSE
zurrándosela	zurrar	VGFSE
zurrándonosla	zurrar	VGFSE
zurrándoosla	zurrar	VGFSE
zurrándomelas	zurrar	VGFPE
zurrándotelas	zurrar	VGFPE
zurrándoselas	zurrar	VGFPE
zurrándonoslas	zurrar	VGFPE
zurrándooslas	zurrar	VGFPE
zurriagar	zurriagar	O
zurriago	zurriagar	VIP1
zurriagas	zurriagar	VIP2
zurriaga	zurriagar	VIP3
zurriagamos	zurriagar	VIP4
zurriagáis	zurriagar	VIP5
zurriagan	zurriagar	VIP6
zurriagaba	zurriagar	VII1
zurriagabas	zurriagar	VII2
zurriagábamos	zurriagar	VII4
zurriagabais	zurriagar	VII5
zurriagaban	zurriagar	VII6
zurriagaré	zurriagar	VIF1
zurriagarás	zurriagar	VIF2
zurriagará	zurriagar	VIF3
zurriagaremos	zurriagar	VIF4
zurriagaréis	zurriagar	VIF5
zurriagarán	zurriagar	VIF6
zurriagaría	zurriagar	VIC1
zurriagarías	zurriagar	VIC2
zurriagaría	zurriagar	VIC3
zurriagaríamos	zurriagar	VIC4
zurriagaríais	zurriagar	VIC5
zurriagarían	zurriagar	VIC6
zurriagé	zurriagar	VIX1
zurriagaste	zurriagar	VIX2
zurriagó	zurriagar	VIX3
zurriagasteis	zurriagar	VIX5
zurriagaron	zurriagar	VIX6
zurriague	zurriagar	VSP1
zurriagues	zurriagar	VSP2
zurriaguemos	zurriagar	VSP4
zurriaguéis	zurriagar	VSP5
zurriaguen	zurriagar	VSP6
zurriagara	zurriagar	VSX1
zurriagaras	zurriagar	VSX2
zurriagáramos	zurriagar	VSX4
zurriagarais	zurriagar	VSX5
zurriagaran	zurriagar	VSX6
zurriagare	zurriagar	VSF1
zurriagares	zurriagar	VSF2
zurriagáremos	zurriagar	VSF4
zurriagareis	zurriagar	VSF5
zurriagaren	zurriagar	VSF6
zurriagase	zurriagar	VSI1
zurriagases	zurriagar	VSI2
zurriagásemos	zurriagar	VSI4
zurriagaseis	zurriagar	VSI5
zurriagasen	zurriagar	VSI6
zurriagad	zurriagar	VMP
zurriagadme	zurriagar	VMSE
zurriagadle	zurriagar	VMSE
zurriagadnos	zurriagar	VMPE
zurriagaos	zurriagar	VMPE
zurriagadles	zurriagar	VMPE
zurriagadlo	zurriagar	VMMSE
zurriagadla	zurriagar	VMFSE
zurriagadlos	zurriagar	VMMPE
zurriagadlas	zurriagar	VMFPE
zurriagádmelo	zurriagar	VMMSE
zurriagádselo	zurriagar	VMMSE
zurriagádnoslo	zurriagar	VMMSE
zurriagáoslo	zurriagar	VMMSE
zurriagádmelos	zurriagar	VMMPE
zurriagádselos	zurriagar	VMMPE
zurriagádnoslos	zurriagar	VMMPE
zurriagáoslos	zurriagar	VMMPE
zurriagádmela	zurriagar	VMFSE
zurriagádsela	zurriagar	VMFSE
zurriagádnosla	zurriagar	VMFSE
zurriagáosla	zurriagar	VMFSE
zurriagádmelas	zurriagar	VMFPE
zurriagádselas	zurriagar	VMFPE
zurriagádnoslas	zurriagar	VMFPE
zurriagáoslas	zurriagar	VMFPE
zurriagado	zurriagar	VPM
zurriagados	zurriagar	VPMP
zurriagada	zurriagar	VPF
zurriagadas	zurriagar	VPFP
zurriagando	zurriagar	VG
zurriagándome	zurriagar	VGSE
zurriagándote	zurriagar	VGSE
zurriagándole	zurriagar	VGSE
zurriagándonos	zurriagar	VGPE
zurriagándoos	zurriagar	VGPE
zurriagándolo	zurriagar	VGMSE
zurriagándola	zurriagar	VGFSE
zurriagándolos	zurriagar	VGMPE
zurriagándolas	zurriagar	VGFPE
zurriagándomelo	zurriagar	VGMSE
zurriagándotelo	zurriagar	VGMSE
zurriagándoselo	zurriagar	VGMSE
zurriagándonoslo	zurriagar	VGMSE
zurriagándooslo	zurriagar	VGMSE
zurriagándomelos	zurriagar	VGMPE
zurriagándotelos	zurriagar	VGMPE
zurriagándoselos	zurriagar	VGMPE
zurriagándonoslos	zurriagar	VGMPE
zurriagándooslos	zurriagar	VGMPE
zurriagándomela	zurriagar	VGFSE
zurriagándotela	zurriagar	VGFSE
zurriagándosela	zurriagar	VGFSE
zurriagándonosla	zurriagar	VGFSE
zurriagándoosla	zurriagar	VGFSE
zurriagándomelas	zurriagar	VGFPE
zurriagándotelas	zurriagar	VGFPE
zurriagándoselas	zurriagar	VGFPE
zurriagándonoslas	zurriagar	VGFPE
zurriagándooslas	zurriagar	VGFPE
zurriar	zurriar	O
zurrío	zurriar	VIP1
zurrias	zurriar	VIP2
zurria	zurriar	VIP3
zurriamos	zurriar	VIP4
zurriáis	zurriar	VIP5
zurrian	zurriar	VIP6
zurriaba	zurriar	VII1
zurriabas	zurriar	VII2
zurriábamos	zurriar	VII4
zurriabais	zurriar	VII5
zurriaban	zurriar	VII6
zurriaré	zurriar	VIF1
zurriarás	zurriar	VIF2
zurriará	zurriar	VIF3
zurriaremos	zurriar	VIF4
zurriaréis	zurriar	VIF5
zurriarán	zurriar	VIF6
zurriaría	zurriar	VIC1
zurriarías	zurriar	VIC2
zurriaría	zurriar	VIC3
zurriaríamos	zurriar	VIC4
zurriaríais	zurriar	VIC5
zurriarían	zurriar	VIC6
zurrié	zurriar	VIX1
zurriaste	zurriar	VIX2
zurrió	zurriar	VIX3
zurriasteis	zurriar	VIX5
zurriaron	zurriar	VIX6
zurríe	zurriar	VSP1
zurríes	zurriar	VSP2
zurriemos	zurriar	VSP4
zurriéis	zurriar	VSP5
zurríen	zurriar	VSP6
zurriara	zurriar	VSX1
zurriaras	zurriar	VSX2
zurriáramos	zurriar	VSX4
zurriarais	zurriar	VSX5
zurriaran	zurriar	VSX6
zurriare	zurriar	VSF1
zurriares	zurriar	VSF2
zurriáremos	zurriar	VSF4
zurriareis	zurriar	VSF5
zurriaren	zurriar	VSF6
zurriase	zurriar	VSI1
zurriases	zurriar	VSI2
zurriásemos	zurriar	VSI4
zurriaseis	zurriar	VSI5
zurriasen	zurriar	VSI6
zurriad	zurriar	VMP
zurriadme	zurriar	VMSE
zurriadle	zurriar	VMSE
zurriadnos	zurriar	VMPE
zurriaos	zurriar	VMPE
zurriadles	zurriar	VMPE
zurriado	zurriar	VPM
zurriados	zurriar	VPMP
zurriada	zurriar	VPF
zurriadas	zurriar	VPFP
zurriando	zurriar	VG
zurriándome	zurriar	VGSE
zurriándote	zurriar	VGSE
zurriándole	zurriar	VGSE
zurriándonos	zurriar	VGPE
zurriándoos	zurriar	VGPE
zurruscar	zurruscar	O
zurrusco	zurruscar	VIP1
zurruscas	zurruscar	VIP2
zurrusca	zurruscar	VIP3
zurruscamos	zurruscar	VIP4
zurruscáis	zurruscar	VIP5
zurruscan	zurruscar	VIP6
zurruscaba	zurruscar	VII1
zurruscabas	zurruscar	VII2
zurruscábamos	zurruscar	VII4
zurruscabais	zurruscar	VII5
zurruscaban	zurruscar	VII6
zurruscaré	zurruscar	VIF1
zurruscarás	zurruscar	VIF2
zurruscará	zurruscar	VIF3
zurruscaremos	zurruscar	VIF4
zurruscaréis	zurruscar	VIF5
zurruscarán	zurruscar	VIF6
zurruscaría	zurruscar	VIC1
zurruscarías	zurruscar	VIC2
zurruscaría	zurruscar	VIC3
zurruscaríamos	zurruscar	VIC4
zurruscaríais	zurruscar	VIC5
zurruscarían	zurruscar	VIC6
zurrusqué	zurruscar	VIX1
zurruscaste	zurruscar	VIX2
zurruscó	zurruscar	VIX3
zurruscasteis	zurruscar	VIX5
zurruscaron	zurruscar	VIX6
zurrusque	zurruscar	VSP1
zurrusques	zurruscar	VSP2
zurrusquemos	zurruscar	VSP4
zurrusquéis	zurruscar	VSP5
zurrusquen	zurruscar	VSP6
zurruscara	zurruscar	VSX1
zurruscaras	zurruscar	VSX2
zurruscáramos	zurruscar	VSX4
zurruscarais	zurruscar	VSX5
zurruscaran	zurruscar	VSX6
zurruscare	zurruscar	VSF1
zurruscares	zurruscar	VSF2
zurruscáremos	zurruscar	VSF4
zurruscareis	zurruscar	VSF5
zurruscaren	zurruscar	VSF6
zurruscase	zurruscar	VSI1
zurruscases	zurruscar	VSI2
zurruscásemos	zurruscar	VSI4
zurruscaseis	zurruscar	VSI5
zurruscasen	zurruscar	VSI6
zurruscad	zurruscar	VMP
zurruscadme	zurruscar	VMSE
zurruscadle	zurruscar	VMSE
zurruscadnos	zurruscar	VMPE
zurruscaos	zurruscar	VMPE
zurruscadles	zurruscar	VMPE
zurruscado	zurruscar	VPM
zurruscados	zurruscar	VPMP
zurruscada	zurruscar	VPF
zurruscadas	zurruscar	VPFP
zurruscando	zurruscar	VG
zurruscándome	zurruscar	VGSE
zurruscándote	zurruscar	VGSE
zurruscándole	zurruscar	VGSE
zurruscándonos	zurruscar	VGPE
zurruscándoos	zurruscar	VGPE
